name,eng,gender,scot,total,freq
oliver,6623,boy,393,7016,0.019477364781393232
harry,5284,boy,303,5587,0.015510267536152221
george,5263,boy,107,5370,0.014907846191003656
jack,4751,boy,491,5242,0.014552500881422936
jacob,4485,boy,287,4772,0.013247717322806229
noah,4305,boy,307,4612,0.012803535685830328
charlie,4190,boy,297,4487,0.012456518781942906
muhammad,3908,boy,134,4042,0.011221138604103682
thomas,3898,boy,225,4123,0.011446005557822733
oscar,3894,boy,183,4077,0.011318303337192161
william,3819,boy,174,3993,0.011085107977779814
james,3580,boy,421,4001,0.011107317059628608
leo,3563,boy,299,3862,0.010721434262505795
alfie,3555,boy,257,3812,0.010582627500950827
henry,3527,boy,72,3599,0.009991310696726659
joshua,3495,boy,196,3691,0.010246715137987802
freddie,3287,boy,101,3388,0.009405546162964691
archie,2791,boy,228,3019,0.008381152262689021
ethan,2722,boy,257,2979,0.008270106853445045
isaac,2662,boy,122,2784,0.0077287604833806665
alexander,2567,boy,302,2869,0.007964731978024114
joseph,2506,boy,134,2640,0.007328997010102356
edward,2429,boy,51,2480,0.006884815373126456
samuel,2413,boy,152,2565,0.007120786867769902
max,2405,boy,230,2635,0.007315116333946859
logan,2335,boy,304,2639,0.007326220874871257
lucas,2332,boy,285,2617,0.00726514589978707
daniel,2290,boy,246,2536,0.0070402789460680204
theo,2279,boy,140,2419,0.006715471124029393
arthur,2270,boy,76,2346,0.006512813252159139
mohammed,2228,boy,60,2288,0.006351797408755375
harrison,2220,boy,180,2400,0.006662724554638505
benjamin,2153,boy,128,2281,0.00633236446213768
mason,2131,boy,256,2387,0.006626634796634214
finley,2022,boy,38,2060,0.005718838576064717
sebastian,1990,boy,66,2056,0.005707734035140319
adam,1815,boy,216,2031,0.005638330654362835
dylan,1784,boy,158,1942,0.005391254618794991
zachary,1670,boy,67,1737,0.0048221468964196185
riley,1556,boy,157,1713,0.0047555196508732335
teddy,1491,boy,28,1519,0.0042169494160399544
theodore,1484,boy,35,1519,0.0042169494160399544
david,1461,boy,122,1583,0.004394622070830315
elijah,1412,boy,34,1446,0.0040142915441696994
jake,1405,boy,99,1504,0.004175307387573463
toby,1400,boy,33,1433,0.003978201786165408
louie,1380,boy,56,1436,0.003986530191858705
reuben,1322,boy,81,1403,0.0038949177292324265
arlo,1285,boy,73,1358,0.0037699916438329543
hugo,1234,boy,42,1276,0.0035423485548828054
jaxon,1161,boy,151,1312,0.0036422894232023832
luca,1144,boy,107,1251,0.003472945174105321
matthew,1110,boy,227,1337,0.0037116928039798674
harvey,1102,boy,53,1155,0.003206436191919781
harley,1083,boy,53,1136,0.0031536896225288925
reggie,1083,boy,10,1093,0.0030343158075916195
tommy,1066,boy,43,1109,0.0030787339712892094
jenson,1064,boy,22,1086,0.0030148828609739236
luke,1056,boy,142,1198,0.003325810006857054
michael,1056,boy,114,1170,0.0032480782203862715
jayden,1050,boy,94,1144,0.0031758987043776876
jude,1047,boy,132,1179,0.003273063437466166
frankie,1029,boy,39,1068,0.002964912426814135
albert,1028,boy,18,1046,0.002903837451729949
stanley,1019,boy,18,1037,0.0028788522346500545
elliot,999,boy,76,1075,0.002984345373431831
gabriel,995,boy,53,1048,0.0029093897221921473
mohammad,948,boy,43,991,0.002751150014019483
ollie,923,boy,153,1076,0.00298712150866293
ronnie,921,boy,11,932,0.00258735803538462
louis,911,boy,61,972,0.0026984034446285946
charles,910,boy,43,953,0.0026456568752377067
blake,893,boy,102,995,0.0027622545549438804
elliott,892,boy,39,931,0.00258458190015352
lewis,884,boy,321,1205,0.0033452429534747497
frederick,874,boy,16,890,0.0024707603556784457
nathan,872,boy,206,1078,0.002992673779125129
tyler,863,boy,68,931,0.00258458190015352
jackson,858,boy,114,972,0.0026984034446285946
rory,856,boy,211,1067,0.0029621362915830357
ryan,855,boy,132,987,0.0027400454730950852
carter,839,boy,105,944,0.0026206716581578123
dexter,831,boy,22,853,0.002368043352127769
alex,813,boy,75,888,0.0024652080852162472
austin,812,boy,63,875,0.002429118327211955
caleb,810,boy,141,951,0.0026401046047755078
kai,794,boy,107,901,0.002501297843220539
albie,788,boy,11,799,0.0022181320496484024
ellis,783,boy,47,830,0.0023041922418124833
bobby,775,boy,25,800,0.0022209081848795016
ezra,763,boy,36,799,0.0022181320496484024
leon,737,boy,106,843,0.002340281999816775
roman,737,boy,42,779,0.002162609345026415
jesse,723,boy,4,727,0.0020182503130092475
aaron,704,boy,240,944,0.0026206716581578123
ibrahim,701,boy,23,724,0.0020099219073159494
liam,698,boy,154,852,0.0023652672168966694
jasper,683,boy,17,700,0.0019432946617695642
felix,666,boy,33,699,0.0019405185265384648
finn,650,boy,166,816,0.002265326348577092
tobias,647,boy,16,663,0.001840577658218887
jamie,641,boy,145,786,0.0021820422916441107
connor,638,boy,146,784,0.002176490021181912
aiden,622,boy,103,725,0.0020126980425470486
eli,619,boy,41,660,0.001832249252525589
rowan,619,boy,30,649,0.001801711764983496
seth,611,boy,35,646,0.0017933833592901978
yusuf,610,boy,13,623,0.001729532248974912
robert,597,boy,114,711,0.0019738321493116572
callum,594,boy,194,788,0.002187594562106309
alfred,589,boy,11,600,0.0016656811386596263
ralph,587,boy,11,598,0.0016601288681974277
owen,586,boy,97,683,0.0018961003628408747
patrick,582,boy,49,631,0.001751741330823707
dominic,573,boy,34,607,0.001685114085277322
sonny,563,boy,63,626,0.0017378606546682102
hunter,538,boy,69,607,0.001685114085277322
muhammed,534,boy,15,549,0.001524098241873558
joel,524,boy,28,552,0.0015324266475668562
john,512,boy,121,633,0.0017572936012859059
evan,509,boy,47,556,0.0015435311884912538
ayaan,507,boy,21,528,0.0014657994020204712
maxwell,504,boy,24,528,0.0014657994020204712
milo,504,boy,24,528,0.0014657994020204712
kian,499,boy,55,554,0.001537978918029055
cody,491,boy,72,563,0.0015629641351089494
billy,485,boy,14,499,0.0013852914803185892
lincoln,478,boy,19,497,0.0013797392098563906
nathaniel,476,boy,20,496,0.0013769630746252911
finlay,467,boy,259,726,0.002015474177778148
joey,459,boy,42,501,0.0013908437507807881
leonardo,453,boy,11,464,0.001288126747230111
ali,452,boy,16,468,0.0012992312881545086
oakley,445,boy,9,454,0.0012603653949191172
rocco,441,boy,39,480,0.001332544910927701
rupert,438,boy,8,446,0.0012381563130703223
musa,431,boy,10,441,0.0012242756369148255
christopher,428,boy,82,510,0.0014158289678606825
grayson,427,boy,30,457,0.0012686938006124153
anthony,422,boy,45,467,0.0012964551529234091
kayden,422,boy,71,493,0.001368634668931993
parker,407,boy,39,446,0.0012381563130703223
bailey,406,boy,38,444,0.0012326040426081236
jaxson,405,boy,55,460,0.0012770222063057137
cole,396,boy,117,513,0.0014241573735539806
spencer,396,boy,19,415,0.0011520961209062416
cooper,390,boy,93,483,0.0013408733166209992
eric,390,boy,17,407,0.0011298870390574465
rhys,390,boy,65,455,0.0012631415301502167
maximilian,389,boy,18,407,0.0011298870390574465
bradley,388,boy,32,420,0.0011659767970617384
nicholas,388,boy,26,414,0.0011493199856751422
brody,384,boy,47,431,0.0011965142846038317
hudson,383,boy,19,402,0.0011160063629019497
filip,382,boy,35,417,0.0011576483913684403
vincent,380,boy,27,407,0.0011298870390574465
jonah,378,boy,18,396,0.0010993495515153535
cameron,373,boy,181,554,0.001537978918029055
jakub,373,boy,34,407,0.0011298870390574465
ted,368,boy,3,371,0.001029946170737869
aidan,365,boy,86,451,0.001252036989225819
abdullah,364,boy,9,373,0.0010354984412000677
ruben,363,boy,27,390,0.0010826927401287572
tristan,361,boy,12,373,0.0010354984412000677
zac,355,boy,74,429,0.0011909620141416328
kevin,352,boy,21,373,0.0010354984412000677
levi,348,boy,30,378,0.0010493791173555645
elias,342,boy,9,351,9.744234661158814e-4
flynn,342,boy,41,383,0.0010632597935110615
jason,340,boy,36,376,0.0010438268468933659
ahmed,338,boy,12,350,9.716473308847821e-4
yahya,333,boy,4,337,9.355575728804902e-4
rex,328,boy,8,336,9.327814376493907e-4
ashton,327,boy,33,360,9.994086831957758e-4
frank,326,boy,9,335,9.300053024182914e-4
rayan,326,boy,11,337,9.355575728804902e-4
mohamed,321,boy,11,332,9.216768967249933e-4
chase,320,boy,9,329,9.133484910316951e-4
maximus,319,boy,6,325,9.022439501072976e-4
miles,319,boy,9,328,9.105723558005958e-4
alan,312,boy,33,345,9.577666547292852e-4
jax,311,boy,57,368,0.001021617765044571
wilfred,306,boy,2,308,8.550496511786082e-4
vinnie,305,boy,6,311,8.633780568719063e-4
beau,301,boy,10,311,8.633780568719063e-4
eesa,300,boy,15,315,8.744825977963039e-4
sam,300,boy,84,384,0.001066035928742161
marley,297,boy,6,303,8.411689750231113e-4
peter,297,boy,38,335,9.300053024182914e-4
zayn,296,boy,16,312,8.661541921030058e-4
olly,294,boy,46,340,9.438859785737883e-4
syed,294,boy,8,302,8.38392839792012e-4
hamza,292,boy,6,298,8.272882988676145e-4
kyle,288,boy,106,394,0.0010937972810531546
hayden,287,boy,34,321,8.911394091829001e-4
jensen,287,boy,10,297,8.24512163636515e-4
jonathan,287,boy,19,306,8.494973807164094e-4
kaiden,286,boy,36,322,8.939155444139995e-4
robin,286,boy,17,303,8.411689750231113e-4
xavier,283,boy,10,293,8.134076227121176e-4
lukas,279,boy,28,307,8.522735159475089e-4
corey,276,boy,67,343,9.522143842670864e-4
omar,275,boy,14,289,8.0230308178772e-4
zakariya,274,boy,7,281,7.80093999938925e-4
marcus,273,boy,51,324,8.994678148761982e-4
ben,272,boy,107,379,0.001052155252586664
abdul,271,boy,6,277,7.689894590145275e-4
lenny,271,boy,5,276,7.662133237834281e-4
andrew,268,boy,135,403,0.0011187824981330492
taylor,268,boy,17,285,7.911985408633226e-4
myles,267,boy,28,295,8.189598931743163e-4
antoni,266,boy,37,303,8.411689750231113e-4
oskar,266,boy,37,303,8.411689750231113e-4
zack,266,boy,41,307,8.522735159475089e-4
kacper,263,boy,25,288,7.995269465566207e-4
francis,259,boy,15,274,7.606610533212294e-4
morgan,257,boy,6,263,7.301235657791363e-4
mustafa,257,boy,8,265,7.35675836241335e-4
jordan,256,boy,35,291,8.078553522499188e-4
reece,255,boy,39,294,8.161837579432169e-4
conor,254,boy,70,324,8.994678148761982e-4
rohan,253,boy,21,274,7.606610533212294e-4
adrian,251,boy,15,266,7.384519714724344e-4
christian,251,boy,12,263,7.301235657791363e-4
bodhi,248,boy,8,256,7.106906191614406e-4
chester,248,boy,1,249,6.91257672543745e-4
abel,247,boy,12,259,7.190190248547387e-4
idris,247,boy,9,256,7.106906191614406e-4
freddy,245,boy,15,260,7.217951600858382e-4
otis,245,boy,8,253,7.023622134681425e-4
rayyan,244,boy,6,250,6.940338077748443e-4
zain,242,boy,12,254,7.051383486992418e-4
fletcher,241,boy,15,256,7.106906191614406e-4
leighton,241,boy,21,262,7.273474305480368e-4
barnaby,240,boy,2,242,6.718247259260493e-4
raphael,240,boy,2,242,6.718247259260493e-4
isaiah,237,boy,3,240,6.662724554638505e-4
fraser,232,boy,87,319,8.855871387207013e-4
victor,232,boy,8,240,6.662724554638505e-4
rafael,229,boy,11,240,6.662724554638505e-4
layton,226,boy,28,254,7.051383486992418e-4
sidney,224,boy,1,225,6.246304269973599e-4
zak,224,boy,46,270,7.495565123968319e-4
eddie,220,boy,5,225,6.246304269973599e-4
aryan,218,boy,9,227,6.301826974595586e-4
rio,217,boy,17,234,6.496156440772543e-4
brandon,216,boy,23,239,6.634963202327512e-4
danny,216,boy,18,234,6.496156440772543e-4
jay,215,boy,56,271,7.523326476279313e-4
leonard,215,boy,12,227,6.301826974595586e-4
marcel,215,boy,23,238,6.607201850016518e-4
martin,213,boy,25,238,6.607201850016518e-4
brodie,211,boy,182,393,0.0010910211458220553
umar,207,boy,5,212,5.88540668993068e-4
hector,206,boy,15,221,6.135258860729624e-4
hassan,205,boy,10,215,5.968690746863661e-4
joe,205,boy,35,240,6.662724554638505e-4
mark,205,boy,38,243,6.746008611571487e-4
quinn,204,boy,31,235,6.523917793083536e-4
emmanuel,203,boy,3,206,5.718838576064718e-4
aleksander,202,boy,21,223,6.190781565351611e-4
micah,202,boy,11,213,5.913168042241673e-4
jeremiah,201,boy,7,208,5.774361280686704e-4
lorenzo,201,boy,9,210,5.829883985308692e-4
jan,200,boy,20,220,6.10749750841863e-4
rufus,199,boy,8,207,5.746599928375711e-4
nicolas,197,boy,14,211,5.857645337619687e-4
casey,195,boy,28,223,6.190781565351611e-4
lennon,195,boy,16,211,5.857645337619687e-4
xander,195,boy,18,213,5.913168042241673e-4
malachi,194,boy,4,198,5.496747757576767e-4
ahmad,193,boy,5,198,5.496747757576767e-4
arjun,193,boy,1,194,5.385702348332792e-4
fabian,190,boy,12,202,5.607793166820742e-4
dominik,185,boy,24,209,5.802122632997699e-4
enzo,185,boy,8,193,5.357940996021798e-4
ismail,185,boy,2,187,5.191372882155836e-4
richard,184,boy,13,197,5.468986405265773e-4
zach,183,boy,33,216,5.996452099174655e-4
josiah,181,boy,4,185,5.135850177533848e-4
rafferty,181,boy,2,183,5.08032747291186e-4
buddy,180,boy,8,188,5.219134234466829e-4
julian,180,boy,7,187,5.191372882155836e-4
phoenix,180,boy,6,186,5.163611529844841e-4
preston,178,boy,17,195,5.413463700643786e-4
otto,177,boy,4,181,5.024804768289873e-4
wyatt,177,boy,7,184,5.108088825222855e-4
asher,176,boy,4,180,4.997043415978879e-4
douglas,175,boy,14,189,5.246895586777823e-4
archer,174,boy,10,184,5.108088825222855e-4
franklin,171,boy,1,172,4.774952597490929e-4
ivan,171,boy,7,178,4.941520711356891e-4
harri,170,boy,4,174,4.8304753021129166e-4
declan,169,boy,31,200,5.552270462198754e-4
cohen,168,boy,30,198,5.496747757576767e-4
reginald,166,boy,3,169,4.6916685405579475e-4
rafe,165,boy,4,169,4.6916685405579475e-4
timothy,162,boy,8,170,4.7194298928689415e-4
harris,161,boy,274,435,0.001207618825528229
kit,161,boy,3,164,4.552861779002979e-4
szymon,161,boy,22,183,5.08032747291186e-4
teddie,160,boy,2,162,4.497339074380991e-4
aarav,159,boy,5,164,4.552861779002979e-4
paul,159,boy,37,196,5.44122505295478e-4
travis,159,boy,21,180,4.997043415978879e-4
amir,158,boy,5,163,4.525100426691985e-4
bilal,158,boy,2,160,4.441816369759004e-4
cian,157,boy,25,182,5.052566120600867e-4
coby,157,boy,11,168,4.6639071882469536e-4
junior,156,boy,27,183,5.08032747291186e-4
natan,156,boy,11,167,4.63614583593596e-4
bertie,155,boy,4,159,4.41405501744801e-4
casper,155,boy,8,163,4.525100426691985e-4
ayden,153,boy,17,170,4.7194298928689415e-4
ewan,153,boy,35,188,5.219134234466829e-4
kieran,153,boy,32,185,5.135850177533848e-4
tom,153,boy,23,176,4.885998006734904e-4
sami,152,boy,4,156,4.330770960515029e-4
jimmy,151,boy,3,154,4.275248255893041e-4
ernest,150,boy,5,155,4.303009608204035e-4
milan,148,boy,5,153,4.247486903582047e-4
ashley,146,boy,0,146,4.0531574374050907e-4
marshall,146,boy,8,154,4.275248255893041e-4
mikolaj,146,boy,15,161,4.4695777220699973e-4
philip,146,boy,12,158,4.386293665137016e-4
aadam,145,boy,3,148,4.1086801420270785e-4
brooklyn,145,boy,14,159,4.41405501744801e-4
river,145,boy,8,153,4.247486903582047e-4
rudy,145,boy,6,151,4.19196419896006e-4
tomas,144,boy,6,150,4.164202846649066e-4
monty,143,boy,0,143,3.9698733804721095e-4
osian,143,boy,1,144,3.9976347327831034e-4
denis,142,boy,7,149,4.1364414943380725e-4
olivier,142,boy,13,155,4.303009608204035e-4
eden,141,boy,7,148,4.1086801420270785e-4
matteo,141,boy,9,150,4.164202846649066e-4
nico,141,boy,21,162,4.497339074380991e-4
romeo,140,boy,5,145,4.0253960850940973e-4
damian,139,boy,11,150,4.164202846649066e-4
zion,139,boy,3,142,3.9421120281611156e-4
bentley,138,boy,4,142,3.9421120281611156e-4
walter,138,boy,2,140,3.8865893235391283e-4
josh,137,boy,71,208,5.774361280686704e-4
hugh,136,boy,11,147,4.0809187897160846e-4
isa,136,boy,3,139,3.8588279712281344e-4
ismaeel,136,boy,9,145,4.0253960850940973e-4
remy,136,boy,3,139,3.8588279712281344e-4
shay,136,boy,54,190,5.274656939088817e-4
finnley,135,boy,1,136,3.775543914295153e-4
dennis,133,boy,9,142,3.9421120281611156e-4
stefan,133,boy,8,141,3.914350675850122e-4
zachariah,133,boy,7,140,3.8865893235391283e-4
erik,132,boy,11,143,3.9698733804721095e-4
haris,132,boy,7,139,3.8588279712281344e-4
jaiden,132,boy,10,142,3.9421120281611156e-4
kaleb,132,boy,21,153,4.247486903582047e-4
jaden,131,boy,7,138,3.8310666189171405e-4
luka,131,boy,11,142,3.9421120281611156e-4
franciszek,130,boy,10,140,3.8865893235391283e-4
sean,130,boy,53,183,5.08032747291186e-4
simon,130,boy,9,139,3.8588279712281344e-4
axel,128,boy,9,137,3.803305266606147e-4
ibraheem,128,boy,0,128,3.553453095807203e-4
zayd,128,boy,1,129,3.581214448118197e-4
andrei,127,boy,2,129,3.581214448118197e-4
angus,127,boy,123,250,6.940338077748443e-4
carson,127,boy,65,192,5.330179643710805e-4
cruz,127,boy,17,144,3.9976347327831034e-4
cassius,126,boy,1,127,3.525691743496209e-4
solomon,126,boy,8,134,3.7200212096731653e-4
zayaan,126,boy,2,128,3.553453095807203e-4
ayan,125,boy,4,129,3.581214448118197e-4
darius,124,boy,0,124,3.442407686563228e-4
tate,124,boy,4,128,3.553453095807203e-4
aron,123,boy,4,127,3.525691743496209e-4
kingsley,123,boy,4,127,3.525691743496209e-4
johnny,121,boy,7,128,3.553453095807203e-4
zayan,121,boy,5,126,3.4979303911852156e-4
matei,120,boy,4,124,3.442407686563228e-4
cillian,119,boy,20,139,3.8588279712281344e-4
clark,119,boy,17,136,3.775543914295153e-4
dougie,119,boy,4,123,3.414646334252234e-4
hussain,119,boy,7,126,3.4979303911852156e-4
kane,119,boy,8,127,3.525691743496209e-4
lochlan,119,boy,59,178,4.941520711356891e-4
nikodem,118,boy,12,130,3.608975800429191e-4
alby,117,boy,4,121,3.3591236296302466e-4
azaan,116,boy,5,121,3.3591236296302466e-4
nate,116,boy,4,120,3.3313622773192527e-4
ronan,115,boy,28,143,3.9698733804721095e-4
aayan,113,boy,8,121,3.3591236296302466e-4
euan,113,boy,80,193,5.357940996021798e-4
woody,113,boy,0,113,3.1370328111422963e-4
ezekiel,112,boy,1,113,3.1370328111422963e-4
niall,111,boy,24,135,3.747782561984159e-4
regan,111,boy,1,112,3.1092714588313024e-4
scott,110,boy,60,170,4.7194298928689415e-4
lachlan,109,boy,72,181,5.024804768289873e-4
aahil,108,boy,2,110,3.053748754209315e-4
ayman,108,boy,2,110,3.053748754209315e-4
curtis,107,boy,12,119,3.303600925008259e-4
mylo,107,boy,8,115,3.192555515764284e-4
stephen,107,boy,33,140,3.8865893235391283e-4
alistair,106,boy,23,129,3.581214448118197e-4
lawrence,106,boy,3,109,3.025987401898321e-4
brian,105,boy,18,123,3.414646334252234e-4
edison,105,boy,3,108,2.9982260495873273e-4
heath,104,boy,6,110,3.053748754209315e-4
maksymilian,104,boy,14,118,3.2758395726972654e-4
ilyas,103,boy,3,106,2.94270334496534e-4
khalid,103,boy,0,103,2.859419288032359e-4
armaan,102,boy,2,104,2.887180640343352e-4
aston,102,boy,3,105,2.914941992654346e-4
aydin,102,boy,3,105,2.914941992654346e-4
bruno,102,boy,10,112,3.1092714588313024e-4
laurence,102,boy,6,108,2.9982260495873273e-4
clayton,101,boy,8,109,3.025987401898321e-4
marco,101,boy,17,118,3.2758395726972654e-4
noel,101,boy,10,111,3.081510106520309e-4
aaryan,100,boy,1,101,2.803896583410371e-4
alexandru,100,boy,3,103,2.859419288032359e-4
dawud,100,boy,3,103,2.859419288032359e-4
ralphie,100,boy,2,102,2.831657935721365e-4
rogan,100,boy,11,111,3.081510106520309e-4
santiago,100,boy,4,104,2.887180640343352e-4
luis,99,boy,8,107,2.970464697276334e-4
montgomery,99,boy,2,101,2.803896583410371e-4
andre,98,boy,2,100,2.776135231099377e-4
eduard,98,boy,0,98,2.72061252647739e-4
justin,98,boy,3,101,2.803896583410371e-4
troy,98,boy,6,104,2.887180640343352e-4
antonio,97,boy,4,101,2.803896583410371e-4
hashim,97,boy,3,100,2.776135231099377e-4
yunus,97,boy,1,98,2.72061252647739e-4
amaan,96,boy,2,98,2.72061252647739e-4
jace,96,boy,18,114,3.16479416345329e-4
kasper,96,boy,4,100,2.776135231099377e-4
zane,96,boy,4,100,2.776135231099377e-4
caiden,95,boy,18,113,3.1370328111422963e-4
calvin,95,boy,82,177,4.913759359045898e-4
kobi,94,boy,5,99,2.7483738787883837e-4
anas,93,boy,4,97,2.692851174166396e-4
benedict,93,boy,4,97,2.692851174166396e-4
dawid,93,boy,4,97,2.692851174166396e-4
hamish,93,boy,117,210,5.829883985308692e-4
barney,92,boy,1,93,2.5818057649224207e-4
tomos,92,boy,0,92,2.5540444126114273e-4
haider,91,boy,2,93,2.5818057649224207e-4
hasan,91,boy,3,94,2.6095671172334146e-4
jonas,91,boy,7,98,2.72061252647739e-4
lucian,91,boy,2,93,2.5818057649224207e-4
diego,90,boy,4,94,2.6095671172334146e-4
loki,90,boy,5,95,2.6373284695444085e-4
mckenzie,90,boy,1,91,2.5262830603004334e-4
miller,90,boy,20,110,3.053748754209315e-4
samson,90,boy,0,90,2.4985217079894395e-4
magnus,89,boy,41,130,3.608975800429191e-4
rayaan,89,boy,0,89,2.4707603556784456e-4
amari,88,boy,0,88,2.442999003367452e-4
ioan,88,boy,2,90,2.4985217079894395e-4
jai,88,boy,4,92,2.5540444126114273e-4
malakai,88,boy,1,89,2.4707603556784456e-4
mario,88,boy,3,91,2.5262830603004334e-4
patryk,88,boy,7,95,2.6373284695444085e-4
ray,88,boy,2,90,2.4985217079894395e-4
wiktor,88,boy,6,94,2.6095671172334146e-4
yousuf,88,boy,4,92,2.5540444126114273e-4
coen,87,boy,14,101,2.803896583410371e-4
michal,87,boy,8,95,2.6373284695444085e-4
cayden,86,boy,15,101,2.803896583410371e-4
dawson,86,boy,8,94,2.6095671172334146e-4
elis,86,boy,2,88,2.442999003367452e-4
jac,86,boy,0,86,2.3874762987454644e-4
kyron,86,boy,4,90,2.4985217079894395e-4
mateo,86,boy,3,89,2.4707603556784456e-4
rehan,86,boy,1,87,2.4152376510564583e-4
archibald,85,boy,14,99,2.7483738787883837e-4
lawson,85,boy,13,98,2.72061252647739e-4
lennox,85,boy,15,100,2.776135231099377e-4
robbie,85,boy,72,157,4.358532312826022e-4
tymon,85,boy,12,97,2.692851174166396e-4
daniyal,84,boy,8,92,2.5540444126114273e-4
jakob,84,boy,8,92,2.5540444126114273e-4
mateusz,84,boy,7,91,2.5262830603004334e-4
ryder,84,boy,2,86,2.3874762987454644e-4
ernie,83,boy,2,85,2.3597149464344707e-4
hadley,83,boy,3,86,2.3874762987454644e-4
hari,83,boy,2,85,2.3597149464344707e-4
imran,83,boy,2,85,2.3597149464344707e-4
keegan,83,boy,12,95,2.6373284695444085e-4
percy,83,boy,1,84,2.3319535941234768e-4
steven,83,boy,27,110,3.053748754209315e-4
abraham,82,boy,5,87,2.4152376510564583e-4
dante,82,boy,1,83,2.3041922418124832e-4
edwin,82,boy,3,85,2.3597149464344707e-4
hendrix,82,boy,1,83,2.3041922418124832e-4
kobe,82,boy,6,88,2.442999003367452e-4
shane,82,boy,9,91,2.5262830603004334e-4
sulaiman,82,boy,2,84,2.3319535941234768e-4
yousef,82,boy,5,87,2.4152376510564583e-4
bruce,81,boy,10,91,2.5262830603004334e-4
bryan,81,boy,6,87,2.4152376510564583e-4
krish,81,boy,2,83,2.3041922418124832e-4
kye,81,boy,4,85,2.3597149464344707e-4
malik,81,boy,5,86,2.3874762987454644e-4
maxim,81,boy,3,84,2.3319535941234768e-4
prince,81,boy,0,81,2.2486695371904956e-4
zakaria,81,boy,1,82,2.2764308895014895e-4
devon,80,boy,5,85,2.3597149464344707e-4
henley,80,boy,0,80,2.220908184879502e-4
subhan,80,boy,4,84,2.3319535941234768e-4
caelan,79,boy,26,105,2.914941992654346e-4
cai,79,boy,3,82,2.2764308895014895e-4
dillon,79,boy,6,85,2.3597149464344707e-4
dean,78,boy,14,92,2.5540444126114273e-4
rico,78,boy,0,78,2.1653854802575144e-4
cairo,77,boy,1,78,2.1653854802575144e-4
issac,77,boy,2,79,2.193146832568508e-4
maddox,77,boy,0,77,2.1376241279465205e-4
arham,76,boy,3,79,2.193146832568508e-4
fox,75,boy,2,77,2.1376241279465205e-4
koby,75,boy,8,83,2.3041922418124832e-4
yaqub,75,boy,1,76,2.1098627756355268e-4
yuvraj,75,boy,0,75,2.082101423324533e-4
huxley,74,boy,3,77,2.1376241279465205e-4
igor,74,boy,4,78,2.1653854802575144e-4
kristian,74,boy,2,76,2.1098627756355268e-4
leyton,74,boy,17,91,2.5262830603004334e-4
matas,74,boy,2,76,2.1098627756355268e-4
raheem,74,boy,0,74,2.0543400710135393e-4
bear,73,boy,2,75,2.082101423324533e-4
brayden,73,boy,15,88,2.442999003367452e-4
deacon,73,boy,9,82,2.2764308895014895e-4
gethin,73,boy,0,73,2.0265787187025454e-4
henri,73,boy,1,74,2.0543400710135393e-4
jago,73,boy,0,73,2.0265787187025454e-4
kamil,73,boy,4,77,2.1376241279465205e-4
kyran,73,boy,4,77,2.1376241279465205e-4
rian,73,boy,7,80,2.220908184879502e-4
rudi,73,boy,14,87,2.4152376510564583e-4
zayyan,73,boy,1,74,2.0543400710135393e-4
angelo,72,boy,2,74,2.0543400710135393e-4
ari,72,boy,7,79,2.193146832568508e-4
oliwier,72,boy,7,79,2.193146832568508e-4
remi,72,boy,2,74,2.0543400710135393e-4
israel,71,boy,3,74,2.0543400710135393e-4
mitchell,71,boy,13,84,2.3319535941234768e-4
shayan,71,boy,1,72,1.9988173663915517e-4
usman,71,boy,2,73,2.0265787187025454e-4
fergus,70,boy,38,108,2.9982260495873273e-4
georgie,70,boy,1,71,1.9710560140805578e-4
reid,70,boy,6,76,2.1098627756355268e-4
sullivan,70,boy,2,72,1.9988173663915517e-4
ayub,69,boy,1,70,1.9432946617695641e-4
jett,69,boy,7,76,2.1098627756355268e-4
nolan,69,boy,8,77,2.1376241279465205e-4
reagan,69,boy,3,72,1.9988173663915517e-4
byron,67,boy,0,67,1.8600106048365827e-4
dominykas,67,boy,3,70,1.9432946617695641e-4
esa,67,boy,3,70,1.9432946617695641e-4
kayson,67,boy,11,78,2.1653854802575144e-4
moses,67,boy,2,69,1.9155333094585702e-4
veer,67,boy,0,67,1.8600106048365827e-4
zaid,67,boy,4,71,1.9710560140805578e-4
caden,66,boy,6,72,1.9988173663915517e-4
ian,66,boy,17,83,2.3041922418124832e-4
jamal,66,boy,0,66,1.832249252525589e-4
macsen,66,boy,0,66,1.832249252525589e-4
maximillian,66,boy,1,67,1.8600106048365827e-4
oisin,66,boy,1,67,1.8600106048365827e-4
alec,65,boy,3,68,1.8877719571475766e-4
judah,65,boy,2,67,1.8600106048365827e-4
wilbur,65,boy,3,68,1.8877719571475766e-4
yasin,65,boy,1,66,1.832249252525589e-4
zidan,65,boy,2,67,1.8600106048365827e-4
kyan,64,boy,1,65,1.8044879002145954e-4
mikaeel,64,boy,1,65,1.8044879002145954e-4
orion,64,boy,5,69,1.9155333094585702e-4
zakariyya,64,boy,3,67,1.8600106048365827e-4
aariz,63,boy,1,64,1.7767265479036015e-4
emir,63,boy,2,65,1.8044879002145954e-4
mikey,63,boy,8,71,1.9710560140805578e-4
ned,63,boy,0,63,1.7489651955926078e-4
odin,63,boy,13,76,2.1098627756355268e-4
anton,62,boy,6,68,1.8877719571475766e-4
avery,62,boy,2,64,1.7767265479036015e-4
eisa,62,boy,2,64,1.7767265479036015e-4
faris,62,boy,3,65,1.8044879002145954e-4
kaden,62,boy,2,64,1.7767265479036015e-4
leonidas,62,boy,2,64,1.7767265479036015e-4
piotr,62,boy,6,68,1.8877719571475766e-4
salman,62,boy,2,64,1.7767265479036015e-4
will,62,boy,5,67,1.8600106048365827e-4
emerson,61,boy,1,62,1.721203843281614e-4
olaf,61,boy,4,65,1.8044879002145954e-4
wesley,61,boy,1,62,1.721203843281614e-4
adnan,60,boy,0,60,1.6656811386596263e-4
adyan,60,boy,1,61,1.6934424909706203e-4
alessandro,60,boy,5,65,1.8044879002145954e-4
dalton,60,boy,5,65,1.8044879002145954e-4
deniz,60,boy,2,62,1.721203843281614e-4
dorian,60,boy,8,68,1.8877719571475766e-4
fynn,60,boy,9,69,1.9155333094585702e-4
lennie,60,boy,1,61,1.6934424909706203e-4
nikolas,60,boy,3,63,1.7489651955926078e-4
orson,60,boy,2,62,1.721203843281614e-4
tony,60,boy,2,62,1.721203843281614e-4
abdulrahman,59,boy,3,62,1.721203843281614e-4
asa,59,boy,1,60,1.6656811386596263e-4
bartosz,59,boy,7,66,1.832249252525589e-4
braxton,59,boy,6,65,1.8044879002145954e-4
brogan,59,boy,7,66,1.832249252525589e-4
che,59,boy,7,66,1.832249252525589e-4
idrees,59,boy,4,63,1.7489651955926078e-4
laith,59,boy,0,59,1.6379197863486327e-4
francesco,58,boy,3,61,1.6934424909706203e-4
lorcan,58,boy,2,60,1.6656811386596263e-4
raymond,58,boy,2,60,1.6656811386596263e-4
shaun,58,boy,19,77,2.1376241279465205e-4
sultan,58,boy,2,60,1.6656811386596263e-4
arjan,57,boy,1,58,1.6101584340376388e-4
frazer,57,boy,5,62,1.721203843281614e-4
haroon,57,boy,4,61,1.6934424909706203e-4
ishaq,57,boy,1,58,1.6101584340376388e-4
kairo,57,boy,0,57,1.582397081726645e-4
kody,57,boy,19,76,2.1098627756355268e-4
kylan,57,boy,3,60,1.6656811386596263e-4
lee,57,boy,21,78,2.1653854802575144e-4
md,57,boy,0,57,1.582397081726645e-4
taha,57,boy,4,61,1.6934424909706203e-4
andreas,56,boy,1,57,1.582397081726645e-4
atticus,56,boy,2,58,1.6101584340376388e-4
colby,56,boy,5,61,1.6934424909706203e-4
emil,56,boy,6,62,1.721203843281614e-4
ianis,56,boy,3,59,1.6379197863486327e-4
jovan,56,boy,0,56,1.5546357294156512e-4
kabir,56,boy,0,56,1.5546357294156512e-4
khalil,56,boy,0,56,1.5546357294156512e-4
omer,56,boy,0,56,1.5546357294156512e-4
yaseen,56,boy,3,59,1.6379197863486327e-4
ajay,55,boy,10,65,1.8044879002145954e-4
darren,55,boy,13,68,1.8877719571475766e-4
emanuel,55,boy,2,57,1.582397081726645e-4
kade,55,boy,13,68,1.8877719571475766e-4
mahdi,55,boy,1,56,1.5546357294156512e-4
wojciech,55,boy,4,59,1.6379197863486327e-4
cain,54,boy,3,57,1.582397081726645e-4
franky,54,boy,0,54,1.4991130247936636e-4
greyson,54,boy,0,54,1.4991130247936636e-4
hadi,54,boy,2,56,1.5546357294156512e-4
hamzah,54,boy,2,56,1.5546357294156512e-4
jeremy,54,boy,0,54,1.4991130247936636e-4
kylo,54,boy,4,58,1.6101584340376388e-4
rocky,54,boy,1,55,1.5268743771046576e-4
ross,54,boy,63,117,3.2480782203862715e-4
rylee,54,boy,1,55,1.5268743771046576e-4
uzair,54,boy,4,58,1.6101584340376388e-4
wilson,54,boy,6,60,1.6656811386596263e-4
arnie,53,boy,1,54,1.4991130247936636e-4
calum,53,boy,80,133,3.692259857362172e-4
caspian,53,boy,1,54,1.4991130247936636e-4
clay,53,boy,3,56,1.5546357294156512e-4
giovanni,53,boy,1,54,1.4991130247936636e-4
guy,53,boy,6,59,1.6379197863486327e-4
hubert,53,boy,8,61,1.6934424909706203e-4
jared,53,boy,6,59,1.6379197863486327e-4
keyaan,53,boy,1,54,1.4991130247936636e-4
teodor,53,boy,1,54,1.4991130247936636e-4
vihaan,53,boy,1,54,1.4991130247936636e-4
viktor,53,boy,5,58,1.6101584340376388e-4
vinny,53,boy,3,56,1.5546357294156512e-4
carlos,52,boy,0,52,1.443590320171676e-4
caspar,52,boy,2,54,1.4991130247936636e-4
ciaran,52,boy,23,75,2.082101423324533e-4
gregory,52,boy,0,52,1.443590320171676e-4
herbert,52,boy,1,53,1.47135167248267e-4
ishaan,52,boy,2,54,1.4991130247936636e-4
roscoe,52,boy,0,52,1.443590320171676e-4
sahib,52,boy,0,52,1.443590320171676e-4
tomasz,52,boy,4,56,1.5546357294156512e-4
amos,51,boy,1,52,1.443590320171676e-4
drew,51,boy,7,58,1.6101584340376388e-4
farhan,51,boy,3,54,1.4991130247936636e-4
kajus,51,boy,0,51,1.4158289678606824e-4
kenzie,51,boy,16,67,1.8600106048365827e-4
neil,51,boy,10,61,1.6934424909706203e-4
neo,51,boy,2,53,1.47135167248267e-4
reyansh,51,boy,5,56,1.5546357294156512e-4
winston,51,boy,0,51,1.4158289678606824e-4
zackary,51,boy,3,54,1.4991130247936636e-4
antony,50,boy,9,59,1.6379197863486327e-4
cristian,50,boy,1,51,1.4158289678606824e-4
edmund,50,boy,1,51,1.4158289678606824e-4
fionn,50,boy,13,63,1.7489651955926078e-4
hasnain,50,boy,1,51,1.4158289678606824e-4
stanislaw,50,boy,6,56,1.5546357294156512e-4
yanis,50,boy,1,51,1.4158289678606824e-4
ace,49,boy,3,52,1.443590320171676e-4
damien,49,boy,6,55,1.5268743771046576e-4
fred,49,boy,4,53,1.47135167248267e-4
jayce,49,boy,14,63,1.7489651955926078e-4
jorge,49,boy,2,51,1.4158289678606824e-4
keaton,49,boy,0,49,1.360306263238695e-4
mahir,49,boy,0,49,1.360306263238695e-4
matthias,49,boy,2,51,1.4158289678606824e-4
nathanael,49,boy,1,50,1.3880676155496885e-4
owain,49,boy,0,49,1.360306263238695e-4
raees,49,boy,1,50,1.3880676155496885e-4
rome,49,boy,2,51,1.4158289678606824e-4
warren,49,boy,5,54,1.4991130247936636e-4
ziggy,49,boy,2,51,1.4158289678606824e-4
addison,48,boy,2,50,1.3880676155496885e-4
aran,48,boy,2,50,1.3880676155496885e-4
aubrey,48,boy,1,49,1.360306263238695e-4
dion,48,boy,0,48,1.3325449109277012e-4
emilio,48,boy,2,50,1.3880676155496885e-4
harlan,48,boy,2,50,1.3880676155496885e-4
kiaan,48,boy,1,49,1.360306263238695e-4
killian,48,boy,8,56,1.5546357294156512e-4
maison,48,boy,4,52,1.443590320171676e-4
mathew,48,boy,2,50,1.3880676155496885e-4
matias,48,boy,3,51,1.4158289678606824e-4
nojus,48,boy,1,49,1.360306263238695e-4
tommie,48,boy,0,48,1.3325449109277012e-4
valentino,48,boy,0,48,1.3325449109277012e-4
cayson,47,boy,4,51,1.4158289678606824e-4
edgar,47,boy,2,49,1.360306263238695e-4
emmett,47,boy,3,50,1.3880676155496885e-4
haydn,47,boy,0,47,1.3047835586167073e-4
kareem,47,boy,1,48,1.3325449109277012e-4
osman,47,boy,0,47,1.3047835586167073e-4
alfie-james,46,boy,0,46,1.2770222063057137e-4
amar,46,boy,0,46,1.2770222063057137e-4
cory,46,boy,8,54,1.4991130247936636e-4
ieuan,46,boy,1,47,1.3047835586167073e-4
lowen,46,boy,1,47,1.3047835586167073e-4
miguel,46,boy,3,49,1.360306263238695e-4
mikael,46,boy,1,47,1.3047835586167073e-4
orlando,46,boy,0,46,1.2770222063057137e-4
ralphy,46,boy,0,46,1.2770222063057137e-4
rueben,46,boy,4,50,1.3880676155496885e-4
ryley,46,boy,5,51,1.4158289678606824e-4
tudor,46,boy,2,48,1.3325449109277012e-4
vivaan,46,boy,0,46,1.2770222063057137e-4
wilf,46,boy,0,46,1.2770222063057137e-4
yasir,46,boy,5,51,1.4158289678606824e-4
zander,46,boy,24,70,1.9432946617695641e-4
artur,45,boy,7,52,1.443590320171676e-4
colin,45,boy,11,56,1.5546357294156512e-4
eren,45,boy,0,45,1.2492608539947198e-4
harper,45,boy,6,51,1.4158289678606824e-4
hughie,45,boy,1,46,1.2770222063057137e-4
jaydon,45,boy,1,46,1.2770222063057137e-4
ronald,45,boy,4,49,1.360306263238695e-4
sebastien,45,boy,2,47,1.3047835586167073e-4
youssef,45,boy,2,47,1.3047835586167073e-4
zayden,45,boy,3,48,1.3325449109277012e-4
aronas,44,boy,3,47,1.3047835586167073e-4
ayyub,44,boy,0,44,1.221499501683726e-4
faizan,44,boy,4,48,1.3325449109277012e-4
haaris,44,boy,4,48,1.3325449109277012e-4
ishaaq,44,boy,0,44,1.221499501683726e-4
iwan,44,boy,1,45,1.2492608539947198e-4
wade,44,boy,0,44,1.221499501683726e-4
abdirahman,43,boy,0,43,1.1937381493727322e-4
adil,43,boy,1,44,1.221499501683726e-4
ammar,43,boy,1,44,1.221499501683726e-4
harlow,43,boy,1,44,1.221499501683726e-4
jaxx,43,boy,7,50,1.3880676155496885e-4
marc,43,boy,13,56,1.5546357294156512e-4
ronny,43,boy,0,43,1.1937381493727322e-4
saul,43,boy,10,53,1.47135167248267e-4
tommy-lee,43,boy,0,43,1.1937381493727322e-4
abbas,42,boy,0,42,1.1659767970617384e-4
aden,42,boy,0,42,1.1659767970617384e-4
huzaifa,42,boy,0,42,1.1659767970617384e-4
ismael,42,boy,2,44,1.221499501683726e-4
kaiser,42,boy,2,44,1.221499501683726e-4
karim,42,boy,2,44,1.221499501683726e-4
kenny,42,boy,1,43,1.1937381493727322e-4
klay,42,boy,3,45,1.2492608539947198e-4
kodi,42,boy,10,52,1.443590320171676e-4
lewie,42,boy,0,42,1.1659767970617384e-4
presley,42,boy,1,43,1.1937381493727322e-4
qasim,42,boy,1,43,1.1937381493727322e-4
ranveer,42,boy,3,45,1.2492608539947198e-4
reegan,42,boy,2,44,1.221499501683726e-4
theodor,42,boy,1,43,1.1937381493727322e-4
vlad,42,boy,0,42,1.1659767970617384e-4
abubakar,41,boy,1,42,1.1659767970617384e-4
chris,41,boy,5,46,1.2770222063057137e-4
franco,41,boy,4,45,1.2492608539947198e-4
huw,41,boy,1,42,1.1659767970617384e-4
malachy,41,boy,5,46,1.2770222063057137e-4
sahil,41,boy,3,44,1.221499501683726e-4
samir,41,boy,1,42,1.1659767970617384e-4
santino,41,boy,4,45,1.2492608539947198e-4
shayaan,41,boy,3,44,1.221499501683726e-4
talha,41,boy,1,42,1.1659767970617384e-4
zayne,41,boy,3,44,1.221499501683726e-4
danielius,40,boy,3,43,1.1937381493727322e-4
deen,40,boy,0,40,1.110454092439751e-4
denny,40,boy,3,43,1.1937381493727322e-4
eryk,40,boy,5,45,1.2492608539947198e-4
fredrick,40,boy,2,42,1.1659767970617384e-4
harlen,40,boy,3,43,1.1937381493727322e-4
huey,40,boy,0,40,1.110454092439751e-4
kason,40,boy,2,42,1.1659767970617384e-4
kaylan,40,boy,1,41,1.1382154447507448e-4
leland,40,boy,1,41,1.1382154447507448e-4
lucien,40,boy,0,40,1.110454092439751e-4
maciej,40,boy,3,43,1.1937381493727322e-4
nelson,40,boy,0,40,1.110454092439751e-4
rares,40,boy,0,40,1.110454092439751e-4
riaan,40,boy,2,42,1.1659767970617384e-4
simeon,40,boy,2,42,1.1659767970617384e-4
tiago,40,boy,4,44,1.221499501683726e-4
abu,39,boy,1,40,1.110454092439751e-4
alexis,39,boy,0,39,1.0826927401287572e-4
aman,39,boy,0,39,1.0826927401287572e-4
baxter,39,boy,1,40,1.110454092439751e-4
boris,39,boy,1,40,1.110454092439751e-4
callan,39,boy,68,107,2.970464697276334e-4
dev,39,boy,1,40,1.110454092439751e-4
gideon,39,boy,3,42,1.1659767970617384e-4
johan,39,boy,2,41,1.1382154447507448e-4
karter,39,boy,6,45,1.2492608539947198e-4
kaya,39,boy,0,39,1.0826927401287572e-4
kenneth,39,boy,13,52,1.443590320171676e-4
owais,39,boy,1,40,1.110454092439751e-4
reign,39,boy,1,40,1.110454092439751e-4
tymoteusz,39,boy,4,43,1.1937381493727322e-4
alessio,38,boy,1,39,1.0826927401287572e-4
arian,38,boy,3,41,1.1382154447507448e-4
cade,38,boy,4,42,1.1659767970617384e-4
emrys,38,boy,1,39,1.0826927401287572e-4
eoin,38,boy,9,47,1.3047835586167073e-4
hashir,38,boy,2,40,1.110454092439751e-4
herbie,38,boy,0,38,1.0549313878177634e-4
jeevan,38,boy,1,39,1.0826927401287572e-4
karam,38,boy,2,40,1.110454092439751e-4
kaylen,38,boy,1,39,1.0826927401287572e-4
lloyd,38,boy,5,43,1.1937381493727322e-4
lyle,38,boy,65,103,2.859419288032359e-4
mikail,38,boy,2,40,1.110454092439751e-4
niko,38,boy,5,43,1.1937381493727322e-4
omari,38,boy,0,38,1.0549313878177634e-4
pedro,38,boy,3,41,1.1382154447507448e-4
raja,38,boy,1,39,1.0826927401287572e-4
raul,38,boy,0,38,1.0549313878177634e-4
riley-james,38,boy,1,39,1.0826927401287572e-4
ruairi,38,boy,16,54,1.4991130247936636e-4
safwan,38,boy,0,38,1.0549313878177634e-4
saif,38,boy,0,38,1.0549313878177634e-4
saxon,38,boy,0,38,1.0549313878177634e-4
shea,38,boy,6,44,1.221499501683726e-4
tyrese,38,boy,2,40,1.110454092439751e-4
abdullahi,37,boy,1,38,1.0549313878177634e-4
dilan,37,boy,1,38,1.0549313878177634e-4
emre,37,boy,3,40,1.110454092439751e-4
gilbert,37,boy,0,37,1.0271700355067696e-4
karol,37,boy,1,38,1.0549313878177634e-4
king,37,boy,2,39,1.0826927401287572e-4
kobie,37,boy,2,39,1.0826927401287572e-4
mehmet,37,boy,2,39,1.0826927401287572e-4
soren,37,boy,5,42,1.1659767970617384e-4
sufyan,37,boy,1,38,1.0549313878177634e-4
zakariyah,37,boy,0,37,1.0271700355067696e-4
zaki,37,boy,2,39,1.0826927401287572e-4
abubakr,36,boy,0,36,9.994086831957759e-5
alastair,36,boy,11,47,1.3047835586167073e-4
ayaz,36,boy,1,37,1.0271700355067696e-4
charley,36,boy,0,36,9.994086831957759e-5
conrad,36,boy,3,39,1.0826927401287572e-4
eben,36,boy,2,38,1.0549313878177634e-4
gene,36,boy,3,39,1.0826927401287572e-4
hakeem,36,boy,0,36,9.994086831957759e-5
luqman,36,boy,1,37,1.0271700355067696e-4
maverick,36,boy,1,37,1.0271700355067696e-4
paddy,36,boy,1,37,1.0271700355067696e-4
seb,36,boy,1,37,1.0271700355067696e-4
taylan,36,boy,1,37,1.0271700355067696e-4
teo,36,boy,2,38,1.0549313878177634e-4
amin,35,boy,1,36,9.994086831957759e-5
arman,35,boy,1,36,9.994086831957759e-5
bowie,35,boy,1,36,9.994086831957759e-5
colton,35,boy,13,48,1.3325449109277012e-4
dawood,35,boy,3,38,1.0549313878177634e-4
elwood,35,boy,1,36,9.994086831957759e-5
etienne,35,boy,1,36,9.994086831957759e-5
harun,35,boy,2,37,1.0271700355067696e-4
jaylen,35,boy,0,35,9.716473308847821e-5
jose,35,boy,0,35,9.716473308847821e-5
kayan,35,boy,0,35,9.716473308847821e-5
krystian,35,boy,5,40,1.110454092439751e-4
lucca,35,boy,6,41,1.1382154447507448e-4
phillip,35,boy,1,36,9.994086831957759e-5
ridwan,35,boy,0,35,9.716473308847821e-5
rishi,35,boy,1,36,9.994086831957759e-5
shiv,35,boy,0,35,9.716473308847821e-5
steffan,35,boy,2,37,1.0271700355067696e-4
sulayman,35,boy,2,37,1.0271700355067696e-4
alexandre,34,boy,1,35,9.716473308847821e-5
andy,34,boy,6,40,1.110454092439751e-4
eshan,34,boy,0,34,9.438859785737883e-5
griff,34,boy,1,35,9.716473308847821e-5
ivor,34,boy,7,41,1.1382154447507448e-4
jaydan,34,boy,1,35,9.716473308847821e-5
maksim,34,boy,2,36,9.994086831957759e-5
nikita,34,boy,1,35,9.716473308847821e-5
noa,34,boy,0,34,9.438859785737883e-5
shae,34,boy,5,39,1.0826927401287572e-4
theon,34,boy,0,34,9.438859785737883e-5
abdurrahman,33,boy,1,34,9.438859785737883e-5
albi,33,boy,2,35,9.716473308847821e-5
brady,33,boy,5,38,1.0549313878177634e-4
buster,33,boy,0,33,9.161246262627945e-5
eshaan,33,boy,1,34,9.438859785737883e-5
iosif,33,boy,0,33,9.161246262627945e-5
josef,33,boy,1,34,9.438859785737883e-5
karson,33,boy,7,40,1.110454092439751e-4
krzysztof,33,boy,5,38,1.0549313878177634e-4
kush,33,boy,0,33,9.161246262627945e-5
nataniel,33,boy,2,35,9.716473308847821e-5
tyler-james,33,boy,2,35,9.716473308847821e-5
tyson,33,boy,0,33,9.161246262627945e-5
zephaniah,33,boy,0,33,9.161246262627945e-5
adem,32,boy,4,36,9.994086831957759e-5
ahyan,32,boy,0,32,8.883632739518007e-5
aneurin,32,boy,3,35,9.716473308847821e-5
ariyan,32,boy,1,33,9.161246262627945e-5
arnold,32,boy,0,32,8.883632739518007e-5
arran,32,boy,127,159,4.41405501744801e-4
brendan,32,boy,5,37,1.0271700355067696e-4
bryn,32,boy,2,34,9.438859785737883e-5
cyrus,32,boy,0,32,8.883632739518007e-5
danyal,32,boy,4,36,9.994086831957759e-5
dhruv,32,boy,3,35,9.716473308847821e-5
forrest,32,boy,2,34,9.438859785737883e-5
kaelan,32,boy,4,36,9.994086831957759e-5
keon,32,boy,0,32,8.883632739518007e-5
manveer,32,boy,1,33,9.161246262627945e-5
mathias,32,boy,0,32,8.883632739518007e-5
raife,32,boy,2,34,9.438859785737883e-5
subhaan,32,boy,0,32,8.883632739518007e-5
atlas,31,boy,0,31,8.60601921640807e-5
avi,31,boy,0,31,8.60601921640807e-5
benas,31,boy,1,32,8.883632739518007e-5
benny,31,boy,1,32,8.883632739518007e-5
bernard,31,boy,4,35,9.716473308847821e-5
bobbie,31,boy,0,31,8.60601921640807e-5
caio,31,boy,1,32,8.883632739518007e-5
callen,31,boy,16,47,1.3047835586167073e-4
carl,31,boy,2,33,9.161246262627945e-5
donovan,31,boy,2,33,9.161246262627945e-5
eliot,31,boy,0,31,8.60601921640807e-5
essa,31,boy,3,34,9.438859785737883e-5
gerard,31,boy,5,36,9.994086831957759e-5
iestyn,31,boy,0,31,8.60601921640807e-5
jayson,31,boy,3,34,9.438859785737883e-5
jonny,31,boy,2,33,9.161246262627945e-5
kiyan,31,boy,0,31,8.60601921640807e-5
kole,31,boy,7,38,1.0549313878177634e-4
konrad,31,boy,5,36,9.994086831957759e-5
ksawery,31,boy,3,34,9.438859785737883e-5
kurtis,31,boy,7,38,1.0549313878177634e-4
mohamad,31,boy,2,33,9.161246262627945e-5
montague,31,boy,0,31,8.60601921640807e-5
ricardo,31,boy,2,33,9.161246262627945e-5
richie,31,boy,7,38,1.0549313878177634e-4
waleed,31,boy,1,32,8.883632739518007e-5
yash,31,boy,1,32,8.883632739518007e-5
zavier,31,boy,0,31,8.60601921640807e-5
adriel,30,boy,2,32,8.883632739518007e-5
domas,30,boy,1,31,8.60601921640807e-5
elvis,30,boy,1,31,8.60601921640807e-5
gus,30,boy,1,31,8.60601921640807e-5
ivo,30,boy,2,32,8.883632739518007e-5
kaison,30,boy,4,34,9.438859785737883e-5
kendrick,30,boy,1,31,8.60601921640807e-5
kieron,30,boy,3,33,9.161246262627945e-5
kuba,30,boy,1,31,8.60601921640807e-5
leopold,30,boy,1,31,8.60601921640807e-5
mackenzie,30,boy,2,32,8.883632739518007e-5
manuel,30,boy,1,31,8.60601921640807e-5
maxime,30,boy,0,30,8.328405693298132e-5
niam,30,boy,0,30,8.328405693298132e-5
roshan,30,boy,0,30,8.328405693298132e-5
sai,30,boy,1,31,8.60601921640807e-5
sheikh,30,boy,1,31,8.60601921640807e-5
sol,30,boy,3,33,9.161246262627945e-5
thiago,30,boy,0,30,8.328405693298132e-5
umair,30,boy,0,30,8.328405693298132e-5
alexandros,29,boy,1,30,8.328405693298132e-5
arun,29,boy,1,30,8.328405693298132e-5
axl,29,boy,2,31,8.60601921640807e-5
ayrton,29,boy,2,31,8.60601921640807e-5
baran,29,boy,0,29,8.050792170188194e-5
cormac,29,boy,9,38,1.0549313878177634e-4
damon,29,boy,7,36,9.994086831957759e-5
findlay,29,boy,41,70,1.9432946617695641e-4
jayden-lee,29,boy,2,31,8.60601921640807e-5
jokubas,29,boy,1,30,8.328405693298132e-5
kamran,29,boy,0,29,8.050792170188194e-5
keelan,29,boy,2,31,8.60601921640807e-5
loui,29,boy,3,32,8.883632739518007e-5
milosz,29,boy,4,33,9.161246262627945e-5
nikhil,29,boy,1,30,8.328405693298132e-5
pawel,29,boy,4,33,9.161246262627945e-5
riyan,29,boy,0,29,8.050792170188194e-5
rodrigo,29,boy,0,29,8.050792170188194e-5
saad,29,boy,3,32,8.883632739518007e-5
sacha,29,boy,0,29,8.050792170188194e-5
salahuddin,29,boy,0,29,8.050792170188194e-5
sammy,29,boy,3,32,8.883632739518007e-5
shaan,29,boy,0,29,8.050792170188194e-5
shiloh,29,boy,3,32,8.883632739518007e-5
sunny,29,boy,3,32,8.883632739518007e-5
taran,29,boy,1,30,8.328405693298132e-5
tomi,29,boy,0,29,8.050792170188194e-5
viaan,29,boy,1,30,8.328405693298132e-5
alberto,28,boy,0,28,7.773178647078256e-5
ameer,28,boy,2,30,8.328405693298132e-5
arvin,28,boy,1,29,8.050792170188194e-5
baby,28,boy,0,28,7.773178647078256e-5
borys,28,boy,2,30,8.328405693298132e-5
carlo,28,boy,5,33,9.161246262627945e-5
chace,28,boy,2,30,8.328405693298132e-5
emilis,28,boy,1,29,8.050792170188194e-5
henryk,28,boy,2,30,8.328405693298132e-5
issa,28,boy,1,29,8.050792170188194e-5
izaan,28,boy,0,28,7.773178647078256e-5
jad,28,boy,1,29,8.050792170188194e-5
jowan,28,boy,0,28,7.773178647078256e-5
jozef,28,boy,0,28,7.773178647078256e-5
kenzo,28,boy,2,30,8.328405693298132e-5
laurie,28,boy,4,32,8.883632739518007e-5
leandro,28,boy,2,30,8.328405693298132e-5
lockie,28,boy,8,36,9.994086831957759e-5
mayson,28,boy,9,37,1.0271700355067696e-4
moshe,28,boy,0,28,7.773178647078256e-5
nikolai,28,boy,2,30,8.328405693298132e-5
oren,28,boy,0,28,7.773178647078256e-5
rafi,28,boy,0,28,7.773178647078256e-5
raihan,28,boy,0,28,7.773178647078256e-5
rayhan,28,boy,2,30,8.328405693298132e-5
sydney,28,boy,3,31,8.60601921640807e-5
yousaf,28,boy,4,32,8.883632739518007e-5
zeeshan,28,boy,1,29,8.050792170188194e-5
abu-bakr,27,boy,1,28,7.773178647078256e-5
akram,27,boy,0,27,7.495565123968318e-5
denzel,27,boy,1,28,7.773178647078256e-5
dewi,27,boy,0,27,7.495565123968318e-5
dhilan,27,boy,1,28,7.773178647078256e-5
diyan,27,boy,0,27,7.495565123968318e-5
elyas,27,boy,0,27,7.495565123968318e-5
gary,27,boy,16,43,1.1937381493727322e-4
giorgio,27,boy,0,27,7.495565123968318e-5
gruffydd,27,boy,0,27,7.495565123968318e-5
haiden,27,boy,3,30,8.328405693298132e-5
harley-james,27,boy,0,27,7.495565123968318e-5
haseeb,27,boy,2,29,8.050792170188194e-5
humza,27,boy,3,30,8.328405693298132e-5
hussein,27,boy,0,27,7.495565123968318e-5
ifan,27,boy,1,28,7.773178647078256e-5
jethro,27,boy,0,27,7.495565123968318e-5
jon,27,boy,4,31,8.60601921640807e-5
kaine,27,boy,3,30,8.328405693298132e-5
moise,27,boy,0,27,7.495565123968318e-5
oliver-james,27,boy,0,27,7.495565123968318e-5
riyad,27,boy,1,28,7.773178647078256e-5
shah,27,boy,1,28,7.773178647078256e-5
sufyaan,27,boy,0,27,7.495565123968318e-5
tadhg,27,boy,1,28,7.773178647078256e-5
tyrone,27,boy,0,27,7.495565123968318e-5
vladimir,27,boy,2,29,8.050792170188194e-5
yisroel,27,boy,0,27,7.495565123968318e-5
yousif,27,boy,1,28,7.773178647078256e-5
zaydan,27,boy,3,30,8.328405693298132e-5
zidane,27,boy,0,27,7.495565123968318e-5
abdur,26,boy,0,26,7.21795160085838e-5
aj,26,boy,3,29,8.050792170188194e-5
alejandro,26,boy,0,26,7.21795160085838e-5
aris,26,boy,1,27,7.495565123968318e-5
ash,26,boy,4,30,8.328405693298132e-5
ashwin,26,boy,0,26,7.21795160085838e-5
august,26,boy,3,29,8.050792170188194e-5
austen,26,boy,5,31,8.60601921640807e-5
ayoub,26,boy,2,28,7.773178647078256e-5
bogdan,26,boy,2,28,7.773178647078256e-5
braydon,26,boy,2,28,7.773178647078256e-5
camden,26,boy,1,27,7.495565123968318e-5
clement,26,boy,0,26,7.21795160085838e-5
dillan,26,boy,3,29,8.050792170188194e-5
duncan,26,boy,26,52,1.443590320171676e-4
efan,26,boy,0,26,7.21795160085838e-5
enoch,26,boy,0,26,7.21795160085838e-5
fabio,26,boy,2,28,7.773178647078256e-5
gavin,26,boy,7,33,9.161246262627945e-5
hamid,26,boy,1,27,7.495565123968318e-5
jarvis,26,boy,0,26,7.21795160085838e-5
jayden-james,26,boy,0,26,7.21795160085838e-5
jed,26,boy,3,29,8.050792170188194e-5
jerome,26,boy,1,27,7.495565123968318e-5
jonty,26,boy,0,26,7.21795160085838e-5
karl,26,boy,1,27,7.495565123968318e-5
kelvin,26,boy,6,32,8.883632739518007e-5
markus,26,boy,8,34,9.438859785737883e-5
marvin,26,boy,3,29,8.050792170188194e-5
murphy,26,boy,4,30,8.328405693298132e-5
nuh,26,boy,0,26,7.21795160085838e-5
oli,26,boy,2,28,7.773178647078256e-5
orin,26,boy,4,30,8.328405693298132e-5
quentin,26,boy,1,27,7.495565123968318e-5
riley-jay,26,boy,0,26,7.21795160085838e-5
timur,26,boy,2,28,7.773178647078256e-5
tyler-jay,26,boy,2,28,7.773178647078256e-5
tyrell,26,boy,0,26,7.21795160085838e-5
wali,26,boy,0,26,7.21795160085838e-5
yannis,26,boy,2,28,7.773178647078256e-5
zakariah,26,boy,1,27,7.495565123968318e-5
zubair,26,boy,0,26,7.21795160085838e-5
aras,25,boy,4,29,8.050792170188194e-5
aryaan,25,boy,0,25,6.940338077748443e-5
azlan,25,boy,2,27,7.495565123968318e-5
bryson,25,boy,1,26,7.21795160085838e-5
carlton,25,boy,0,25,6.940338077748443e-5
chaim,25,boy,0,25,6.940338077748443e-5
darragh,25,boy,12,37,1.0271700355067696e-4
eduardo,25,boy,1,26,7.21795160085838e-5
ehsan,25,boy,1,26,7.21795160085838e-5
faisal,25,boy,0,25,6.940338077748443e-5
fateh,25,boy,0,25,6.940338077748443e-5
francisco,25,boy,1,26,7.21795160085838e-5
harold,25,boy,2,27,7.495565123968318e-5
jules,25,boy,0,25,6.940338077748443e-5
kerem,25,boy,1,26,7.21795160085838e-5
lewys,25,boy,0,25,6.940338077748443e-5
luther,25,boy,0,25,6.940338077748443e-5
marlow,25,boy,0,25,6.940338077748443e-5
marty,25,boy,1,26,7.21795160085838e-5
perry,25,boy,4,29,8.050792170188194e-5
pietro,25,boy,0,25,6.940338077748443e-5
rajveer,25,boy,0,25,6.940338077748443e-5
reilly,25,boy,6,31,8.60601921640807e-5
ricky,25,boy,2,27,7.495565123968318e-5
roan,25,boy,12,37,1.0271700355067696e-4
roland,25,boy,0,25,6.940338077748443e-5
rudra,25,boy,0,25,6.940338077748443e-5
sameer,25,boy,0,25,6.940338077748443e-5
terence,25,boy,1,26,7.21795160085838e-5
tommaso,25,boy,2,27,7.495565123968318e-5
trystan,25,boy,0,25,6.940338077748443e-5
woodrow,25,boy,1,26,7.21795160085838e-5
yehuda,25,boy,0,25,6.940338077748443e-5
zorawar,25,boy,1,26,7.21795160085838e-5
alyaan,24,boy,1,25,6.940338077748443e-5
ansh,24,boy,0,24,6.662724554638506e-5
arley,24,boy,0,24,6.662724554638506e-5
bryce,24,boy,9,33,9.161246262627945e-5
clarke,24,boy,2,26,7.21795160085838e-5
craig,24,boy,19,43,1.1937381493727322e-4
denver,24,boy,3,27,7.495565123968318e-5
ellison,24,boy,1,25,6.940338077748443e-5
eyad,24,boy,1,25,6.940338077748443e-5
hammad,24,boy,1,25,6.940338077748443e-5
jak,24,boy,7,31,8.60601921640807e-5
javier,24,boy,0,24,6.662724554638506e-5
jibril,24,boy,1,25,6.940338077748443e-5
joao,24,boy,1,25,6.940338077748443e-5
keyan,24,boy,1,25,6.940338077748443e-5
kohen,24,boy,1,25,6.940338077748443e-5
levison,24,boy,0,24,6.662724554638506e-5
marek,24,boy,1,25,6.940338077748443e-5
memphis,24,boy,0,24,6.662724554638506e-5
mikhail,24,boy,0,24,6.662724554638506e-5
miran,24,boy,1,25,6.940338077748443e-5
morris,24,boy,3,27,7.495565123968318e-5
nehemiah,24,boy,0,24,6.662724554638506e-5
pablo,24,boy,1,25,6.940338077748443e-5
reyan,24,boy,0,24,6.662724554638506e-5
sayed,24,boy,0,24,6.662724554638506e-5
suleiman,24,boy,0,24,6.662724554638506e-5
valentin,24,boy,1,25,6.940338077748443e-5
zackariya,24,boy,0,24,6.662724554638506e-5
zaiden,24,boy,1,25,6.940338077748443e-5
advik,23,boy,1,24,6.662724554638506e-5
ahad,23,boy,0,23,6.385111031528568e-5
alasdair,23,boy,23,46,1.2770222063057137e-4
aled,23,boy,0,23,6.385111031528568e-5
aleks,23,boy,2,25,6.940338077748443e-5
alvin,23,boy,1,24,6.662724554638506e-5
arlie,23,boy,0,23,6.385111031528568e-5
arnav,23,boy,0,23,6.385111031528568e-5
ayomide,23,boy,0,23,6.385111031528568e-5
azariah,23,boy,0,23,6.385111031528568e-5
bjorn,23,boy,4,27,7.495565123968318e-5
bodie,23,boy,0,23,6.385111031528568e-5
chayse,23,boy,0,23,6.385111031528568e-5
cohan,23,boy,2,25,6.940338077748443e-5
dara,23,boy,3,26,7.21795160085838e-5
dhyan,23,boy,0,23,6.385111031528568e-5
eddison,23,boy,0,23,6.385111031528568e-5
elisha,23,boy,0,23,6.385111031528568e-5
enes,23,boy,0,23,6.385111031528568e-5
fahad,23,boy,0,23,6.385111031528568e-5
georgi,23,boy,1,24,6.662724554638506e-5
gurveer,23,boy,1,24,6.662724554638506e-5
ishan,23,boy,0,23,6.385111031528568e-5
jay-jay,23,boy,2,25,6.940338077748443e-5
joshua-james,23,boy,0,23,6.385111031528568e-5
kellan,23,boy,3,26,7.21795160085838e-5
kion,23,boy,3,26,7.21795160085838e-5
korey,23,boy,2,25,6.940338077748443e-5
krishan,23,boy,0,23,6.385111031528568e-5
krishna,23,boy,1,24,6.662724554638506e-5
luciano,23,boy,0,23,6.385111031528568e-5
lucius,23,boy,1,24,6.662724554638506e-5
obi,23,boy,0,23,6.385111031528568e-5
ren,23,boy,2,25,6.940338077748443e-5
roy,23,boy,3,26,7.21795160085838e-5
russell,23,boy,4,27,7.495565123968318e-5
saleh,23,boy,1,24,6.662724554638506e-5
salvador,23,boy,0,23,6.385111031528568e-5
shaurya,23,boy,1,24,6.662724554638506e-5
sonnie,23,boy,0,23,6.385111031528568e-5
tajus,23,boy,3,26,7.21795160085838e-5
terry,23,boy,1,24,6.662724554638506e-5
todd,23,boy,0,23,6.385111031528568e-5
uthman,23,boy,0,23,6.385111031528568e-5
younis,23,boy,2,25,6.940338077748443e-5
yusha,23,boy,4,27,7.495565123968318e-5
zaidan,23,boy,1,24,6.662724554638506e-5
aamir,22,boy,1,23,6.385111031528568e-5
alfie-jay,22,boy,2,24,6.662724554638506e-5
alfie-lee,22,boy,0,22,6.10749750841863e-5
arron,22,boy,7,29,8.050792170188194e-5
blu,22,boy,0,22,6.10749750841863e-5
conan,22,boy,7,29,8.050792170188194e-5
daniil,22,boy,1,23,6.385111031528568e-5
dario,22,boy,4,26,7.21795160085838e-5
dax,22,boy,0,22,6.10749750841863e-5
digby,22,boy,0,22,6.10749750841863e-5
domantas,22,boy,0,22,6.10749750841863e-5
herkus,22,boy,0,22,6.10749750841863e-5
ihsan,22,boy,0,22,6.10749750841863e-5
immanuel,22,boy,1,23,6.385111031528568e-5
izaak,22,boy,0,22,6.10749750841863e-5
jadon,22,boy,1,23,6.385111031528568e-5
jameson,22,boy,0,22,6.10749750841863e-5
jermaine,22,boy,0,22,6.10749750841863e-5
johnathan,22,boy,2,24,6.662724554638506e-5
jolan,22,boy,0,22,6.10749750841863e-5
kallum,22,boy,5,27,7.495565123968318e-5
kurt,22,boy,2,24,6.662724554638506e-5
lochlann,22,boy,5,27,7.495565123968318e-5
logan-james,22,boy,1,23,6.385111031528568e-5
lyndon,22,boy,0,22,6.10749750841863e-5
macauley,22,boy,2,24,6.662724554638506e-5
marlon,22,boy,1,23,6.385111031528568e-5
musab,22,boy,4,26,7.21795160085838e-5
nihal,22,boy,0,22,6.10749750841863e-5
ozzy,22,boy,1,23,6.385111031528568e-5
rishaan,22,boy,0,22,6.10749750841863e-5
rohaan,22,boy,1,23,6.385111031528568e-5
rubin,22,boy,1,23,6.385111031528568e-5
stuart,22,boy,15,37,1.0271700355067696e-4
vincenzo,22,boy,1,23,6.385111031528568e-5
wayne,22,boy,0,22,6.10749750841863e-5
zohaib,22,boy,0,22,6.10749750841863e-5
abdur-rahman,21,boy,2,23,6.385111031528568e-5
angad,21,boy,0,21,5.829883985308692e-5
apollo,21,boy,0,21,5.829883985308692e-5
arya,21,boy,0,21,5.829883985308692e-5
awais,21,boy,1,22,6.10749750841863e-5
aydan,21,boy,1,22,6.10749750841863e-5
cobie,21,boy,1,22,6.10749750841863e-5
conner,21,boy,2,23,6.385111031528568e-5
deon,21,boy,0,21,5.829883985308692e-5
geoffrey,21,boy,0,21,5.829883985308692e-5
gurfateh,21,boy,0,21,5.829883985308692e-5
inigo,21,boy,1,22,6.10749750841863e-5
iolo,21,boy,0,21,5.829883985308692e-5
jacques,21,boy,0,21,5.829883985308692e-5
jeffrey,21,boy,0,21,5.829883985308692e-5
jerry,21,boy,1,22,6.10749750841863e-5
julius,21,boy,1,22,6.10749750841863e-5
junaid,21,boy,0,21,5.829883985308692e-5
kailen,21,boy,3,24,6.662724554638506e-5
keanu,21,boy,0,21,5.829883985308692e-5
kiran,21,boy,1,22,6.10749750841863e-5
konstantin,21,boy,0,21,5.829883985308692e-5
lance,21,boy,0,21,5.829883985308692e-5
leyland,21,boy,0,21,5.829883985308692e-5
makai,21,boy,1,22,6.10749750841863e-5
malcolm,21,boy,8,29,8.050792170188194e-5
mason-lee,21,boy,0,21,5.829883985308692e-5
mazin,21,boy,1,22,6.10749750841863e-5
mehdi,21,boy,0,21,5.829883985308692e-5
mihai,21,boy,0,21,5.829883985308692e-5
murray,21,boy,107,128,3.553453095807203e-4
nabil,21,boy,0,21,5.829883985308692e-5
pavel,21,boy,1,22,6.10749750841863e-5
quinton,21,boy,3,24,6.662724554638506e-5
rahim,21,boy,0,21,5.829883985308692e-5
raiden,21,boy,2,23,6.385111031528568e-5
rami,21,boy,0,21,5.829883985308692e-5
rion,21,boy,0,21,5.829883985308692e-5
sasha,21,boy,0,21,5.829883985308692e-5
silas,21,boy,4,25,6.940338077748443e-5
suleman,21,boy,0,21,5.829883985308692e-5
thierry,21,boy,0,21,5.829883985308692e-5
viraj,21,boy,0,21,5.829883985308692e-5
yosef,21,boy,0,21,5.829883985308692e-5
zakary,21,boy,0,21,5.829883985308692e-5
zakir,21,boy,2,23,6.385111031528568e-5
zeke,21,boy,0,21,5.829883985308692e-5
zephyr,21,boy,0,21,5.829883985308692e-5
aditya,20,boy,1,21,5.829883985308692e-5
aedan,20,boy,5,25,6.940338077748443e-5
affan,20,boy,1,21,5.829883985308692e-5
alyan,20,boy,1,21,5.829883985308692e-5
anay,20,boy,2,22,6.10749750841863e-5
anderson,20,boy,4,24,6.662724554638506e-5
aren,20,boy,2,22,6.10749750841863e-5
arijus,20,boy,0,20,5.552270462198755e-5
arlen,20,boy,3,23,6.385111031528568e-5
artie,20,boy,0,20,5.552270462198755e-5
augustus,20,boy,0,20,5.552270462198755e-5
aveer,20,boy,0,20,5.552270462198755e-5
aymen,20,boy,0,20,5.552270462198755e-5
beniamin,20,boy,1,21,5.829883985308692e-5
blaise,20,boy,2,22,6.10749750841863e-5
cobey,20,boy,0,20,5.552270462198755e-5
codey,20,boy,0,20,5.552270462198755e-5
darcy,20,boy,0,20,5.552270462198755e-5
devin,20,boy,7,27,7.495565123968318e-5
edoardo,20,boy,1,21,5.829883985308692e-5
efe,20,boy,0,20,5.552270462198755e-5
ekam,20,boy,0,20,5.552270462198755e-5
erick,20,boy,0,20,5.552270462198755e-5
franklyn,20,boy,1,21,5.829883985308692e-5
gray,20,boy,4,24,6.662724554638506e-5
harman,20,boy,1,21,5.829883985308692e-5
harvey-lee,20,boy,0,20,5.552270462198755e-5
ionut,20,boy,0,20,5.552270462198755e-5
khaled,20,boy,1,21,5.829883985308692e-5
kyrie,20,boy,1,21,5.829883985308692e-5
layth,20,boy,0,20,5.552270462198755e-5
mahad,20,boy,0,20,5.552270462198755e-5
marius,20,boy,3,23,6.385111031528568e-5
mattia,20,boy,2,22,6.10749750841863e-5
mert,20,boy,1,21,5.829883985308692e-5
nana,20,boy,1,21,5.829883985308692e-5
ocean,20,boy,0,20,5.552270462198755e-5
patrik,20,boy,2,22,6.10749750841863e-5
raiyan,20,boy,1,21,5.829883985308692e-5
roux,20,boy,0,20,5.552270462198755e-5
sawyer,20,boy,4,24,6.662724554638506e-5
seamus,20,boy,6,26,7.21795160085838e-5
teddy-james,20,boy,0,20,5.552270462198755e-5
trey,20,boy,0,20,5.552270462198755e-5
abdurahman,19,boy,3,22,6.10749750841863e-5
adonis,19,boy,0,19,5.274656939088817e-5
ahsan,19,boy,2,21,5.829883985308692e-5
alban,19,boy,1,20,5.552270462198755e-5
amaar,19,boy,1,20,5.552270462198755e-5
archie-james,19,boy,0,19,5.274656939088817e-5
areeb,19,boy,0,19,5.274656939088817e-5
ashar,19,boy,1,20,5.552270462198755e-5
avrohom,19,boy,0,19,5.274656939088817e-5
aziz,19,boy,0,19,5.274656939088817e-5
bay,19,boy,0,19,5.274656939088817e-5
benson,19,boy,0,19,5.274656939088817e-5
bleu,19,boy,0,19,5.274656939088817e-5
braiden,19,boy,3,22,6.10749750841863e-5
brendon,19,boy,1,20,5.552270462198755e-5
cash,19,boy,2,21,5.829883985308692e-5
castiel,19,boy,0,19,5.274656939088817e-5
chay,19,boy,2,21,5.829883985308692e-5
darwin,19,boy,1,20,5.552270462198755e-5
donnie,19,boy,4,23,6.385111031528568e-5
duke,19,boy,0,19,5.274656939088817e-5
eliezer,19,boy,1,20,5.552270462198755e-5
elisei,19,boy,1,20,5.552270462198755e-5
ephraim,19,boy,0,19,5.274656939088817e-5
finnian,19,boy,2,21,5.829883985308692e-5
frederic,19,boy,0,19,5.274656939088817e-5
gruff,19,boy,0,19,5.274656939088817e-5
gwilym,19,boy,0,19,5.274656939088817e-5
jacob-james,19,boy,1,20,5.552270462198755e-5
jayan,19,boy,0,19,5.274656939088817e-5
kaan,19,boy,1,20,5.552270462198755e-5
kaiyan,19,boy,2,21,5.829883985308692e-5
kamal,19,boy,2,21,5.829883985308692e-5
kaylum,19,boy,3,22,6.10749750841863e-5
kenan,19,boy,1,20,5.552270462198755e-5
kevinas,19,boy,1,20,5.552270462198755e-5
kuzey,19,boy,1,20,5.552270462198755e-5
landon,19,boy,0,19,5.274656939088817e-5
lars,19,boy,0,19,5.274656939088817e-5
mack,19,boy,3,22,6.10749750841863e-5
manraj,19,boy,0,19,5.274656939088817e-5
marlo,19,boy,0,19,5.274656939088817e-5
mohid,19,boy,2,21,5.829883985308692e-5
murtaza,19,boy,0,19,5.274656939088817e-5
naksh,19,boy,0,19,5.274656939088817e-5
olivers,19,boy,1,20,5.552270462198755e-5
percival,19,boy,0,19,5.274656939088817e-5
pranav,19,boy,0,19,5.274656939088817e-5
raef,19,boy,0,19,5.274656939088817e-5
reon,19,boy,1,20,5.552270462198755e-5
rhodri,19,boy,0,19,5.274656939088817e-5
roberto,19,boy,1,20,5.552270462198755e-5
ronin,19,boy,5,24,6.662724554638506e-5
saeed,19,boy,0,19,5.274656939088817e-5
said,19,boy,0,19,5.274656939088817e-5
sid,19,boy,1,20,5.552270462198755e-5
tai,19,boy,0,19,5.274656939088817e-5
tobiasz,19,boy,3,22,6.10749750841863e-5
torben,19,boy,2,21,5.829883985308692e-5
varun,19,boy,0,19,5.274656939088817e-5
wren,19,boy,0,19,5.274656939088817e-5
yazan,19,boy,0,19,5.274656939088817e-5
yigit,19,boy,2,21,5.829883985308692e-5
zacharias,19,boy,1,20,5.552270462198755e-5
zen,19,boy,1,20,5.552270462198755e-5
zev,19,boy,0,19,5.274656939088817e-5
zidaan,19,boy,1,20,5.552270462198755e-5
ziyad,19,boy,0,19,5.274656939088817e-5
aarush,18,boy,0,18,4.997043415978879e-5
adan,18,boy,1,19,5.274656939088817e-5
aksel,18,boy,0,18,4.997043415978879e-5
ameen,18,boy,0,18,4.997043415978879e-5
anish,18,boy,0,18,4.997043415978879e-5
arda,18,boy,0,18,4.997043415978879e-5
armandas,18,boy,0,18,4.997043415978879e-5
beauden,18,boy,0,18,4.997043415978879e-5
bill,18,boy,0,18,4.997043415978879e-5
blaine,18,boy,8,26,7.21795160085838e-5
boaz,18,boy,0,18,4.997043415978879e-5
brook,18,boy,0,18,4.997043415978879e-5
chance,18,boy,2,20,5.552270462198755e-5
christos,18,boy,2,20,5.552270462198755e-5
corben,18,boy,0,18,4.997043415978879e-5
corbyn,18,boy,0,18,4.997043415978879e-5
dan,18,boy,0,18,4.997043415978879e-5
devansh,18,boy,0,18,4.997043415978879e-5
dragos,18,boy,0,18,4.997043415978879e-5
dwayne,18,boy,2,20,5.552270462198755e-5
emlyn,18,boy,0,18,4.997043415978879e-5
eugene,18,boy,1,19,5.274656939088817e-5
gino,18,boy,2,20,5.552270462198755e-5
hamdan,18,boy,0,18,4.997043415978879e-5
ignacy,18,boy,1,19,5.274656939088817e-5
imad,18,boy,0,18,4.997043415978879e-5
irfan,18,boy,0,18,4.997043415978879e-5
iustin,18,boy,0,18,4.997043415978879e-5
izaac,18,boy,1,19,5.274656939088817e-5
jaime,18,boy,0,18,4.997043415978879e-5
jibreel,18,boy,0,18,4.997043415978879e-5
jj,18,boy,0,18,4.997043415978879e-5
john-paul,18,boy,1,19,5.274656939088817e-5
joseff,18,boy,0,18,4.997043415978879e-5
juan,18,boy,0,18,4.997043415978879e-5
jujhar,18,boy,2,20,5.552270462198755e-5
kasey,18,boy,2,20,5.552270462198755e-5
kash,18,boy,1,19,5.274656939088817e-5
khizar,18,boy,1,19,5.274656939088817e-5
kymani,18,boy,0,18,4.997043415978879e-5
leroy,18,boy,0,18,4.997043415978879e-5
lleyton,18,boy,3,21,5.829883985308692e-5
mahmoud,18,boy,0,18,4.997043415978879e-5
marcell,18,boy,2,20,5.552270462198755e-5
mattias,18,boy,0,18,4.997043415978879e-5
maurice,18,boy,0,18,4.997043415978879e-5
maxx,18,boy,8,26,7.21795160085838e-5
mihail,18,boy,0,18,4.997043415978879e-5
nile,18,boy,0,18,4.997043415978879e-5
rajan,18,boy,1,19,5.274656939088817e-5
ravi,18,boy,0,18,4.997043415978879e-5
reggie-lee,18,boy,0,18,4.997043415978879e-5
rizwan,18,boy,1,19,5.274656939088817e-5
ruan,18,boy,5,23,6.385111031528568e-5
ruzgar,18,boy,0,18,4.997043415978879e-5
safwaan,18,boy,0,18,4.997043415978879e-5
samar,18,boy,0,18,4.997043415978879e-5
sterling,18,boy,0,18,4.997043415978879e-5
sudais,18,boy,0,18,4.997043415978879e-5
sufian,18,boy,0,18,4.997043415978879e-5
tariq,18,boy,0,18,4.997043415978879e-5
thor,18,boy,0,18,4.997043415978879e-5
tobi,18,boy,0,18,4.997043415978879e-5
tobie,18,boy,0,18,4.997043415978879e-5
ubaid,18,boy,0,18,4.997043415978879e-5
zakai,18,boy,0,18,4.997043415978879e-5
zaviyar,18,boy,1,19,5.274656939088817e-5
abdulaziz,17,boy,1,18,4.997043415978879e-5
abid,17,boy,1,18,4.997043415978879e-5
afonso,17,boy,0,17,4.7194298928689415e-5
ahmet,17,boy,2,19,5.274656939088817e-5
ajeet,17,boy,0,17,4.7194298928689415e-5
aleksandar,17,boy,3,20,5.552270462198755e-5
allan,17,boy,20,37,1.0271700355067696e-4
amrit,17,boy,1,18,4.997043415978879e-5
ariel,17,boy,0,17,4.7194298928689415e-5
arif,17,boy,0,17,4.7194298928689415e-5
arish,17,boy,0,17,4.7194298928689415e-5
armani,17,boy,0,17,4.7194298928689415e-5
ayyan,17,boy,1,18,4.997043415978879e-5
aziah,17,boy,0,17,4.7194298928689415e-5
barnabas,17,boy,2,19,5.274656939088817e-5
basil,17,boy,4,21,5.829883985308692e-5
bence,17,boy,1,18,4.997043415978879e-5
benji,17,boy,0,17,4.7194298928689415e-5
blue,17,boy,0,17,4.7194298928689415e-5
brax,17,boy,1,18,4.997043415978879e-5
cassian,17,boy,0,17,4.7194298928689415e-5
constantin,17,boy,0,17,4.7194298928689415e-5
corbin,17,boy,1,18,4.997043415978879e-5
cosmo,17,boy,3,20,5.552270462198755e-5
dafydd,17,boy,0,17,4.7194298928689415e-5
eddy,17,boy,1,18,4.997043415978879e-5
emile,17,boy,3,20,5.552270462198755e-5
everett,17,boy,2,19,5.274656939088817e-5
fintan,17,boy,0,17,4.7194298928689415e-5
forest,17,boy,0,17,4.7194298928689415e-5
gael,17,boy,1,18,4.997043415978879e-5
gianluca,17,boy,4,21,5.829883985308692e-5
godwin,17,boy,0,17,4.7194298928689415e-5
guto,17,boy,0,17,4.7194298928689415e-5
haadi,17,boy,1,18,4.997043415978879e-5
harlee,17,boy,1,18,4.997043415978879e-5
husnain,17,boy,1,18,4.997043415978879e-5
ilyaas,17,boy,0,17,4.7194298928689415e-5
ira,17,boy,0,17,4.7194298928689415e-5
isiah,17,boy,0,17,4.7194298928689415e-5
jaxen,17,boy,3,20,5.552270462198755e-5
kailan,17,boy,0,17,4.7194298928689415e-5
kain,17,boy,6,23,6.385111031528568e-5
kimi,17,boy,0,17,4.7194298928689415e-5
konstantinos,17,boy,0,17,4.7194298928689415e-5
kornel,17,boy,2,19,5.274656939088817e-5
kristupas,17,boy,2,19,5.274656939088817e-5
llewelyn,17,boy,0,17,4.7194298928689415e-5
lucious,17,boy,0,17,4.7194298928689415e-5
lukasz,17,boy,1,18,4.997043415978879e-5
marian,17,boy,0,17,4.7194298928689415e-5
marko,17,boy,3,20,5.552270462198755e-5
marlowe,17,boy,0,17,4.7194298928689415e-5
marwan,17,boy,1,18,4.997043415978879e-5
mickey,17,boy,1,18,4.997043415978879e-5
micky,17,boy,0,17,4.7194298928689415e-5
muadh,17,boy,1,18,4.997043415978879e-5
nick,17,boy,2,19,5.274656939088817e-5
nikola,17,boy,0,17,4.7194298928689415e-5
nyle,17,boy,0,17,4.7194298928689415e-5
om,17,boy,0,17,4.7194298928689415e-5
rashid,17,boy,0,17,4.7194298928689415e-5
ruhan,17,boy,0,17,4.7194298928689415e-5
saifan,17,boy,0,17,4.7194298928689415e-5
shawn,17,boy,3,20,5.552270462198755e-5
sion,17,boy,0,17,4.7194298928689415e-5
stirling,17,boy,1,18,4.997043415978879e-5
suleyman,17,boy,1,18,4.997043415978879e-5
timotei,17,boy,1,18,4.997043415978879e-5
wolf,17,boy,1,18,4.997043415978879e-5
yassin,17,boy,0,17,4.7194298928689415e-5
zahir,17,boy,0,17,4.7194298928689415e-5
abdallah,16,boy,2,18,4.997043415978879e-5
acer,16,boy,0,16,4.4418163697590036e-05
anwar,16,boy,0,16,4.4418163697590036e-05
ares,16,boy,1,17,4.7194298928689415e-5
arin,16,boy,0,16,4.4418163697590036e-05
avyaan,16,boy,0,16,4.4418163697590036e-05
ayansh,16,boy,0,16,4.4418163697590036e-05
bennett,16,boy,0,16,4.4418163697590036e-05
bowen,16,boy,0,16,4.4418163697590036e-05
buzz,16,boy,0,16,4.4418163697590036e-05
carwyn,16,boy,0,16,4.4418163697590036e-05
cason,16,boy,3,19,5.274656939088817e-5
chayce,16,boy,1,17,4.7194298928689415e-5
corban,16,boy,1,17,4.7194298928689415e-5
dale,16,boy,5,21,5.829883985308692e-5
daniels,16,boy,2,18,4.997043415978879e-5
dayton,16,boy,2,18,4.997043415978879e-5
derek,16,boy,10,26,7.21795160085838e-5
drake,16,boy,1,17,4.7194298928689415e-5
easton,16,boy,2,18,4.997043415978879e-5
ebenezer,16,boy,0,16,4.4418163697590036e-05
edan,16,boy,1,17,4.7194298928689415e-5
federico,16,boy,0,16,4.4418163697590036e-05
feliks,16,boy,0,16,4.4418163697590036e-05
gordon,16,boy,8,24,6.662724554638506e-5
harlem,16,boy,0,16,4.4418163697590036e-05
harley-jay,16,boy,0,16,4.4418163697590036e-05
harlo,16,boy,0,16,4.4418163697590036e-05
hezekiah,16,boy,0,16,4.4418163697590036e-05
humphrey,16,boy,1,17,4.7194298928689415e-5
huzaifah,16,boy,3,19,5.274656939088817e-5
ibaad,16,boy,0,16,4.4418163697590036e-05
imaad,16,boy,0,16,4.4418163697590036e-05
ishmael,16,boy,0,16,4.4418163697590036e-05
jawad,16,boy,1,17,4.7194298928689415e-5
joss,16,boy,1,17,4.7194298928689415e-5
kajetan,16,boy,2,18,4.997043415978879e-5
kal-el,16,boy,0,16,4.4418163697590036e-05
lev,16,boy,0,16,4.4418163697590036e-05
lex,16,boy,0,16,4.4418163697590036e-05
lionel,16,boy,0,16,4.4418163697590036e-05
markuss,16,boy,1,17,4.7194298928689415e-5
mirza,16,boy,0,16,4.4418163697590036e-05
mohsin,16,boy,1,17,4.7194298928689415e-5
nabeel,16,boy,1,17,4.7194298928689415e-5
nixon,16,boy,4,20,5.552270462198755e-5
oran,16,boy,11,27,7.495565123968318e-5
oscar-james,16,boy,0,16,4.4418163697590036e-05
razvan,16,boy,1,17,4.7194298928689415e-5
reed,16,boy,0,16,4.4418163697590036e-05
rossi,16,boy,1,17,4.7194298928689415e-5
ryker,16,boy,1,17,4.7194298928689415e-5
saim,16,boy,1,17,4.7194298928689415e-5
selim,16,boy,0,16,4.4418163697590036e-05
shivam,16,boy,0,16,4.4418163697590036e-05
stan,16,boy,2,18,4.997043415978879e-5
trent,16,boy,2,18,4.997043415978879e-5
alpha,15,boy,1,16,4.4418163697590036e-05
andrea,15,boy,1,16,4.4418163697590036e-05
arafat,15,boy,1,16,4.4418163697590036e-05
aram,15,boy,0,15,4.164202846649066e-5
atharv,15,boy,4,19,5.274656939088817e-5
augustas,15,boy,1,16,4.4418163697590036e-05
bartlomiej,15,boy,1,16,4.4418163697590036e-05
billy-joe,15,boy,0,15,4.164202846649066e-5
bo,15,boy,0,15,4.164202846649066e-5
caius,15,boy,1,16,4.4418163697590036e-05
cezar,15,boy,0,15,4.164202846649066e-5
chad,15,boy,0,15,4.164202846649066e-5
charlie-james,15,boy,1,16,4.4418163697590036e-05
cristiano,15,boy,0,15,4.164202846649066e-5
daley,15,boy,4,19,5.274656939088817e-5
danyaal,15,boy,0,15,4.164202846649066e-5
davi,15,boy,2,17,4.7194298928689415e-5
devan,15,boy,1,16,4.4418163697590036e-05
dimitri,15,boy,0,15,4.164202846649066e-5
dominick,15,boy,1,16,4.4418163697590036e-05
elvin,15,boy,0,15,4.164202846649066e-5
eoghan,15,boy,11,26,7.21795160085838e-5
evanas,15,boy,0,15,4.164202846649066e-5
florian,15,boy,0,15,4.164202846649066e-5
gabrielius,15,boy,2,17,4.7194298928689415e-5
hardy,15,boy,0,15,4.164202846649066e-5
ilan,15,boy,0,15,4.164202846649066e-5
indiana,15,boy,0,15,4.164202846649066e-5
jaiveer,15,boy,0,15,4.164202846649066e-5
jamil,15,boy,2,17,4.7194298928689415e-5
jayjay,15,boy,2,17,4.7194298928689415e-5
jaylan,15,boy,1,16,4.4418163697590036e-05
jesse-james,15,boy,0,15,4.164202846649066e-5
johnnie,15,boy,0,15,4.164202846649066e-5
joshan,15,boy,0,15,4.164202846649066e-5
kaidan,15,boy,0,15,4.164202846649066e-5
kaisan,15,boy,0,15,4.164202846649066e-5
kamari,15,boy,0,15,4.164202846649066e-5
kaydon,15,boy,0,15,4.164202846649066e-5
kirill,15,boy,0,15,4.164202846649066e-5
kiyaan,15,boy,0,15,4.164202846649066e-5
koa,15,boy,1,16,4.4418163697590036e-05
kobey,15,boy,0,15,4.164202846649066e-5
kyren,15,boy,0,15,4.164202846649066e-5
laszlo,15,boy,0,15,4.164202846649066e-5
leelan,15,boy,1,16,4.4418163697590036e-05
leonel,15,boy,0,15,4.164202846649066e-5
lewi,15,boy,1,16,4.4418163697590036e-05
luc,15,boy,3,18,4.997043415978879e-5
lucas-james,15,boy,0,15,4.164202846649066e-5
ludo,15,boy,0,15,4.164202846649066e-5
martim,15,boy,0,15,4.164202846649066e-5
mateen,15,boy,0,15,4.164202846649066e-5
mateus,15,boy,1,16,4.4418163697590036e-05
monroe,15,boy,1,16,4.4418163697590036e-05
mustapha,15,boy,0,15,4.164202846649066e-5
nivaan,15,boy,1,16,4.4418163697590036e-05
obie,15,boy,1,16,4.4418163697590036e-05
oswald,15,boy,0,15,4.164202846649066e-5
raif,15,boy,0,15,4.164202846649066e-5
riccardo,15,boy,1,16,4.4418163697590036e-05
ridley,15,boy,0,15,4.164202846649066e-5
royce,15,boy,1,16,4.4418163697590036e-05
sergio,15,boy,0,15,4.164202846649066e-5
seyed,15,boy,0,15,4.164202846649066e-5
siddharth,15,boy,3,18,4.997043415978879e-5
teddi,15,boy,0,15,4.164202846649066e-5
theo-james,15,boy,1,16,4.4418163697590036e-05
thomas-james,15,boy,2,17,4.7194298928689415e-5
tim,15,boy,0,15,4.164202846649066e-5
torin,15,boy,6,21,5.829883985308692e-5
vansh,15,boy,0,15,4.164202846649066e-5
walker,15,boy,3,18,4.997043415978879e-5
willem,15,boy,1,16,4.4418163697590036e-05
yamin,15,boy,1,16,4.4418163697590036e-05
zachery,15,boy,3,18,4.997043415978879e-5
zi,15,boy,2,17,4.7194298928689415e-5
aadil,14,boy,0,14,3.886589323539128e-5
aarish,14,boy,0,14,3.886589323539128e-5
abdulmalik,14,boy,0,14,3.886589323539128e-5
abyan,14,boy,0,14,3.886589323539128e-5
adamas,14,boy,0,14,3.886589323539128e-5
adomas,14,boy,0,14,3.886589323539128e-5
ailbe,14,boy,2,16,4.4418163697590036e-05
aleem,14,boy,0,14,3.886589323539128e-5
aleksandr,14,boy,3,17,4.7194298928689415e-5
amine,14,boy,0,14,3.886589323539128e-5
ammaar,14,boy,1,15,4.164202846649066e-5
aneirin,14,boy,0,14,3.886589323539128e-5
armin,14,boy,1,15,4.164202846649066e-5
artin,14,boy,0,14,3.886589323539128e-5
azad,14,boy,0,14,3.886589323539128e-5
benyamin,14,boy,0,14,3.886589323539128e-5
blaze,14,boy,0,14,3.886589323539128e-5
bobby-ray,14,boy,0,14,3.886589323539128e-5
brett,14,boy,1,15,4.164202846649066e-5
caolan,14,boy,2,16,4.4418163697590036e-05
cass,14,boy,0,14,3.886589323539128e-5
cedric,14,boy,1,15,4.164202846649066e-5
cody-lee,14,boy,0,14,3.886589323539128e-5
dallas,14,boy,0,14,3.886589323539128e-5
danial,14,boy,1,15,4.164202846649066e-5
davide,14,boy,0,14,3.886589323539128e-5
domenico,14,boy,0,14,3.886589323539128e-5
dudley,14,boy,0,14,3.886589323539128e-5
ehsaan,14,boy,0,14,3.886589323539128e-5
elijus,14,boy,2,16,4.4418163697590036e-05
erikas,14,boy,0,14,3.886589323539128e-5
eymen,14,boy,1,15,4.164202846649066e-5
franek,14,boy,2,16,4.4418163697590036e-05
gregor,14,boy,37,51,1.4158289678606824e-4
griffin,14,boy,2,16,4.4418163697590036e-05
habib,14,boy,0,14,3.886589323539128e-5
harveer,14,boy,0,14,3.886589323539128e-5
henrik,14,boy,2,16,4.4418163697590036e-05
henry-james,14,boy,1,15,4.164202846649066e-5
hisham,14,boy,1,15,4.164202846649066e-5
horatio,14,boy,0,14,3.886589323539128e-5
husayn,14,boy,0,14,3.886589323539128e-5
ihsaan,14,boy,0,14,3.886589323539128e-5
ioannis,14,boy,1,15,4.164202846649066e-5
isaak,14,boy,0,14,3.886589323539128e-5
jamari,14,boy,0,14,3.886589323539128e-5
jameel,14,boy,0,14,3.886589323539128e-5
jedidiah,14,boy,1,15,4.164202846649066e-5
jenson-james,14,boy,0,14,3.886589323539128e-5
jet,14,boy,0,14,3.886589323539128e-5
joris,14,boy,0,14,3.886589323539128e-5
karan,14,boy,0,14,3.886589323539128e-5
kavin,14,boy,0,14,3.886589323539128e-5
kayleb,14,boy,3,17,4.7194298928689415e-5
kaylem,14,boy,0,14,3.886589323539128e-5
keagan,14,boy,2,16,4.4418163697590036e-05
keir,14,boy,24,38,1.0549313878177634e-4
khush,14,boy,0,14,3.886589323539128e-5
kofi,14,boy,0,14,3.886589323539128e-5
leif,14,boy,1,15,4.164202846649066e-5
leo-james,14,boy,3,17,4.7194298928689415e-5
loic,14,boy,0,14,3.886589323539128e-5
majus,14,boy,2,16,4.4418163697590036e-05
marcos,14,boy,1,15,4.164202846649066e-5
mikel,14,boy,1,15,4.164202846649066e-5
mordechai,14,boy,0,14,3.886589323539128e-5
mujtaba,14,boy,0,14,3.886589323539128e-5
noah-james,14,boy,0,14,3.886589323539128e-5
norman,14,boy,0,14,3.886589323539128e-5
odhran,14,boy,9,23,6.385111031528568e-5
oskaras,14,boy,0,14,3.886589323539128e-5
ozzie,14,boy,0,14,3.886589323539128e-5
petru,14,boy,0,14,3.886589323539128e-5
quinlan,14,boy,1,15,4.164202846649066e-5
rafay,14,boy,1,15,4.164202846649066e-5
raghav,14,boy,0,14,3.886589323539128e-5
reiss,14,boy,4,18,4.997043415978879e-5
renzo,14,boy,0,14,3.886589323539128e-5
rhylee,14,boy,0,14,3.886589323539128e-5
roberts,14,boy,2,16,4.4418163697590036e-05
romario,14,boy,0,14,3.886589323539128e-5
roni,14,boy,1,15,4.164202846649066e-5
ruari,14,boy,11,25,6.940338077748443e-5
sheldon,14,boy,0,14,3.886589323539128e-5
shmuel,14,boy,0,14,3.886589323539128e-5
siraj,14,boy,0,14,3.886589323539128e-5
spike,14,boy,0,14,3.886589323539128e-5
stephan,14,boy,4,18,4.997043415978879e-5
stevie,14,boy,1,15,4.164202846649066e-5
taim,14,boy,0,14,3.886589323539128e-5
tinashe,14,boy,0,14,3.886589323539128e-5
titus,14,boy,2,16,4.4418163697590036e-05
uzayr,14,boy,0,14,3.886589323539128e-5
vedant,14,boy,0,14,3.886589323539128e-5
vince,14,boy,2,16,4.4418163697590036e-05
willis,14,boy,3,17,4.7194298928689415e-5
winter,14,boy,0,14,3.886589323539128e-5
yoel,14,boy,0,14,3.886589323539128e-5
yusef,14,boy,0,14,3.886589323539128e-5
zaine,14,boy,0,14,3.886589323539128e-5
albion,13,boy,0,13,3.60897580042919e-5
alek,13,boy,0,13,3.60897580042919e-5
arden,13,boy,2,15,4.164202846649066e-5
asad,13,boy,1,14,3.886589323539128e-5
aviraj,13,boy,2,15,4.164202846649066e-5
ayush,13,boy,0,13,3.60897580042919e-5
azan,13,boy,2,15,4.164202846649066e-5
bernie,13,boy,0,13,3.60897580042919e-5
boe,13,boy,0,13,3.60897580042919e-5
braylon,13,boy,0,13,3.60897580042919e-5
brennan,13,boy,3,16,4.4418163697590036e-05
brock,13,boy,0,13,3.60897580042919e-5
bronson,13,boy,0,13,3.60897580042919e-5
campbell,13,boy,31,44,1.221499501683726e-4
carter-james,13,boy,1,14,3.886589323539128e-5
coben,13,boy,2,15,4.164202846649066e-5
conall,13,boy,8,21,5.829883985308692e-5
constantine,13,boy,1,14,3.886589323539128e-5
daryl,13,boy,11,24,6.662724554638506e-5
dimitar,13,boy,0,13,3.60897580042919e-5
divine,13,boy,0,13,3.60897580042919e-5
ed,13,boy,0,13,3.60897580042919e-5
ediz,13,boy,1,14,3.886589323539128e-5
eliott,13,boy,3,16,4.4418163697590036e-05
finnlay,13,boy,3,16,4.4418163697590036e-05
frederik,13,boy,0,13,3.60897580042919e-5
giuseppe,13,boy,0,13,3.60897580042919e-5
grant,13,boy,4,17,4.7194298928689415e-5
hanzalah,13,boy,0,13,3.60897580042919e-5
holden,13,boy,1,14,3.886589323539128e-5
howard,13,boy,1,14,3.886589323539128e-5
izyan,13,boy,1,14,3.886589323539128e-5
jamaal,13,boy,0,13,3.60897580042919e-5
jase,13,boy,3,16,4.4418163697590036e-05
joby,13,boy,0,13,3.60897580042919e-5
john-james,13,boy,4,17,4.7194298928689415e-5
kameron,13,boy,0,13,3.60897580042919e-5
kingston,13,boy,2,15,4.164202846649066e-5
klayton,13,boy,2,15,4.164202846649066e-5
koben,13,boy,1,14,3.886589323539128e-5
koen,13,boy,2,15,4.164202846649066e-5
koray,13,boy,1,14,3.886589323539128e-5
kwame,13,boy,0,13,3.60897580042919e-5
kyson,13,boy,1,14,3.886589323539128e-5
lemuel,13,boy,0,13,3.60897580042919e-5
logan-lee,13,boy,1,14,3.886589323539128e-5
luqmaan,13,boy,0,13,3.60897580042919e-5
maaz,13,boy,0,13,3.60897580042919e-5
malaki,13,boy,1,14,3.886589323539128e-5
marcin,13,boy,1,14,3.886589323539128e-5
mike,13,boy,1,14,3.886589323539128e-5
moishe,13,boy,0,13,3.60897580042919e-5
mubarak,13,boy,1,14,3.886589323539128e-5
nahom,13,boy,0,13,3.60897580042919e-5
navraj,13,boy,0,13,3.60897580042919e-5
oluwatobi,13,boy,0,13,3.60897580042919e-5
oluwatobiloba,13,boy,0,13,3.60897580042919e-5
parth,13,boy,1,14,3.886589323539128e-5
pierre,13,boy,1,14,3.886589323539128e-5
prem,13,boy,0,13,3.60897580042919e-5
qais,13,boy,0,13,3.60897580042919e-5
radu,13,boy,0,13,3.60897580042919e-5
raffaele,13,boy,0,13,3.60897580042919e-5
raheel,13,boy,1,14,3.886589323539128e-5
raman,13,boy,0,13,3.60897580042919e-5
ramsey,13,boy,2,15,4.164202846649066e-5
rayhaan,13,boy,0,13,3.60897580042919e-5
rokas,13,boy,1,14,3.886589323539128e-5
rowen,13,boy,0,13,3.60897580042919e-5
ruaridh,13,boy,93,106,2.94270334496534e-4
rui,13,boy,2,15,4.164202846649066e-5
rylie,13,boy,7,20,5.552270462198755e-5
sachin,13,boy,1,14,3.886589323539128e-5
samarth,13,boy,0,13,3.60897580042919e-5
sarim,13,boy,0,13,3.60897580042919e-5
senan,13,boy,2,15,4.164202846649066e-5
shaheer,13,boy,1,14,3.886589323539128e-5
shivansh,13,boy,1,14,3.886589323539128e-5
stefano,13,boy,2,15,4.164202846649066e-5
suhaan,13,boy,0,13,3.60897580042919e-5
tameem,13,boy,2,15,4.164202846649066e-5
tj,13,boy,1,14,3.886589323539128e-5
tommi,13,boy,0,13,3.60897580042919e-5
ty,13,boy,0,13,3.60897580042919e-5
tyreece,13,boy,1,14,3.886589323539128e-5
uthmaan,13,boy,0,13,3.60897580042919e-5
uwais,13,boy,0,13,3.60897580042919e-5
vakaris,13,boy,1,14,3.886589323539128e-5
valentine,13,boy,0,13,3.60897580042919e-5
viggo,13,boy,0,13,3.60897580042919e-5
virat,13,boy,0,13,3.60897580042919e-5
vladislav,13,boy,0,13,3.60897580042919e-5
waris,13,boy,0,13,3.60897580042919e-5
yi,13,boy,2,15,4.164202846649066e-5
younes,13,boy,0,13,3.60897580042919e-5
zechariah,13,boy,0,13,3.60897580042919e-5
zia,13,boy,3,16,4.4418163697590036e-05
zoravar,13,boy,0,13,3.60897580042919e-5
zyan,13,boy,0,13,3.60897580042919e-5
aaran,12,boy,2,14,3.886589323539128e-5
aayush,12,boy,0,12,3.331362277319253e-5
abe,12,boy,1,13,3.60897580042919e-5
agamjot,12,boy,0,12,3.331362277319253e-5
ahil,12,boy,0,12,3.331362277319253e-5
alexei,12,boy,0,12,3.331362277319253e-5
alfie-joe,12,boy,0,12,3.331362277319253e-5
aliyan,12,boy,1,13,3.60897580042919e-5
anakin,12,boy,0,12,3.331362277319253e-5
angel,12,boy,1,13,3.60897580042919e-5
arion,12,boy,0,12,3.331362277319253e-5
arnas,12,boy,0,12,3.331362277319253e-5
art,12,boy,0,12,3.331362277319253e-5
austyn,12,boy,1,13,3.60897580042919e-5
avraj,12,boy,0,12,3.331362277319253e-5
avram,12,boy,2,14,3.886589323539128e-5
avyan,12,boy,0,12,3.331362277319253e-5
azeem,12,boy,1,13,3.60897580042919e-5
bastian,12,boy,1,13,3.60897580042919e-5
benett,12,boy,1,13,3.60897580042919e-5
berat,12,boy,1,13,3.60897580042919e-5
bernardo,12,boy,1,13,3.60897580042919e-5
bertram,12,boy,0,12,3.331362277319253e-5
braden,12,boy,0,12,3.331362277319253e-5
bray,12,boy,0,12,3.331362277319253e-5
cavan,12,boy,3,15,4.164202846649066e-5
charlie-jay,12,boy,0,12,3.331362277319253e-5
chidubem,12,boy,1,13,3.60897580042919e-5
codie,12,boy,0,12,3.331362277319253e-5
cuba,12,boy,0,12,3.331362277319253e-5
cullen,12,boy,6,18,4.997043415978879e-5
daksh,12,boy,0,12,3.331362277319253e-5
danish,12,boy,0,12,3.331362277319253e-5
daoud,12,boy,0,12,3.331362277319253e-5
dawoud,12,boy,1,13,3.60897580042919e-5
demir,12,boy,3,15,4.164202846649066e-5
dilraj,12,boy,0,12,3.331362277319253e-5
dre,12,boy,0,12,3.331362277319253e-5
ehan,12,boy,0,12,3.331362277319253e-5
ferdinand,12,boy,0,12,3.331362277319253e-5
floyd,12,boy,2,14,3.886589323539128e-5
frazier,12,boy,0,12,3.331362277319253e-5
freddie-james,12,boy,0,12,3.331362277319253e-5
fynley,12,boy,0,12,3.331362277319253e-5
gareth,12,boy,1,13,3.60897580042919e-5
georgios,12,boy,0,12,3.331362277319253e-5
gerald,12,boy,2,14,3.886589323539128e-5
gerry,12,boy,1,13,3.60897580042919e-5
giacomo,12,boy,0,12,3.331362277319253e-5
gianni,12,boy,1,13,3.60897580042919e-5
gracjan,12,boy,0,12,3.331362277319253e-5
gustas,12,boy,1,13,3.60897580042919e-5
gustavo,12,boy,0,12,3.331362277319253e-5
gwion,12,boy,0,12,3.331362277319253e-5
hal,12,boy,0,12,3.331362277319253e-5
hartley,12,boy,2,14,3.886589323539128e-5
harvey-james,12,boy,0,12,3.331362277319253e-5
huseyin,12,boy,0,12,3.331362277319253e-5
indy,12,boy,1,13,3.60897580042919e-5
isaaq,12,boy,0,12,3.331362277319253e-5
jaxon-james,12,boy,0,12,3.331362277319253e-5
jaxxon,12,boy,1,13,3.60897580042919e-5
joah,12,boy,0,12,3.331362277319253e-5
johannes,12,boy,0,12,3.331362277319253e-5
jos,12,boy,0,12,3.331362277319253e-5
kairon,12,boy,0,12,3.331362277319253e-5
kaius,12,boy,1,13,3.60897580042919e-5
kayne,12,boy,0,12,3.331362277319253e-5
kaysen,12,boy,2,14,3.886589323539128e-5
keane,12,boy,2,14,3.886589323539128e-5
khaleel,12,boy,0,12,3.331362277319253e-5
khalifa,12,boy,0,12,3.331362277319253e-5
khian,12,boy,1,13,3.60897580042919e-5
kilian,12,boy,0,12,3.331362277319253e-5
kitt,12,boy,1,13,3.60897580042919e-5
kolby,12,boy,1,13,3.60897580042919e-5
korbyn,12,boy,0,12,3.331362277319253e-5
lake,12,boy,2,14,3.886589323539128e-5
levente,12,boy,0,12,3.331362277319253e-5
lewin,12,boy,0,12,3.331362277319253e-5
linden,12,boy,1,13,3.60897580042919e-5
lohan,12,boy,0,12,3.331362277319253e-5
maksims,12,boy,0,12,3.331362277319253e-5
manav,12,boy,0,12,3.331362277319253e-5
mazen,12,boy,0,12,3.331362277319253e-5
micheal,12,boy,3,15,4.164202846649066e-5
milad,12,boy,0,12,3.331362277319253e-5
muhamad,12,boy,0,12,3.331362277319253e-5
nadir,12,boy,0,12,3.331362277319253e-5
nael,12,boy,0,12,3.331362277319253e-5
nali,12,boy,0,12,3.331362277319253e-5
nasir,12,boy,0,12,3.331362277319253e-5
nayan,12,boy,0,12,3.331362277319253e-5
nihaal,12,boy,0,12,3.331362277319253e-5
noar,12,boy,0,12,3.331362277319253e-5
poyraz,12,boy,1,13,3.60897580042919e-5
ralf,12,boy,0,12,3.331362277319253e-5
ralphi,12,boy,0,12,3.331362277319253e-5
reef,12,boy,0,12,3.331362277319253e-5
rene,12,boy,0,12,3.331362277319253e-5
rishan,12,boy,1,13,3.60897580042919e-5
riyadh,12,boy,0,12,3.331362277319253e-5
roger,12,boy,0,12,3.331362277319253e-5
rojus,12,boy,0,12,3.331362277319253e-5
rosco,12,boy,0,12,3.331362277319253e-5
salah,12,boy,0,12,3.331362277319253e-5
sampson,12,boy,0,12,3.331362277319253e-5
shalom,12,boy,0,12,3.331362277319253e-5
shaylan,12,boy,0,12,3.331362277319253e-5
shimon,12,boy,0,12,3.331362277319253e-5
shiven,12,boy,0,12,3.331362277319253e-5
suliman,12,boy,1,13,3.60897580042919e-5
tre,12,boy,0,12,3.331362277319253e-5
vaughn,12,boy,3,15,4.164202846649066e-5
vian,12,boy,0,12,3.331362277319253e-5
yakov,12,boy,0,12,3.331362277319253e-5
yaqoob,12,boy,0,12,3.331362277319253e-5
yitzchok,12,boy,0,12,3.331362277319253e-5
youcef,12,boy,1,13,3.60897580042919e-5
younus,12,boy,0,12,3.331362277319253e-5
yuvan,12,boy,3,15,4.164202846649066e-5
zahid,12,boy,0,12,3.331362277319253e-5
zeb,12,boy,0,12,3.331362277319253e-5
ziad,12,boy,0,12,3.331362277319253e-5
adeel,11,boy,0,11,3.053748754209315e-5
adi,11,boy,0,11,3.053748754209315e-5
aiman,11,boy,1,12,3.331362277319253e-5
ajus,11,boy,0,11,3.053748754209315e-5
akaal,11,boy,0,11,3.053748754209315e-5
alijah,11,boy,0,11,3.053748754209315e-5
aodhan,11,boy,2,13,3.60897580042919e-5
arav,11,boy,1,12,3.331362277319253e-5
armando,11,boy,1,12,3.331362277319253e-5
arsh,11,boy,1,12,3.331362277319253e-5
arthur-james,11,boy,0,11,3.053748754209315e-5
aslan,11,boy,0,11,3.053748754209315e-5
barclay,11,boy,3,14,3.886589323539128e-5
barry,11,boy,6,17,4.7194298928689415e-5
bayley,11,boy,0,11,3.053748754209315e-5
bobby-lee,11,boy,0,11,3.053748754209315e-5
brayan,11,boy,0,11,3.053748754209315e-5
brodi,11,boy,2,13,3.60897580042919e-5
caesar,11,boy,0,11,3.053748754209315e-5
catalin,11,boy,1,12,3.331362277319253e-5
ceejay,11,boy,3,14,3.886589323539128e-5
charlie-ray,11,boy,1,12,3.331362277319253e-5
cobi,11,boy,1,12,3.331362277319253e-5
colt,11,boy,4,15,4.164202846649066e-5
corin,11,boy,1,12,3.331362277319253e-5
damir,11,boy,1,12,3.331362277319253e-5
dane,11,boy,0,11,3.053748754209315e-5
darin,11,boy,1,12,3.331362277319253e-5
darsh,11,boy,0,11,3.053748754209315e-5
darshan,11,boy,0,11,3.053748754209315e-5
daud,11,boy,0,11,3.053748754209315e-5
dontae,11,boy,0,11,3.053748754209315e-5
dovid,11,boy,0,11,3.053748754209315e-5
dyfan,11,boy,0,11,3.053748754209315e-5
elian,11,boy,0,11,3.053748754209315e-5
eligh,11,boy,2,13,3.60897580042919e-5
enrico,11,boy,3,14,3.886589323539128e-5
ezrah,11,boy,1,12,3.331362277319253e-5
faaris,11,boy,0,11,3.053748754209315e-5
fenn,11,boy,0,11,3.053748754209315e-5
fenton,11,boy,0,11,3.053748754209315e-5
ford,11,boy,3,14,3.886589323539128e-5
frankie-lee,11,boy,0,11,3.053748754209315e-5
freddie-joe,11,boy,0,11,3.053748754209315e-5
fredrik,11,boy,1,12,3.331362277319253e-5
fyfe,11,boy,0,11,3.053748754209315e-5
gaspard,11,boy,0,11,3.053748754209315e-5
ghulam,11,boy,0,11,3.053748754209315e-5
grey,11,boy,0,11,3.053748754209315e-5
gurnoor,11,boy,0,11,3.053748754209315e-5
hao,11,boy,4,15,4.164202846649066e-5
himmat,11,boy,0,11,3.053748754209315e-5
hiro,11,boy,0,11,3.053748754209315e-5
hosea,11,boy,0,11,3.053748754209315e-5
howie,11,boy,1,12,3.331362277319253e-5
ignas,11,boy,0,11,3.053748754209315e-5
ilias,11,boy,0,11,3.053748754209315e-5
ionatan,11,boy,2,13,3.60897580042919e-5
izaiah,11,boy,0,11,3.053748754209315e-5
jamie-lee,11,boy,1,12,3.331362277319253e-5
jaylon,11,boy,0,11,3.053748754209315e-5
jessie,11,boy,0,11,3.053748754209315e-5
jimi,11,boy,1,12,3.331362277319253e-5
joey-james,11,boy,0,11,3.053748754209315e-5
jonathon,11,boy,0,11,3.053748754209315e-5
jotham,11,boy,0,11,3.053748754209315e-5
julien,11,boy,0,11,3.053748754209315e-5
kaleem,11,boy,0,11,3.053748754209315e-5
kaloyan,11,boy,0,11,3.053748754209315e-5
kameel,11,boy,0,11,3.053748754209315e-5
karolis,11,boy,1,12,3.331362277319253e-5
kayaan,11,boy,0,11,3.053748754209315e-5
keenan,11,boy,2,13,3.60897580042919e-5
keilan,11,boy,1,12,3.331362277319253e-5
keshav,11,boy,0,11,3.053748754209315e-5
kodie,11,boy,3,14,3.886589323539128e-5
krishiv,11,boy,0,11,3.053748754209315e-5
kyon,11,boy,0,11,3.053748754209315e-5
larry,11,boy,2,13,3.60897580042919e-5
leeland,11,boy,0,11,3.053748754209315e-5
lemar,11,boy,0,11,3.053748754209315e-5
lucan,11,boy,0,11,3.053748754209315e-5
maahir,11,boy,0,11,3.053748754209315e-5
macaulay,11,boy,1,12,3.331362277319253e-5
mace,11,boy,1,12,3.331362277319253e-5
maher,11,boy,1,12,3.331362277319253e-5
marcelo,11,boy,2,13,3.60897580042919e-5
marios,11,boy,0,11,3.053748754209315e-5
markas,11,boy,2,13,3.60897580042919e-5
massimo,11,boy,1,12,3.331362277319253e-5
matheus,11,boy,0,11,3.053748754209315e-5
maximo,11,boy,1,12,3.331362277319253e-5
meer,11,boy,0,11,3.053748754209315e-5
mika,11,boy,2,13,3.60897580042919e-5
mir,11,boy,0,11,3.053748754209315e-5
moeez,11,boy,0,11,3.053748754209315e-5
muzammil,11,boy,0,11,3.053748754209315e-5
naeem,11,boy,0,11,3.053748754209315e-5
natanael,11,boy,0,11,3.053748754209315e-5
nicolo,11,boy,0,11,3.053748754209315e-5
nishaan,11,boy,0,11,3.053748754209315e-5
norbert,11,boy,0,11,3.053748754209315e-5
nova,11,boy,0,11,3.053748754209315e-5
ossian,11,boy,3,14,3.886589323539128e-5
ozan,11,boy,0,11,3.053748754209315e-5
pasha,11,boy,1,12,3.331362277319253e-5
paulo,11,boy,1,12,3.331362277319253e-5
peyton,11,boy,1,12,3.331362277319253e-5
piran,11,boy,0,11,3.053748754209315e-5
ragnar,11,boy,1,12,3.331362277319253e-5
rakan,11,boy,0,11,3.053748754209315e-5
rayyaan,11,boy,0,11,3.053748754209315e-5
reese,11,boy,0,11,3.053748754209315e-5
rehaan,11,boy,0,11,3.053748754209315e-5
reis,11,boy,1,12,3.331362277319253e-5
rejus,11,boy,0,11,3.053748754209315e-5
reo,11,boy,1,12,3.331362277319253e-5
reuel,11,boy,0,11,3.053748754209315e-5
rihaan,11,boy,1,12,3.331362277319253e-5
rihan,11,boy,1,12,3.331362277319253e-5
robson,11,boy,1,12,3.331362277319253e-5
ryaan,11,boy,2,13,3.60897580042919e-5
samiul,11,boy,0,11,3.053748754209315e-5
samuele,11,boy,1,12,3.331362277319253e-5
shahan,11,boy,1,12,3.331362277319253e-5
shai,11,boy,0,11,3.053748754209315e-5
shloime,11,boy,0,11,3.053748754209315e-5
shlomo,11,boy,0,11,3.053748754209315e-5
tafari,11,boy,0,11,3.053748754209315e-5
taliesin,11,boy,0,11,3.053748754209315e-5
tayyab,11,boy,0,11,3.053748754209315e-5
teejay,11,boy,2,13,3.60897580042919e-5
tiberius,11,boy,0,11,3.053748754209315e-5
tobin,11,boy,0,11,3.053748754209315e-5
tyrion,11,boy,0,11,3.053748754209315e-5
uriel,11,boy,1,12,3.331362277319253e-5
vasile,11,boy,0,11,3.053748754209315e-5
ved,11,boy,1,12,3.331362277319253e-5
yasser,11,boy,0,11,3.053748754209315e-5
yuri,11,boy,1,12,3.331362277319253e-5
yuvraaj,11,boy,0,11,3.053748754209315e-5
zackariah,11,boy,0,11,3.053748754209315e-5
zaeem,11,boy,0,11,3.053748754209315e-5
zakk,11,boy,0,11,3.053748754209315e-5
zeyad,11,boy,0,11,3.053748754209315e-5
zinedine,11,boy,0,11,3.053748754209315e-5
zohan,11,boy,0,11,3.053748754209315e-5
zubayr,11,boy,0,11,3.053748754209315e-5
aarib,10,boy,0,10,2.7761352310993775e-5
abdul-rahman,10,boy,2,12,3.331362277319253e-5
adeeb,10,boy,0,10,2.7761352310993775e-5
agam,10,boy,0,10,2.7761352310993775e-5
ahaan,10,boy,1,11,3.053748754209315e-5
akshayan,10,boy,0,10,2.7761352310993775e-5
alfie-george,10,boy,0,10,2.7761352310993775e-5
alin,10,boy,1,11,3.053748754209315e-5
alister,10,boy,0,10,2.7761352310993775e-5
allen,10,boy,1,11,3.053748754209315e-5
alp,10,boy,0,10,2.7761352310993775e-5
ambrose,10,boy,0,10,2.7761352310993775e-5
andi,10,boy,0,10,2.7761352310993775e-5
andrzej,10,boy,0,10,2.7761352310993775e-5
antoine,10,boy,1,11,3.053748754209315e-5
arshan,10,boy,0,10,2.7761352310993775e-5
artem,10,boy,0,10,2.7761352310993775e-5
arturo,10,boy,0,10,2.7761352310993775e-5
asim,10,boy,1,11,3.053748754209315e-5
augustin,10,boy,0,10,2.7761352310993775e-5
ayodeji,10,boy,1,11,3.053748754209315e-5
barkley,10,boy,0,10,2.7761352310993775e-5
beckett,10,boy,0,10,2.7761352310993775e-5
benedek,10,boy,0,10,2.7761352310993775e-5
bilaal,10,boy,0,10,2.7761352310993775e-5
bobbi,10,boy,0,10,2.7761352310993775e-5
bora,10,boy,0,10,2.7761352310993775e-5
brinley,10,boy,1,11,3.053748754209315e-5
broden,10,boy,3,13,3.60897580042919e-5
burhan,10,boy,1,11,3.053748754209315e-5
caine,10,boy,2,12,3.331362277319253e-5
codi,10,boy,5,15,4.164202846649066e-5
corby,10,boy,0,10,2.7761352310993775e-5
cruze,10,boy,2,12,3.331362277319253e-5
davis,10,boy,4,14,3.886589323539128e-5
deio,10,boy,0,10,2.7761352310993775e-5
dennie,10,boy,0,10,2.7761352310993775e-5
django,10,boy,0,10,2.7761352310993775e-5
donny,10,boy,3,13,3.60897580042919e-5
donte,10,boy,0,10,2.7761352310993775e-5
dovydas,10,boy,1,11,3.053748754209315e-5
dyllan,10,boy,0,10,2.7761352310993775e-5
ege,10,boy,0,10,2.7761352310993775e-5
farley,10,boy,0,10,2.7761352310993775e-5
fawad,10,boy,1,11,3.053748754209315e-5
fernando,10,boy,1,11,3.053748754209315e-5
filippo,10,boy,0,10,2.7761352310993775e-5
finley-james,10,boy,0,10,2.7761352310993775e-5
finnegan,10,boy,1,11,3.053748754209315e-5
florin,10,boy,0,10,2.7761352310993775e-5
freddie-lee,10,boy,0,10,2.7761352310993775e-5
furkan,10,boy,1,11,3.053748754209315e-5
furqan,10,boy,0,10,2.7761352310993775e-5
graham,10,boy,4,14,3.886589323539128e-5
guilherme,10,boy,0,10,2.7761352310993775e-5
habeeb,10,boy,0,10,2.7761352310993775e-5
harlyn,10,boy,3,13,3.60897580042919e-5
haroun,10,boy,0,10,2.7761352310993775e-5
harry-james,10,boy,0,10,2.7761352310993775e-5
hayyan,10,boy,0,10,2.7761352310993775e-5
henrique,10,boy,0,10,2.7761352310993775e-5
heston,10,boy,1,11,3.053748754209315e-5
hishaam,10,boy,0,10,2.7761352310993775e-5
iago,10,boy,0,10,2.7761352310993775e-5
ignatius,10,boy,0,10,2.7761352310993775e-5
jabir,10,boy,0,10,2.7761352310993775e-5
jafar,10,boy,0,10,2.7761352310993775e-5
jim,10,boy,0,10,2.7761352310993775e-5
jin,10,boy,1,11,3.053748754209315e-5
jobie,10,boy,0,10,2.7761352310993775e-5
jordi,10,boy,1,11,3.053748754209315e-5
joven,10,boy,0,10,2.7761352310993775e-5
junayd,10,boy,0,10,2.7761352310993775e-5
kairav,10,boy,0,10,2.7761352310993775e-5
kalel,10,boy,2,12,3.331362277319253e-5
kamron,10,boy,0,10,2.7761352310993775e-5
kaydan,10,boy,3,13,3.60897580042919e-5
kaysan,10,boy,0,10,2.7761352310993775e-5
keiron,10,boy,0,10,2.7761352310993775e-5
kenji,10,boy,0,10,2.7761352310993775e-5
kerim,10,boy,0,10,2.7761352310993775e-5
khari,10,boy,0,10,2.7761352310993775e-5
knox,10,boy,2,12,3.331362277319253e-5
korben,10,boy,0,10,2.7761352310993775e-5
kristians,10,boy,0,10,2.7761352310993775e-5
kyden,10,boy,2,12,3.331362277319253e-5
lawi,10,boy,0,10,2.7761352310993775e-5
link,10,boy,0,10,2.7761352310993775e-5
majeed,10,boy,0,10,2.7761352310993775e-5
mamadou,10,boy,1,11,3.053748754209315e-5
mason-james,10,boy,1,11,3.053748754209315e-5
meir,10,boy,0,10,2.7761352310993775e-5
mekhi,10,boy,0,10,2.7761352310993775e-5
mikhael,10,boy,0,10,2.7761352310993775e-5
millen,10,boy,1,11,3.053748754209315e-5
miraj,10,boy,0,10,2.7761352310993775e-5
moosa,10,boy,0,10,2.7761352310993775e-5
muaad,10,boy,0,10,2.7761352310993775e-5
muhammad-ali,10,boy,1,11,3.053748754209315e-5
muhammad-yusuf,10,boy,0,10,2.7761352310993775e-5
muhsin,10,boy,1,11,3.053748754209315e-5
murad,10,boy,1,11,3.053748754209315e-5
mus'ab,10,boy,0,10,2.7761352310993775e-5
nahum,10,boy,0,10,2.7761352310993775e-5
nahyan,10,boy,0,10,2.7761352310993775e-5
nayel,10,boy,3,13,3.60897580042919e-5
neel,10,boy,0,10,2.7761352310993775e-5
nikolaos,10,boy,1,11,3.053748754209315e-5
noam,10,boy,0,10,2.7761352310993775e-5
noe,10,boy,0,10,2.7761352310993775e-5
noor,10,boy,0,10,2.7761352310993775e-5
nouh,10,boy,1,11,3.053748754209315e-5
olamide,10,boy,0,10,2.7761352310993775e-5
ollie-jay,10,boy,0,10,2.7761352310993775e-5
oluwatimileyin,10,boy,1,11,3.053748754209315e-5
orhan,10,boy,1,11,3.053748754209315e-5
padraig,10,boy,0,10,2.7761352310993775e-5
paolo,10,boy,1,11,3.053748754209315e-5
petar,10,boy,0,10,2.7761352310993775e-5
pip,10,boy,0,10,2.7761352310993775e-5
quinten,10,boy,0,10,2.7761352310993775e-5
rahul,10,boy,0,10,2.7761352310993775e-5
ranvir,10,boy,1,11,3.053748754209315e-5
rhydian,10,boy,0,10,2.7761352310993775e-5
riyaan,10,boy,0,10,2.7761352310993775e-5
rodney,10,boy,0,10,2.7761352310993775e-5
rudie,10,boy,1,11,3.053748754209315e-5
rylan,10,boy,1,11,3.053748754209315e-5
saiyan,10,boy,0,10,2.7761352310993775e-5
salim,10,boy,0,10,2.7761352310993775e-5
samuil,10,boy,0,10,2.7761352310993775e-5
shoaib,10,boy,0,10,2.7761352310993775e-5
shreyan,10,boy,0,10,2.7761352310993775e-5
skye,10,boy,0,10,2.7761352310993775e-5
tadeusz,10,boy,0,10,2.7761352310993775e-5
tahir,10,boy,0,10,2.7761352310993775e-5
taio,10,boy,0,10,2.7761352310993775e-5
taron,10,boy,0,10,2.7761352310993775e-5
tegh,10,boy,0,10,2.7761352310993775e-5
tej,10,boy,0,10,2.7761352310993775e-5
tobey,10,boy,2,12,3.331362277319253e-5
toprak,10,boy,0,10,2.7761352310993775e-5
tylan,10,boy,0,10,2.7761352310993775e-5
tyron,10,boy,1,11,3.053748754209315e-5
umut,10,boy,0,10,2.7761352310993775e-5
usmaan,10,boy,0,10,2.7761352310993775e-5
vir,10,boy,1,11,3.053748754209315e-5
weston,10,boy,1,11,3.053748754209315e-5
yacine,10,boy,1,11,3.053748754209315e-5
yahye,10,boy,0,10,2.7761352310993775e-5
yaqoub,10,boy,0,10,2.7761352310993775e-5
yohan,10,boy,0,10,2.7761352310993775e-5
yu,10,boy,2,12,3.331362277319253e-5
yunis,10,boy,0,10,2.7761352310993775e-5
yuvaan,10,boy,1,11,3.053748754209315e-5
zacharia,10,boy,0,10,2.7761352310993775e-5
zackery,10,boy,0,10,2.7761352310993775e-5
zayed,10,boy,0,10,2.7761352310993775e-5
zebedee,10,boy,0,10,2.7761352310993775e-5
ziyaan,10,boy,0,10,2.7761352310993775e-5
a,9,boy,1,10,2.7761352310993775e-5
a-jay,9,boy,1,10,2.7761352310993775e-5
aaditya,9,boy,0,9,2.4985217079894396e-5
aadvik,9,boy,0,9,2.4985217079894396e-5
aahan,9,boy,0,9,2.4985217079894396e-5
aariyan,9,boy,0,9,2.4985217079894396e-5
aayaan,9,boy,0,9,2.4985217079894396e-5
abaan,9,boy,1,10,2.7761352310993775e-5
abdul-haadi,9,boy,0,9,2.4985217079894396e-5
abdul-malik,9,boy,0,9,2.4985217079894396e-5
abdulwahab,9,boy,0,9,2.4985217079894396e-5
abdurraheem,9,boy,1,10,2.7761352310993775e-5
abhinav,9,boy,0,9,2.4985217079894396e-5
abram,9,boy,0,9,2.4985217079894396e-5
adel,9,boy,0,9,2.4985217079894396e-5
aeron,9,boy,0,9,2.4985217079894396e-5
ahnaf,9,boy,0,9,2.4985217079894396e-5
akeem,9,boy,0,9,2.4985217079894396e-5
alffi,9,boy,0,9,2.4985217079894396e-5
alfie-john,9,boy,0,9,2.4985217079894396e-5
aliyaan,9,boy,0,9,2.4985217079894396e-5
alvi,9,boy,0,9,2.4985217079894396e-5
andrey,9,boy,0,9,2.4985217079894396e-5
anthony-james,9,boy,1,10,2.7761352310993775e-5
aqib,9,boy,0,9,2.4985217079894396e-5
aramis,9,boy,0,9,2.4985217079894396e-5
archie-lee,9,boy,0,9,2.4985217079894396e-5
areez,9,boy,0,9,2.4985217079894396e-5
arhaan,9,boy,3,12,3.331362277319253e-5
arlind,9,boy,1,10,2.7761352310993775e-5
arminas,9,boy,0,9,2.4985217079894396e-5
aro,9,boy,0,9,2.4985217079894396e-5
artiom,9,boy,0,9,2.4985217079894396e-5
auden,9,boy,0,9,2.4985217079894396e-5
ayaansh,9,boy,0,9,2.4985217079894396e-5
bartholomew,9,boy,0,9,2.4985217079894396e-5
bassam,9,boy,0,9,2.4985217079894396e-5
bennie,9,boy,0,9,2.4985217079894396e-5
bert,9,boy,0,9,2.4985217079894396e-5
bobby-joe,9,boy,0,9,2.4985217079894396e-5
bobi,9,boy,0,9,2.4985217079894396e-5
boden,9,boy,0,9,2.4985217079894396e-5
bohdi,9,boy,0,9,2.4985217079894396e-5
boston,9,boy,0,9,2.4985217079894396e-5
bran,9,boy,0,9,2.4985217079894396e-5
cailan,9,boy,1,10,2.7761352310993775e-5
casian,9,boy,0,9,2.4985217079894396e-5
cezary,9,boy,1,10,2.7761352310993775e-5
cj,9,boy,2,11,3.053748754209315e-5
clarence,9,boy,0,9,2.4985217079894396e-5
dakota,9,boy,0,9,2.4985217079894396e-5
daren,9,boy,0,9,2.4985217079894396e-5
davey,9,boy,1,10,2.7761352310993775e-5
davids,9,boy,0,9,2.4985217079894396e-5
daxton,9,boy,0,9,2.4985217079894396e-5
dimitrios,9,boy,1,10,2.7761352310993775e-5
donald,9,boy,7,16,4.4418163697590036e-05
duarte,9,boy,0,9,2.4985217079894396e-5
edwyn,9,boy,1,10,2.7761352310993775e-5
elan,9,boy,1,10,2.7761352310993775e-5
elio,9,boy,1,10,2.7761352310993775e-5
elnathan,9,boy,0,9,2.4985217079894396e-5
elon,9,boy,0,9,2.4985217079894396e-5
emils,9,boy,0,9,2.4985217079894396e-5
ennis,9,boy,0,9,2.4985217079894396e-5
enrique,9,boy,1,10,2.7761352310993775e-5
eris,9,boy,1,10,2.7761352310993775e-5
esah,9,boy,0,9,2.4985217079894396e-5
ethan-james,9,boy,0,9,2.4985217079894396e-5
evander,9,boy,0,9,2.4985217079894396e-5
evren,9,boy,2,11,3.053748754209315e-5
ezio,9,boy,1,10,2.7761352310993775e-5
faizaan,9,boy,2,11,3.053748754209315e-5
faolan,9,boy,0,9,2.4985217079894396e-5
fares,9,boy,1,10,2.7761352310993775e-5
felipe,9,boy,1,10,2.7761352310993775e-5
flavius,9,boy,0,9,2.4985217079894396e-5
fraizer,9,boy,0,9,2.4985217079894396e-5
francois,9,boy,0,9,2.4985217079894396e-5
fuad,9,boy,0,9,2.4985217079894396e-5
gabriele,9,boy,0,9,2.4985217079894396e-5
gian,9,boy,1,10,2.7761352310993775e-5
gil,9,boy,0,9,2.4985217079894396e-5
giles,9,boy,0,9,2.4985217079894396e-5
goncalo,9,boy,0,9,2.4985217079894396e-5
gruffudd,9,boy,0,9,2.4985217079894396e-5
guney,9,boy,0,9,2.4985217079894396e-5
haashim,9,boy,0,9,2.4985217079894396e-5
halil,9,boy,0,9,2.4985217079894396e-5
harith,9,boy,0,9,2.4985217079894396e-5
harland,9,boy,1,10,2.7761352310993775e-5
harvey-jay,9,boy,1,10,2.7761352310993775e-5
hawley,9,boy,0,9,2.4985217079894396e-5
haziq,9,boy,0,9,2.4985217079894396e-5
hedley,9,boy,0,9,2.4985217079894396e-5
hektor,9,boy,0,9,2.4985217079894396e-5
hudhayfah,9,boy,0,9,2.4985217079894396e-5
hywel,9,boy,0,9,2.4985217079894396e-5
ibrahima,9,boy,0,9,2.4985217079894396e-5
ifor,9,boy,0,9,2.4985217079894396e-5
ilya,9,boy,1,10,2.7761352310993775e-5
indie,9,boy,0,9,2.4985217079894396e-5
indigo,9,boy,1,10,2.7761352310993775e-5
iosua,9,boy,1,10,2.7761352310993775e-5
iziah,9,boy,0,9,2.4985217079894396e-5
jahan,9,boy,0,9,2.4985217079894396e-5
jahziah,9,boy,0,9,2.4985217079894396e-5
jamison,9,boy,1,10,2.7761352310993775e-5
jem,9,boy,0,9,2.4985217079894396e-5
jibran,9,boy,0,9,2.4985217079894396e-5
jiyan,9,boy,1,10,2.7761352310993775e-5
joachim,9,boy,1,10,2.7761352310993775e-5
joban,9,boy,0,9,2.4985217079894396e-5
jobe,9,boy,0,9,2.4985217079894396e-5
jody,9,boy,0,9,2.4985217079894396e-5
joseph-james,9,boy,0,9,2.4985217079894396e-5
judd,9,boy,1,10,2.7761352310993775e-5
kaeden,9,boy,1,10,2.7761352310993775e-5
karanveer,9,boy,1,10,2.7761352310993775e-5
kartar,9,boy,0,9,2.4985217079894396e-5
kasim,9,boy,1,10,2.7761352310993775e-5
kayden-lee,9,boy,0,9,2.4985217079894396e-5
kazimierz,9,boy,1,10,2.7761352310993775e-5
keian,9,boy,2,11,3.053748754209315e-5
kennedy,9,boy,1,10,2.7761352310993775e-5
khalif,9,boy,0,9,2.4985217079894396e-5
kirk,9,boy,3,12,3.331362277319253e-5
kishan,9,boy,0,9,2.4985217079894396e-5
kory,9,boy,1,10,2.7761352310993775e-5
kwaku,9,boy,1,10,2.7761352310993775e-5
kylen,9,boy,0,9,2.4985217079894396e-5
kyro,9,boy,0,9,2.4985217079894396e-5
laksh,9,boy,0,9,2.4985217079894396e-5
lamar,9,boy,0,9,2.4985217079894396e-5
lawand,9,boy,0,9,2.4985217079894396e-5
layne,9,boy,0,9,2.4985217079894396e-5
llewellyn,9,boy,1,10,2.7761352310993775e-5
lorik,9,boy,0,9,2.4985217079894396e-5
loris,9,boy,0,9,2.4985217079894396e-5
lourenco,9,boy,0,9,2.4985217079894396e-5
luan,9,boy,1,10,2.7761352310993775e-5
maalik,9,boy,0,9,2.4985217079894396e-5
mabon,9,boy,0,9,2.4985217079894396e-5
mahmood,9,boy,0,9,2.4985217079894396e-5
mani,9,boy,0,9,2.4985217079894396e-5
manny,9,boy,0,9,2.4985217079894396e-5
mantas,9,boy,0,9,2.4985217079894396e-5
massimiliano,9,boy,0,9,2.4985217079894396e-5
matyas,9,boy,2,11,3.053748754209315e-5
maximiliano,9,boy,0,9,2.4985217079894396e-5
maxton,9,boy,0,9,2.4985217079894396e-5
maxymilian,9,boy,1,10,2.7761352310993775e-5
mckinley,9,boy,1,10,2.7761352310993775e-5
melvin,9,boy,1,10,2.7761352310993775e-5
merlin,9,boy,0,9,2.4985217079894396e-5
mete,9,boy,0,9,2.4985217079894396e-5
micaiah,9,boy,0,9,2.4985217079894396e-5
miley,9,boy,0,9,2.4985217079894396e-5
mithran,9,boy,0,9,2.4985217079894396e-5
mostafa,9,boy,0,9,2.4985217079894396e-5
muaz,9,boy,0,9,2.4985217079894396e-5
muhammad-eesa,9,boy,0,9,2.4985217079894396e-5
muhammad-ibrahim,9,boy,0,9,2.4985217079894396e-5
neev,9,boy,0,9,2.4985217079894396e-5
nehan,9,boy,0,9,2.4985217079894396e-5
nickolas,9,boy,1,10,2.7761352310993775e-5
nicolae,9,boy,0,9,2.4985217079894396e-5
niyam,9,boy,0,9,2.4985217079894396e-5
ole,9,boy,1,10,2.7761352310993775e-5
othniel,9,boy,0,9,2.4985217079894396e-5
panagiotis,9,boy,0,9,2.4985217079894396e-5
paris,9,boy,0,9,2.4985217079894396e-5
petros,9,boy,0,9,2.4985217079894396e-5
piers,9,boy,0,9,2.4985217079894396e-5
raffi,9,boy,0,9,2.4985217079894396e-5
ramone,9,boy,0,9,2.4985217079894396e-5
ranulph,9,boy,0,9,2.4985217079894396e-5
rei,9,boy,0,9,2.4985217079894396e-5
riaz,9,boy,0,9,2.4985217079894396e-5
rivaan,9,boy,0,9,2.4985217079894396e-5
rohit,9,boy,0,9,2.4985217079894396e-5
rollo,9,boy,0,9,2.4985217079894396e-5
roman-lee,9,boy,0,9,2.4985217079894396e-5
ronaldo,9,boy,0,9,2.4985217079894396e-5
royal,9,boy,0,9,2.4985217079894396e-5
saifullah,9,boy,0,9,2.4985217079894396e-5
samy,9,boy,1,10,2.7761352310993775e-5
sartaj,9,boy,0,9,2.4985217079894396e-5
sebastiano,9,boy,0,9,2.4985217079894396e-5
shahzaib,9,boy,0,9,2.4985217079894396e-5
shakeel,9,boy,0,9,2.4985217079894396e-5
shayden,9,boy,0,9,2.4985217079894396e-5
shayen,9,boy,0,9,2.4985217079894396e-5
shrey,9,boy,0,9,2.4985217079894396e-5
sidharth,9,boy,2,11,3.053748754209315e-5
simcha,9,boy,0,9,2.4985217079894396e-5
sinan,9,boy,1,10,2.7761352310993775e-5
storm,9,boy,0,9,2.4985217079894396e-5
sukhraj,9,boy,0,9,2.4985217079894396e-5
sulaymaan,9,boy,0,9,2.4985217079894396e-5
tao,9,boy,0,9,2.4985217079894396e-5
tayo,9,boy,0,9,2.4985217079894396e-5
terrence,9,boy,0,9,2.4985217079894396e-5
thaddeus,9,boy,0,9,2.4985217079894396e-5
tharun,9,boy,1,10,2.7761352310993775e-5
tian,9,boy,0,9,2.4985217079894396e-5
tiernan,9,boy,0,9,2.4985217079894396e-5
tommy-james,9,boy,1,10,2.7761352310993775e-5
tye,9,boy,2,11,3.053748754209315e-5
tzvi,9,boy,0,9,2.4985217079894396e-5
vaughan,9,boy,0,9,2.4985217079894396e-5
veeraj,9,boy,0,9,2.4985217079894396e-5
veeran,9,boy,0,9,2.4985217079894396e-5
wassim,9,boy,0,9,2.4985217079894396e-5
willoughby,9,boy,0,9,2.4985217079894396e-5
yakub,9,boy,0,9,2.4985217079894396e-5
yann,9,boy,1,10,2.7761352310993775e-5
zackaria,9,boy,0,9,2.4985217079894396e-5
zavian,9,boy,0,9,2.4985217079894396e-5
ziah,9,boy,0,9,2.4985217079894396e-5
ziyan,9,boy,1,10,2.7761352310993775e-5
aaden,8,boy,2,10,2.7761352310993775e-5
aari,8,boy,1,9,2.4985217079894396e-5
abdul-hadi,8,boy,0,8,2.2209081848795018e-5
abdulahi,8,boy,0,8,2.2209081848795018e-5
abdulraheem,8,boy,0,8,2.2209081848795018e-5
abdur-raheem,8,boy,0,8,2.2209081848795018e-5
abhiram,8,boy,1,9,2.4985217079894396e-5
abner,8,boy,0,8,2.2209081848795018e-5
adonai,8,boy,0,8,2.2209081848795018e-5
adrijus,8,boy,0,8,2.2209081848795018e-5
akil,8,boy,0,8,2.2209081848795018e-5
aland,8,boy,0,8,2.2209081848795018e-5
albee,8,boy,0,8,2.2209081848795018e-5
alden,8,boy,2,10,2.7761352310993775e-5
aldous,8,boy,0,8,2.2209081848795018e-5
aleksandrs,8,boy,0,8,2.2209081848795018e-5
alfredo,8,boy,0,8,2.2209081848795018e-5
alvaro,8,boy,0,8,2.2209081848795018e-5
alvie,8,boy,0,8,2.2209081848795018e-5
amay,8,boy,0,8,2.2209081848795018e-5
amen,8,boy,1,9,2.4985217079894396e-5
anders,8,boy,2,10,2.7761352310993775e-5
andres,8,boy,0,8,2.2209081848795018e-5
anis,8,boy,0,8,2.2209081848795018e-5
aqeel,8,boy,2,10,2.7761352310993775e-5
arhan,8,boy,0,8,2.2209081848795018e-5
arlow,8,boy,0,8,2.2209081848795018e-5
aspen,8,boy,1,9,2.4985217079894396e-5
aum,8,boy,0,8,2.2209081848795018e-5
awab,8,boy,2,10,2.7761352310993775e-5
aylan,8,boy,0,8,2.2209081848795018e-5
azari,8,boy,0,8,2.2209081848795018e-5
balthazar,8,boy,0,8,2.2209081848795018e-5
beck,8,boy,0,8,2.2209081848795018e-5
benaiah,8,boy,0,8,2.2209081848795018e-5
botond,8,boy,2,10,2.7761352310993775e-5
bram,8,boy,2,10,2.7761352310993775e-5
brandon-lee,8,boy,3,11,3.053748754209315e-5
burhanuddin,8,boy,0,8,2.2209081848795018e-5
carter-jay,8,boy,0,8,2.2209081848795018e-5
chaise,8,boy,1,9,2.4985217079894396e-5
chinedu,8,boy,1,9,2.4985217079894396e-5
clifford,8,boy,0,8,2.2209081848795018e-5
clinton,8,boy,1,9,2.4985217079894396e-5
clyde,8,boy,3,11,3.053748754209315e-5
dainton,8,boy,0,8,2.2209081848795018e-5
damari,8,boy,0,8,2.2209081848795018e-5
daniel-james,8,boy,0,8,2.2209081848795018e-5
darian,8,boy,1,9,2.4985217079894396e-5
dashiell,8,boy,0,8,2.2209081848795018e-5
dastan,8,boy,0,8,2.2209081848795018e-5
davie,8,boy,1,9,2.4985217079894396e-5
daya,8,boy,0,8,2.2209081848795018e-5
deep,8,boy,0,8,2.2209081848795018e-5
denas,8,boy,1,9,2.4985217079894396e-5
derrick,8,boy,0,8,2.2209081848795018e-5
derry,8,boy,2,10,2.7761352310993775e-5
desmond,8,boy,1,9,2.4985217079894396e-5
devlin,8,boy,0,8,2.2209081848795018e-5
dhanush,8,boy,0,8,2.2209081848795018e-5
dharam,8,boy,0,8,2.2209081848795018e-5
dhian,8,boy,0,8,2.2209081848795018e-5
dilanas,8,boy,1,9,2.4985217079894396e-5
dolton,8,boy,0,8,2.2209081848795018e-5
dominiks,8,boy,0,8,2.2209081848795018e-5
easa,8,boy,0,8,2.2209081848795018e-5
eashan,8,boy,0,8,2.2209081848795018e-5
eason,8,boy,0,8,2.2209081848795018e-5
ebrahim,8,boy,2,10,2.7761352310993775e-5
eesah,8,boy,1,9,2.4985217079894396e-5
ehab,8,boy,0,8,2.2209081848795018e-5
eiden,8,boy,0,8,2.2209081848795018e-5
eitan,8,boy,0,8,2.2209081848795018e-5
elden,8,boy,0,8,2.2209081848795018e-5
eldon,8,boy,0,8,2.2209081848795018e-5
eliel,8,boy,0,8,2.2209081848795018e-5
elijah-james,8,boy,0,8,2.2209081848795018e-5
elwyn,8,boy,0,8,2.2209081848795018e-5
ely,8,boy,0,8,2.2209081848795018e-5
emilian,8,boy,0,8,2.2209081848795018e-5
emirhan,8,boy,0,8,2.2209081848795018e-5
emmet,8,boy,1,9,2.4985217079894396e-5
emran,8,boy,0,8,2.2209081848795018e-5
enis,8,boy,0,8,2.2209081848795018e-5
erdem,8,boy,0,8,2.2209081848795018e-5
ernesto,8,boy,0,8,2.2209081848795018e-5
ervin,8,boy,0,8,2.2209081848795018e-5
etinosa,8,boy,1,9,2.4985217079894396e-5
evangelos,8,boy,0,8,2.2209081848795018e-5
ezel,8,boy,0,8,2.2209081848795018e-5
fabien,8,boy,0,8,2.2209081848795018e-5
fahim,8,boy,0,8,2.2209081848795018e-5
flavio,8,boy,0,8,2.2209081848795018e-5
frankie-jay,8,boy,0,8,2.2209081848795018e-5
fynnley,8,boy,0,8,2.2209081848795018e-5
gavriel,8,boy,0,8,2.2209081848795018e-5
glyn,8,boy,2,10,2.7761352310993775e-5
graysen,8,boy,0,8,2.2209081848795018e-5
gryff,8,boy,0,8,2.2209081848795018e-5
grzegorz,8,boy,0,8,2.2209081848795018e-5
gunnar,8,boy,1,9,2.4985217079894396e-5
harvin,8,boy,0,8,2.2209081848795018e-5
haytham,8,boy,0,8,2.2209081848795018e-5
hendrik,8,boy,0,8,2.2209081848795018e-5
henos,8,boy,0,8,2.2209081848795018e-5
hero,8,boy,1,9,2.4985217079894396e-5
iannis,8,boy,0,8,2.2209081848795018e-5
ianto,8,boy,0,8,2.2209081848795018e-5
iasonas,8,boy,1,9,2.4985217079894396e-5
imaan,8,boy,0,8,2.2209081848795018e-5
is'haaq,8,boy,0,8,2.2209081848795018e-5
isam,8,boy,0,8,2.2209081848795018e-5
islam,8,boy,0,8,2.2209081848795018e-5
iyad,8,boy,0,8,2.2209081848795018e-5
jacoby,8,boy,0,8,2.2209081848795018e-5
jaidon,8,boy,0,8,2.2209081848795018e-5
james-junior,8,boy,0,8,2.2209081848795018e-5
johann,8,boy,0,8,2.2209081848795018e-5
jonjo,8,boy,0,8,2.2209081848795018e-5
jorawar,8,boy,0,8,2.2209081848795018e-5
kacey,8,boy,1,9,2.4985217079894396e-5
kaian,8,boy,0,8,2.2209081848795018e-5
kaito,8,boy,0,8,2.2209081848795018e-5
kassim,8,boy,0,8,2.2209081848795018e-5
kassius,8,boy,0,8,2.2209081848795018e-5
kavi,8,boy,0,8,2.2209081848795018e-5
kavish,8,boy,0,8,2.2209081848795018e-5
keigan,8,boy,1,9,2.4985217079894396e-5
kenley,8,boy,0,8,2.2209081848795018e-5
kidus,8,boy,0,8,2.2209081848795018e-5
kip,8,boy,0,8,2.2209081848795018e-5
kristers,8,boy,0,8,2.2209081848795018e-5
kristof,8,boy,0,8,2.2209081848795018e-5
leighton-james,8,boy,0,8,2.2209081848795018e-5
lian,8,boy,0,8,2.2209081848795018e-5
locryn,8,boy,0,8,2.2209081848795018e-5
logan-jay,8,boy,0,8,2.2209081848795018e-5
lonnie,8,boy,1,9,2.4985217079894396e-5
lynden,8,boy,0,8,2.2209081848795018e-5
madoc,8,boy,0,8,2.2209081848795018e-5
maks,8,boy,0,8,2.2209081848795018e-5
maksym,8,boy,1,9,2.4985217079894396e-5
matt,8,boy,1,9,2.4985217079894396e-5
matus,8,boy,0,8,2.2209081848795018e-5
matvey,8,boy,0,8,2.2209081848795018e-5
mayan,8,boy,0,8,2.2209081848795018e-5
menachem,8,boy,0,8,2.2209081848795018e-5
michail,8,boy,0,8,2.2209081848795018e-5
mieszko,8,boy,1,9,2.4985217079894396e-5
mihir,8,boy,0,8,2.2209081848795018e-5
mihran,8,boy,0,8,2.2209081848795018e-5
millan,8,boy,0,8,2.2209081848795018e-5
mirac,8,boy,1,9,2.4985217079894396e-5
moiz,8,boy,0,8,2.2209081848795018e-5
momin,8,boy,2,10,2.7761352310993775e-5
monte,8,boy,0,8,2.2209081848795018e-5
moussa,8,boy,0,8,2.2209081848795018e-5
muhammad-ayaan,8,boy,0,8,2.2209081848795018e-5
muhammad-mustafa,8,boy,0,8,2.2209081848795018e-5
muizz,8,boy,0,8,2.2209081848795018e-5
munir,8,boy,0,8,2.2209081848795018e-5
mylan,8,boy,0,8,2.2209081848795018e-5
naim,8,boy,0,8,2.2209081848795018e-5
narayan,8,boy,0,8,2.2209081848795018e-5
nero,8,boy,1,9,2.4985217079894396e-5
nima,8,boy,0,8,2.2209081848795018e-5
nyall,8,boy,1,9,2.4985217079894396e-5
oaklee,8,boy,0,8,2.2209081848795018e-5
obinna,8,boy,0,8,2.2209081848795018e-5
oliver-jay,8,boy,0,8,2.2209081848795018e-5
olli,8,boy,1,9,2.4985217079894396e-5
ollie-james,8,boy,0,8,2.2209081848795018e-5
oluwadamilare,8,boy,0,8,2.2209081848795018e-5
oluwademilade,8,boy,0,8,2.2209081848795018e-5
oluwaferanmi,8,boy,0,8,2.2209081848795018e-5
omid,8,boy,2,10,2.7761352310993775e-5
onyx,8,boy,0,8,2.2209081848795018e-5
opie,8,boy,0,8,2.2209081848795018e-5
ousman,8,boy,0,8,2.2209081848795018e-5
owyn,8,boy,1,9,2.4985217079894396e-5
parsa,8,boy,1,9,2.4985217079894396e-5
pharrell,8,boy,0,8,2.2209081848795018e-5
praise,8,boy,1,9,2.4985217079894396e-5
radley,8,boy,0,8,2.2209081848795018e-5
raed,8,boy,0,8,2.2209081848795018e-5
rai,8,boy,0,8,2.2209081848795018e-5
ram,8,boy,0,8,2.2209081848795018e-5
ramsay,8,boy,9,17,4.7194298928689415e-5
rayne,8,boy,0,8,2.2209081848795018e-5
reeve,8,boy,1,9,2.4985217079894396e-5
remus,8,boy,0,8,2.2209081848795018e-5
rey,8,boy,1,9,2.4985217079894396e-5
reyaan,8,boy,0,8,2.2209081848795018e-5
rhett,8,boy,0,8,2.2209081848795018e-5
riad,8,boy,0,8,2.2209081848795018e-5
roary,8,boy,0,8,2.2209081848795018e-5
ron,8,boy,0,8,2.2209081848795018e-5
ronnie-jay,8,boy,0,8,2.2209081848795018e-5
ryleigh,8,boy,0,8,2.2209081848795018e-5
sahal,8,boy,0,8,2.2209081848795018e-5
sahir,8,boy,1,9,2.4985217079894396e-5
salahudeen,8,boy,0,8,2.2209081848795018e-5
saleem,8,boy,0,8,2.2209081848795018e-5
samual,8,boy,0,8,2.2209081848795018e-5
san,8,boy,0,8,2.2209081848795018e-5
saran,8,boy,0,8,2.2209081848795018e-5
seve,8,boy,0,8,2.2209081848795018e-5
shaye,8,boy,3,11,3.053748754209315e-5
sheriff,8,boy,0,8,2.2209081848795018e-5
shivaay,8,boy,0,8,2.2209081848795018e-5
shlok,8,boy,0,8,2.2209081848795018e-5
shravan,8,boy,0,8,2.2209081848795018e-5
skyler,8,boy,0,8,2.2209081848795018e-5
soham,8,boy,0,8,2.2209081848795018e-5
sonni,8,boy,0,8,2.2209081848795018e-5
soul,8,boy,0,8,2.2209081848795018e-5
stefanos,8,boy,1,9,2.4985217079894396e-5
steve,8,boy,0,8,2.2209081848795018e-5
sukhman,8,boy,0,8,2.2209081848795018e-5
sylvester,8,boy,0,8,2.2209081848795018e-5
tanvir,8,boy,0,8,2.2209081848795018e-5
tarun,8,boy,0,8,2.2209081848795018e-5
taym,8,boy,0,8,2.2209081848795018e-5
teddy-ray,8,boy,0,8,2.2209081848795018e-5
tenzin,8,boy,0,8,2.2209081848795018e-5
timas,8,boy,0,8,2.2209081848795018e-5
timmy,8,boy,0,8,2.2209081848795018e-5
titas,8,boy,1,9,2.4985217079894396e-5
tommy-jay,8,boy,0,8,2.2209081848795018e-5
twm,8,boy,0,8,2.2209081848795018e-5
tyler-john,8,boy,1,9,2.4985217079894396e-5
ubayd,8,boy,0,8,2.2209081848795018e-5
uriah,8,boy,0,8,2.2209081848795018e-5
usayd,8,boy,0,8,2.2209081848795018e-5
vikram,8,boy,1,9,2.4985217079894396e-5
viraaj,8,boy,0,8,2.2209081848795018e-5
viyaan,8,boy,0,8,2.2209081848795018e-5
vyom,8,boy,0,8,2.2209081848795018e-5
waseem,8,boy,0,8,2.2209081848795018e-5
wolfgang,8,boy,0,8,2.2209081848795018e-5
yaakov,8,boy,0,8,2.2209081848795018e-5
yameen,8,boy,0,8,2.2209081848795018e-5
yoan,8,boy,0,8,2.2209081848795018e-5
zahi,8,boy,0,8,2.2209081848795018e-5
zaylen,8,boy,0,8,2.2209081848795018e-5
zevi,8,boy,0,8,2.2209081848795018e-5
zuhair,8,boy,0,8,2.2209081848795018e-5
zulqarnain,8,boy,0,8,2.2209081848795018e-5
abdalla,7,boy,0,7,1.943294661769564e-5
abdulhadi,7,boy,0,7,1.943294661769564e-5
abeer,7,boy,0,7,1.943294661769564e-5
abhay,7,boy,0,7,1.943294661769564e-5
adhvik,7,boy,0,7,1.943294661769564e-5
adrien,7,boy,0,7,1.943294661769564e-5
afnan,7,boy,0,7,1.943294661769564e-5
agamveer,7,boy,0,7,1.943294661769564e-5
agastya,7,boy,0,7,1.943294661769564e-5
aharon,7,boy,0,7,1.943294661769564e-5
aian,7,boy,0,7,1.943294661769564e-5
aidan-james,7,boy,0,7,1.943294661769564e-5
ajai,7,boy,0,7,1.943294661769564e-5
ajit,7,boy,0,7,1.943294661769564e-5
akif,7,boy,0,7,1.943294661769564e-5
akira,7,boy,1,8,2.2209081848795018e-5
akshay,7,boy,0,7,1.943294661769564e-5
alaric,7,boy,1,8,2.2209081848795018e-5
alexandr,7,boy,0,7,1.943294661769564e-5
almir,7,boy,0,7,1.943294661769564e-5
alonso,7,boy,0,7,1.943294661769564e-5
amadou,7,boy,1,8,2.2209081848795018e-5
amer,7,boy,0,7,1.943294661769564e-5
amjad,7,boy,1,8,2.2209081848795018e-5
andrej,7,boy,0,7,1.943294661769564e-5
araf,7,boy,0,7,1.943294661769564e-5
arber,7,boy,0,7,1.943294661769564e-5
archie-jay,7,boy,0,7,1.943294661769564e-5
ariz,7,boy,0,7,1.943294661769564e-5
arlan,7,boy,0,7,1.943294661769564e-5
arlo-james,7,boy,0,7,1.943294661769564e-5
arloh,7,boy,1,8,2.2209081848795018e-5
armand,7,boy,2,9,2.4985217079894396e-5
aros,7,boy,0,7,1.943294661769564e-5
arsalan,7,boy,0,7,1.943294661769564e-5
arta,7,boy,0,7,1.943294661769564e-5
arturs,7,boy,3,10,2.7761352310993775e-5
arwyn,7,boy,0,7,1.943294661769564e-5
atif,7,boy,0,7,1.943294661769564e-5
attila,7,boy,2,9,2.4985217079894396e-5
bader,7,boy,0,7,1.943294661769564e-5
bartek,7,boy,0,7,1.943294661769564e-5
blessing,7,boy,0,7,1.943294661769564e-5
bobby-james,7,boy,1,8,2.2209081848795018e-5
braylen,7,boy,0,7,1.943294661769564e-5
bright,7,boy,0,7,1.943294661769564e-5
buddie,7,boy,0,7,1.943294661769564e-5
cairon,7,boy,0,7,1.943294661769564e-5
calin,7,boy,1,8,2.2209081848795018e-5
carmelo,7,boy,0,7,1.943294661769564e-5
cato,7,boy,0,7,1.943294661769564e-5
celt,7,boy,0,7,1.943294661769564e-5
charlie-george,7,boy,0,7,1.943294661769564e-5
chukwuemeka,7,boy,0,7,1.943294661769564e-5
cinar,7,boy,1,8,2.2209081848795018e-5
claude,7,boy,0,7,1.943294661769564e-5
cody-james,7,boy,2,9,2.4985217079894396e-5
colm,7,boy,0,7,1.943294661769564e-5
cornelius,7,boy,2,9,2.4985217079894396e-5
daanish,7,boy,0,7,1.943294661769564e-5
daiyan,7,boy,0,7,1.943294661769564e-5
damilola,7,boy,0,7,1.943294661769564e-5
damion,7,boy,1,8,2.2209081848795018e-5
darby,7,boy,0,7,1.943294661769564e-5
dave,7,boy,0,7,1.943294661769564e-5
davian,7,boy,0,7,1.943294661769564e-5
dempsey,7,boy,0,7,1.943294661769564e-5
deontay,7,boy,0,7,1.943294661769564e-5
deshawn,7,boy,0,7,1.943294661769564e-5
desire,7,boy,0,7,1.943294661769564e-5
destan,7,boy,0,7,1.943294661769564e-5
deven,7,boy,0,7,1.943294661769564e-5
dewan,7,boy,0,7,1.943294661769564e-5
dov,7,boy,0,7,1.943294661769564e-5
eamon,7,boy,0,7,1.943294661769564e-5
eban,7,boy,0,7,1.943294661769564e-5
edmond,7,boy,0,7,1.943294661769564e-5
edouard,7,boy,0,7,1.943294661769564e-5
edris,7,boy,0,7,1.943294661769564e-5
edvin,7,boy,0,7,1.943294661769564e-5
efrem,7,boy,0,7,1.943294661769564e-5
eifion,7,boy,0,7,1.943294661769564e-5
eleazar,7,boy,0,7,1.943294661769564e-5
eliyas,7,boy,0,7,1.943294661769564e-5
elton,7,boy,0,7,1.943294661769564e-5
emad,7,boy,0,7,1.943294661769564e-5
emiliano,7,boy,1,8,2.2209081848795018e-5
emyr,7,boy,0,7,1.943294661769564e-5
endri,7,boy,0,7,1.943294661769564e-5
esteban,7,boy,0,7,1.943294661769564e-5
ethen,7,boy,0,7,1.943294661769564e-5
farhaan,7,boy,0,7,1.943294661769564e-5
farid,7,boy,0,7,1.943294661769564e-5
fawaz,7,boy,0,7,1.943294661769564e-5
fidel,7,boy,1,8,2.2209081848795018e-5
finlee,7,boy,0,7,1.943294661769564e-5
finnbar,7,boy,1,8,2.2209081848795018e-5
frankie-james,7,boy,0,7,1.943294661769564e-5
freddie-ray,7,boy,0,7,1.943294661769564e-5
frederico,7,boy,0,7,1.943294661769564e-5
giaan,7,boy,0,7,1.943294661769564e-5
glenn,7,boy,4,11,3.053748754209315e-5
griffith,7,boy,0,7,1.943294661769564e-5
gurkirat,7,boy,0,7,1.943294661769564e-5
gurman,7,boy,1,8,2.2209081848795018e-5
gurtaj,7,boy,0,7,1.943294661769564e-5
gustavs,7,boy,1,8,2.2209081848795018e-5
hadrian,7,boy,0,7,1.943294661769564e-5
haidar,7,boy,0,7,1.943294661769564e-5
hakan,7,boy,0,7,1.943294661769564e-5
hamad,7,boy,1,8,2.2209081848795018e-5
harjan,7,boy,0,7,1.943294661769564e-5
harley-ray,7,boy,0,7,1.943294661769564e-5
harnoor,7,boy,0,7,1.943294661769564e-5
harvie,7,boy,2,9,2.4985217079894396e-5
humaid,7,boy,1,8,2.2209081848795018e-5
husain,7,boy,0,7,1.943294661769564e-5
ikenna,7,boy,0,7,1.943294661769564e-5
isambard,7,boy,0,7,1.943294661769564e-5
ivaan,7,boy,1,8,2.2209081848795018e-5
jacek,7,boy,2,9,2.4985217079894396e-5
jacob-lee,7,boy,0,7,1.943294661769564e-5
jacub,7,boy,0,7,1.943294661769564e-5
jaeden,7,boy,0,7,1.943294661769564e-5
jaheim,7,boy,0,7,1.943294661769564e-5
jainil,7,boy,1,8,2.2209081848795018e-5
jairaj,7,boy,1,8,2.2209081848795018e-5
jaison,7,boy,0,7,1.943294661769564e-5
jasraj,7,boy,0,7,1.943294661769564e-5
jaycob,7,boy,1,8,2.2209081848795018e-5
jayen,7,boy,0,7,1.943294661769564e-5
jayke,7,boy,0,7,1.943294661769564e-5
jefferson,7,boy,0,7,1.943294661769564e-5
jenson-jay,7,boy,0,7,1.943294661769564e-5
jordan-junior,7,boy,0,7,1.943294661769564e-5
jordon,7,boy,1,8,2.2209081848795018e-5
justas,7,boy,1,8,2.2209081848795018e-5
kaiden-lee,7,boy,0,7,1.943294661769564e-5
kaio,7,boy,0,7,1.943294661769564e-5
kalen,7,boy,2,9,2.4985217079894396e-5
kamsiyochukwu,7,boy,0,7,1.943294661769564e-5
kanish,7,boy,0,7,1.943294661769564e-5
karthik,7,boy,0,7,1.943294661769564e-5
kartik,7,boy,0,7,1.943294661769564e-5
kaspar,7,boy,3,10,2.7761352310993775e-5
kaspian,7,boy,0,7,1.943294661769564e-5
kaveer,7,boy,0,7,1.943294661769564e-5
kazi,7,boy,1,8,2.2209081848795018e-5
keiran,7,boy,5,12,3.331362277319253e-5
keith,7,boy,2,9,2.4985217079894396e-5
kemal,7,boy,0,7,1.943294661769564e-5
kenzi,7,boy,1,8,2.2209081848795018e-5
keyon,7,boy,1,8,2.2209081848795018e-5
khai,7,boy,2,9,2.4985217079894396e-5
khalis,7,boy,0,7,1.943294661769564e-5
kinan,7,boy,1,8,2.2209081848795018e-5
kirat,7,boy,0,7,1.943294661769564e-5
kiro,7,boy,1,8,2.2209081848795018e-5
kris,7,boy,4,11,3.053748754209315e-5
kyler,7,boy,5,12,3.331362277319253e-5
kyreece,7,boy,0,7,1.943294661769564e-5
laken,7,boy,1,8,2.2209081848795018e-5
lathan,7,boy,1,8,2.2209081848795018e-5
lebron,7,boy,0,7,1.943294661769564e-5
leo-jay,7,boy,0,7,1.943294661769564e-5
linus,7,boy,0,7,1.943294661769564e-5
llewyn,7,boy,1,8,2.2209081848795018e-5
llywelyn,7,boy,0,7,1.943294661769564e-5
louie-james,7,boy,0,7,1.943294661769564e-5
lucas-jay,7,boy,0,7,1.943294661769564e-5
lucio,7,boy,0,7,1.943294661769564e-5
mac,7,boy,13,20,5.552270462198755e-5
majid,7,boy,0,7,1.943294661769564e-5
maleek,7,boy,1,8,2.2209081848795018e-5
malek,7,boy,2,9,2.4985217079894396e-5
marcu,7,boy,0,7,1.943294661769564e-5
marshal,7,boy,0,7,1.943294661769564e-5
martins,7,boy,1,8,2.2209081848795018e-5
mauro,7,boy,0,7,1.943294661769564e-5
maximos,7,boy,0,7,1.943294661769564e-5
maxon,7,boy,0,7,1.943294661769564e-5
mehran,7,boy,1,8,2.2209081848795018e-5
melchizedek,7,boy,0,7,1.943294661769564e-5
miracle,7,boy,0,7,1.943294661769564e-5
miroslav,7,boy,0,7,1.943294661769564e-5
motiejus,7,boy,0,7,1.943294661769564e-5
muaadh,7,boy,1,8,2.2209081848795018e-5
muhamed,7,boy,0,7,1.943294661769564e-5
muneeb,7,boy,0,7,1.943294661769564e-5
myron,7,boy,0,7,1.943294661769564e-5
nassim,7,boy,0,7,1.943294661769564e-5
neidas,7,boy,0,7,1.943294661769564e-5
neitas,7,boy,0,7,1.943294661769564e-5
neymar,7,boy,0,7,1.943294661769564e-5
nikolay,7,boy,1,8,2.2209081848795018e-5
nimrod,7,boy,1,8,2.2209081848795018e-5
nino,7,boy,0,7,1.943294661769564e-5
nirvair,7,boy,1,8,2.2209081848795018e-5
nooh,7,boy,0,7,1.943294661769564e-5
nuri,7,boy,0,7,1.943294661769564e-5
oluwadarasimi,7,boy,1,8,2.2209081848795018e-5
orrin,7,boy,6,13,3.60897580042919e-5
paramveer,7,boy,1,8,2.2209081848795018e-5
payton,7,boy,0,7,1.943294661769564e-5
pierce,7,boy,1,8,2.2209081848795018e-5
porter,7,boy,0,7,1.943294661769564e-5
priyansh,7,boy,0,7,1.943294661769564e-5
prosper,7,boy,0,7,1.943294661769564e-5
quin,7,boy,5,12,3.331362277319253e-5
qusai,7,boy,1,8,2.2209081848795018e-5
rafal,7,boy,0,7,1.943294661769564e-5
rahand,7,boy,0,7,1.943294661769564e-5
rahil,7,boy,0,7,1.943294661769564e-5
rakeem,7,boy,0,7,1.943294661769564e-5
rana,7,boy,2,9,2.4985217079894396e-5
rand,7,boy,0,7,1.943294661769564e-5
raven,7,boy,0,7,1.943294661769564e-5
raza,7,boy,0,7,1.943294661769564e-5
red,7,boy,0,7,1.943294661769564e-5
rishabh,7,boy,0,7,1.943294661769564e-5
riyon,7,boy,0,7,1.943294661769564e-5
romero,7,boy,0,7,1.943294661769564e-5
ronnie-lee,7,boy,0,7,1.943294661769564e-5
ronnie-ray,7,boy,0,7,1.943294661769564e-5
ruhaan,7,boy,0,7,1.943294661769564e-5
ryu,7,boy,0,7,1.943294661769564e-5
sajjad,7,boy,0,7,1.943294661769564e-5
salvatore,7,boy,1,8,2.2209081848795018e-5
shaquille,7,boy,0,7,1.943294661769564e-5
shaydon,7,boy,0,7,1.943294661769564e-5
shia,7,boy,0,7,1.943294661769564e-5
shivan,7,boy,0,7,1.943294661769564e-5
simas,7,boy,2,9,2.4985217079894396e-5
sky,7,boy,0,7,1.943294661769564e-5
sofian,7,boy,0,7,1.943294661769564e-5
sohan,7,boy,0,7,1.943294661769564e-5
stellan,7,boy,2,9,2.4985217079894396e-5
struan,7,boy,54,61,1.6934424909706203e-4
sufiyan,7,boy,0,7,1.943294661769564e-5
suhayb,7,boy,0,7,1.943294661769564e-5
t-jay,7,boy,0,7,1.943294661769564e-5
tamas,7,boy,0,7,1.943294661769564e-5
tamim,7,boy,1,8,2.2209081848795018e-5
tanveer,7,boy,0,7,1.943294661769564e-5
taylen,7,boy,0,7,1.943294661769564e-5
tayler,7,boy,0,7,1.943294661769564e-5
taylor-jay,7,boy,0,7,1.943294661769564e-5
theophilus,7,boy,0,7,1.943294661769564e-5
thorin,7,boy,2,9,2.4985217079894396e-5
tiger,7,boy,0,7,1.943294661769564e-5
timofey,7,boy,0,7,1.943294661769564e-5
timothee,7,boy,0,7,1.943294661769564e-5
tommy-joe,7,boy,0,7,1.943294661769564e-5
torsten,7,boy,0,7,1.943294661769564e-5
tyger,7,boy,0,7,1.943294661769564e-5
tyla,7,boy,0,7,1.943294661769564e-5
tyler-lee,7,boy,0,7,1.943294661769564e-5
tytus,7,boy,0,7,1.943294661769564e-5
umer,7,boy,0,7,1.943294661769564e-5
vadim,7,boy,0,7,1.943294661769564e-5
vicente,7,boy,0,7,1.943294661769564e-5
wasif,7,boy,0,7,1.943294661769564e-5
wei,7,boy,0,7,1.943294661769564e-5
wilder,7,boy,0,7,1.943294661769564e-5
wilfrid,7,boy,0,7,1.943294661769564e-5
xzavier,7,boy,0,7,1.943294661769564e-5
yacoub,7,boy,0,7,1.943294661769564e-5
yad,7,boy,0,7,1.943294661769564e-5
yasa,7,boy,0,7,1.943294661769564e-5
yonis,7,boy,0,7,1.943294661769564e-5
yves,7,boy,0,7,1.943294661769564e-5
zahran,7,boy,1,8,2.2209081848795018e-5
zeus,7,boy,1,8,2.2209081848795018e-5
zishan,7,boy,0,7,1.943294661769564e-5
zoltan,7,boy,0,7,1.943294661769564e-5
aadi,6,boy,1,7,1.943294661769564e-5
aaren,6,boy,1,7,1.943294661769564e-5
aarian,6,boy,0,6,1.6656811386596265e-5
aarin,6,boy,0,6,1.6656811386596265e-5
aarnav,6,boy,0,6,1.6656811386596265e-5
aasim,6,boy,0,6,1.6656811386596265e-5
abdoulie,6,boy,0,6,1.6656811386596265e-5
abdul-ahad,6,boy,0,6,1.6656811386596265e-5
abdul-hakeem,6,boy,0,6,1.6656811386596265e-5
abdul-kareem,6,boy,0,6,1.6656811386596265e-5
abdul-raheem,6,boy,1,7,1.943294661769564e-5
abdulla,6,boy,0,6,1.6656811386596265e-5
abir,6,boy,1,7,1.943294661769564e-5
achilles,6,boy,1,7,1.943294661769564e-5
adiyan,6,boy,1,7,1.943294661769564e-5
adnaan,6,boy,0,6,1.6656811386596265e-5
adonay,6,boy,1,7,1.943294661769564e-5
adrians,6,boy,0,6,1.6656811386596265e-5
ahron,6,boy,0,6,1.6656811386596265e-5
ajwad,6,boy,0,6,1.6656811386596265e-5
akash,6,boy,1,7,1.943294661769564e-5
akshar,6,boy,0,6,1.6656811386596265e-5
al,6,boy,0,6,1.6656811386596265e-5
alekss,6,boy,1,7,1.943294661769564e-5
alexi,6,boy,0,6,1.6656811386596265e-5
alexzander,6,boy,1,7,1.943294661769564e-5
alfie-jack,6,boy,1,7,1.943294661769564e-5
alfie-ray,6,boy,0,6,1.6656811386596265e-5
alfonso,6,boy,2,8,2.2209081848795018e-5
alhassan,6,boy,0,6,1.6656811386596265e-5
amaad,6,boy,0,6,1.6656811386596265e-5
amadeus,6,boy,0,6,1.6656811386596265e-5
amandeep,6,boy,0,6,1.6656811386596265e-5
amias,6,boy,0,6,1.6656811386596265e-5
amr,6,boy,2,8,2.2209081848795018e-5
anand,6,boy,1,7,1.943294661769564e-5
anastasios,6,boy,0,6,1.6656811386596265e-5
anees,6,boy,0,6,1.6656811386596265e-5
ansel,6,boy,0,6,1.6656811386596265e-5
anvay,6,boy,0,6,1.6656811386596265e-5
arad,6,boy,0,6,1.6656811386596265e-5
araz,6,boy,0,6,1.6656811386596265e-5
archi,6,boy,1,7,1.943294661769564e-5
archie-ray,6,boy,0,6,1.6656811386596265e-5
archy,6,boy,2,8,2.2209081848795018e-5
arfan,6,boy,0,6,1.6656811386596265e-5
arinze,6,boy,1,7,1.943294661769564e-5
ario,6,boy,0,6,1.6656811386596265e-5
arkadiusz,6,boy,0,6,1.6656811386596265e-5
arno,6,boy,0,6,1.6656811386596265e-5
arslan,6,boy,0,6,1.6656811386596265e-5
artjoms,6,boy,0,6,1.6656811386596265e-5
aryeh,6,boy,0,6,1.6656811386596265e-5
ashvin,6,boy,0,6,1.6656811386596265e-5
asif,6,boy,0,6,1.6656811386596265e-5
ata,6,boy,0,6,1.6656811386596265e-5
ates,6,boy,0,6,1.6656811386596265e-5
aven,6,boy,0,6,1.6656811386596265e-5
ayham,6,boy,0,6,1.6656811386596265e-5
azhar,6,boy,0,6,1.6656811386596265e-5
balraj,6,boy,0,6,1.6656811386596265e-5
belal,6,boy,0,6,1.6656811386596265e-5
benzion,6,boy,0,6,1.6656811386596265e-5
billy-ray,6,boy,0,6,1.6656811386596265e-5
blair,6,boy,83,89,2.4707603556784456e-4
brae,6,boy,0,6,1.6656811386596265e-5
braeden,6,boy,3,9,2.4985217079894396e-5
brajan,6,boy,0,6,1.6656811386596265e-5
brandan,6,boy,0,6,1.6656811386596265e-5
brayen,6,boy,0,6,1.6656811386596265e-5
bret,6,boy,1,7,1.943294661769564e-5
brody-lee,6,boy,0,6,1.6656811386596265e-5
brooks,6,boy,0,6,1.6656811386596265e-5
brynley,6,boy,0,6,1.6656811386596265e-5
burak,6,boy,0,6,1.6656811386596265e-5
busby,6,boy,0,6,1.6656811386596265e-5
caelen,6,boy,1,7,1.943294661769564e-5
cailen,6,boy,0,6,1.6656811386596265e-5
can,6,boy,0,6,1.6656811386596265e-5
canaan,6,boy,0,6,1.6656811386596265e-5
carlisle,6,boy,1,7,1.943294661769564e-5
carter-lee,6,boy,0,6,1.6656811386596265e-5
cavalli,6,boy,0,6,1.6656811386596265e-5
cayde,6,boy,2,8,2.2209081848795018e-5
chael,6,boy,0,6,1.6656811386596265e-5
charlee,6,boy,0,6,1.6656811386596265e-5
claudiu,6,boy,0,6,1.6656811386596265e-5
coby-james,6,boy,0,6,1.6656811386596265e-5
constantinos,6,boy,0,6,1.6656811386596265e-5
courtney,6,boy,0,6,1.6656811386596265e-5
csaba,6,boy,0,6,1.6656811386596265e-5
cyril,6,boy,0,6,1.6656811386596265e-5
d'angelo,6,boy,0,6,1.6656811386596265e-5
daithi,6,boy,0,6,1.6656811386596265e-5
daivik,6,boy,0,6,1.6656811386596265e-5
daniele,6,boy,0,6,1.6656811386596265e-5
danila,6,boy,0,6,1.6656811386596265e-5
daniyaal,6,boy,0,6,1.6656811386596265e-5
danny-joe,6,boy,0,6,1.6656811386596265e-5
darien,6,boy,0,6,1.6656811386596265e-5
darryl,6,boy,0,6,1.6656811386596265e-5
deimantas,6,boy,0,6,1.6656811386596265e-5
destiny,6,boy,0,6,1.6656811386596265e-5
dhanvin,6,boy,0,6,1.6656811386596265e-5
dimitris,6,boy,1,7,1.943294661769564e-5
doug,6,boy,0,6,1.6656811386596265e-5
dylan-james,6,boy,0,6,1.6656811386596265e-5
edvard,6,boy,0,6,1.6656811386596265e-5
efraim,6,boy,1,7,1.943294661769564e-5
eliah,6,boy,1,7,1.943294661769564e-5
emaad,6,boy,0,6,1.6656811386596265e-5
enea,6,boy,0,6,1.6656811386596265e-5
erioluwa,6,boy,1,7,1.943294661769564e-5
faiz,6,boy,1,7,1.943294661769564e-5
fedor,6,boy,0,6,1.6656811386596265e-5
fin,6,boy,2,8,2.2209081848795018e-5
finian,6,boy,0,6,1.6656811386596265e-5
finley-jay,6,boy,0,6,1.6656811386596265e-5
finnick,6,boy,2,8,2.2209081848795018e-5
fraiser,6,boy,0,6,1.6656811386596265e-5
frasier,6,boy,0,6,1.6656811386596265e-5
freddie-jay,6,boy,0,6,1.6656811386596265e-5
fryderyk,6,boy,0,6,1.6656811386596265e-5
gabe,6,boy,0,6,1.6656811386596265e-5
gabor,6,boy,0,6,1.6656811386596265e-5
garry,6,boy,3,9,2.4985217079894396e-5
gautham,6,boy,0,6,1.6656811386596265e-5
georgio,6,boy,0,6,1.6656811386596265e-5
gethyn,6,boy,0,6,1.6656811386596265e-5
gibson,6,boy,1,7,1.943294661769564e-5
guillermo,6,boy,0,6,1.6656811386596265e-5
guransh,6,boy,0,6,1.6656811386596265e-5
gursahib,6,boy,0,6,1.6656811386596265e-5
haashir,6,boy,0,6,1.6656811386596265e-5
hamaad,6,boy,0,6,1.6656811386596265e-5
hamilton,6,boy,0,6,1.6656811386596265e-5
han,6,boy,3,9,2.4985217079894396e-5
hanzala,6,boy,1,7,1.943294661769564e-5
harjot,6,boy,0,6,1.6656811386596265e-5
harley-jai,6,boy,0,6,1.6656811386596265e-5
harley-john,6,boy,0,6,1.6656811386596265e-5
harlie,6,boy,0,6,1.6656811386596265e-5
haron,6,boy,0,6,1.6656811386596265e-5
harrie,6,boy,1,7,1.943294661769564e-5
harrington,6,boy,0,6,1.6656811386596265e-5
haruki,6,boy,0,6,1.6656811386596265e-5
harvir,6,boy,0,6,1.6656811386596265e-5
hatim,6,boy,0,6,1.6656811386596265e-5
haydar,6,boy,0,6,1.6656811386596265e-5
hayden-james,6,boy,2,8,2.2209081848795018e-5
hayden-lee,6,boy,0,6,1.6656811386596265e-5
haydon,6,boy,0,6,1.6656811386596265e-5
henrie,6,boy,0,6,1.6656811386596265e-5
hilton,6,boy,0,6,1.6656811386596265e-5
hristo,6,boy,0,6,1.6656811386596265e-5
humayun,6,boy,0,6,1.6656811386596265e-5
iain,6,boy,7,13,3.60897580042919e-5
idriss,6,boy,0,6,1.6656811386596265e-5
imtiaz,6,boy,0,6,1.6656811386596265e-5
iori,6,boy,0,6,1.6656811386596265e-5
isaac-james,6,boy,0,6,1.6656811386596265e-5
ivar,6,boy,1,7,1.943294661769564e-5
iver,6,boy,0,6,1.6656811386596265e-5
izak,6,boy,1,7,1.943294661769564e-5
jack-junior,6,boy,1,7,1.943294661769564e-5
jackson-james,6,boy,0,6,1.6656811386596265e-5
jahsiah,6,boy,0,6,1.6656811386596265e-5
jaidan,6,boy,0,6,1.6656811386596265e-5
jamie-junior,6,boy,1,7,1.943294661769564e-5
jamieson,6,boy,0,6,1.6656811386596265e-5
janos,6,boy,0,6,1.6656811386596265e-5
japnoor,6,boy,0,6,1.6656811386596265e-5
jaroslav,6,boy,0,6,1.6656811386596265e-5
jarrod,6,boy,0,6,1.6656811386596265e-5
jasim,6,boy,0,6,1.6656811386596265e-5
jasnoor,6,boy,0,6,1.6656811386596265e-5
jaxton,6,boy,0,6,1.6656811386596265e-5
jay-j,6,boy,0,6,1.6656811386596265e-5
jaycee,6,boy,0,6,1.6656811386596265e-5
jean,6,boy,0,6,1.6656811386596265e-5
jean-luc,6,boy,0,6,1.6656811386596265e-5
jeet,6,boy,0,6,1.6656811386596265e-5
jeriah,6,boy,0,6,1.6656811386596265e-5
jericho,6,boy,0,6,1.6656811386596265e-5
jesiah,6,boy,0,6,1.6656811386596265e-5
jesper,6,boy,0,6,1.6656811386596265e-5
jesus,6,boy,0,6,1.6656811386596265e-5
john-joseph,6,boy,0,6,1.6656811386596265e-5
johnson,6,boy,0,6,1.6656811386596265e-5
jona,6,boy,0,6,1.6656811386596265e-5
joud,6,boy,0,6,1.6656811386596265e-5
joy,6,boy,0,6,1.6656811386596265e-5
jun,6,boy,2,8,2.2209081848795018e-5
kaileb,6,boy,1,7,1.943294661769564e-5
kailum,6,boy,1,7,1.943294661769564e-5
kalvin,6,boy,7,13,3.60897580042919e-5
kalyan,6,boy,0,6,1.6656811386596265e-5
karman,6,boy,0,6,1.6656811386596265e-5
kavan,6,boy,1,7,1.943294661769564e-5
kayhan,6,boy,0,6,1.6656811386596265e-5
kaylon,6,boy,0,6,1.6656811386596265e-5
kealan,6,boy,1,7,1.943294661769564e-5
kean,6,boy,0,6,1.6656811386596265e-5
keano,6,boy,0,6,1.6656811386596265e-5
kellen,6,boy,1,7,1.943294661769564e-5
kenton,6,boy,0,6,1.6656811386596265e-5
kie,6,boy,0,6,1.6656811386596265e-5
kirin,6,boy,0,6,1.6656811386596265e-5
kirubel,6,boy,0,6,1.6656811386596265e-5
kiyansh,6,boy,1,7,1.943294661769564e-5
klaidas,6,boy,0,6,1.6656811386596265e-5
koda,6,boy,2,8,2.2209081848795018e-5
kordian,6,boy,1,7,1.943294661769564e-5
korede,6,boy,1,7,1.943294661769564e-5
kristofers,6,boy,1,7,1.943294661769564e-5
kruz,6,boy,1,7,1.943294661769564e-5
kyrese,6,boy,0,6,1.6656811386596265e-5
kyri,6,boy,0,6,1.6656811386596265e-5
laiton,6,boy,1,7,1.943294661769564e-5
lamin,6,boy,0,6,1.6656811386596265e-5
layland,6,boy,0,6,1.6656811386596265e-5
lealand,6,boy,0,6,1.6656811386596265e-5
lemmy,6,boy,0,6,1.6656811386596265e-5
lester,6,boy,0,6,1.6656811386596265e-5
leto,6,boy,0,6,1.6656811386596265e-5
levi-james,6,boy,0,6,1.6656811386596265e-5
lindon,6,boy,0,6,1.6656811386596265e-5
llew,6,boy,0,6,1.6656811386596265e-5
locke,6,boy,1,7,1.943294661769564e-5
loukas,6,boy,0,6,1.6656811386596265e-5
lowan,6,boy,0,6,1.6656811386596265e-5
loxley,6,boy,0,6,1.6656811386596265e-5
luay,6,boy,0,6,1.6656811386596265e-5
lui,6,boy,0,6,1.6656811386596265e-5
lyon,6,boy,0,6,1.6656811386596265e-5
lysander,6,boy,0,6,1.6656811386596265e-5
maceo,6,boy,0,6,1.6656811386596265e-5
madhav,6,boy,0,6,1.6656811386596265e-5
mahamed,6,boy,0,6,1.6656811386596265e-5
matheo,6,boy,2,8,2.2209081848795018e-5
matin,6,boy,0,6,1.6656811386596265e-5
matisse,6,boy,0,6,1.6656811386596265e-5
maxence,6,boy,0,6,1.6656811386596265e-5
mehtab,6,boy,0,6,1.6656811386596265e-5
menashe,6,boy,0,6,1.6656811386596265e-5
mendy,6,boy,0,6,1.6656811386596265e-5
mian,6,boy,0,6,1.6656811386596265e-5
michael-james,6,boy,0,6,1.6656811386596265e-5
mika'il,6,boy,0,6,1.6656811386596265e-5
minh,6,boy,0,6,1.6656811386596265e-5
mohammod,6,boy,0,6,1.6656811386596265e-5
mohamud,6,boy,0,6,1.6656811386596265e-5
montana,6,boy,0,6,1.6656811386596265e-5
muad,6,boy,0,6,1.6656811386596265e-5
mubeen,6,boy,1,7,1.943294661769564e-5
muhammad-abdullah,6,boy,0,6,1.6656811386596265e-5
muhammad-musa,6,boy,0,6,1.6656811386596265e-5
mumin,6,boy,0,6,1.6656811386596265e-5
naftoli,6,boy,0,6,1.6656811386596265e-5
naman,6,boy,1,7,1.943294661769564e-5
nasser,6,boy,1,7,1.943294661769564e-5
natas,6,boy,0,6,1.6656811386596265e-5
naveen,6,boy,0,6,1.6656811386596265e-5
nedw,6,boy,0,6,1.6656811386596265e-5
nestor,6,boy,0,6,1.6656811386596265e-5
nevan,6,boy,0,6,1.6656811386596265e-5
niccolo,6,boy,0,6,1.6656811386596265e-5
niklaus,6,boy,1,7,1.943294661769564e-5
nirvan,6,boy,0,6,1.6656811386596265e-5
nivan,6,boy,0,6,1.6656811386596265e-5
nour,6,boy,0,6,1.6656811386596265e-5
nye,6,boy,1,7,1.943294661769564e-5
oakley-james,6,boy,0,6,1.6656811386596265e-5
octavian,6,boy,0,6,1.6656811386596265e-5
ojas,6,boy,1,7,1.943294661769564e-5
oliver-george,6,boy,0,6,1.6656811386596265e-5
oliver-john,6,boy,0,6,1.6656811386596265e-5
oluwaseyi,6,boy,1,7,1.943294661769564e-5
oluwatimilehin,6,boy,0,6,1.6656811386596265e-5
orestas,6,boy,0,6,1.6656811386596265e-5
osama,6,boy,1,7,1.943294661769564e-5
ovie,6,boy,0,6,1.6656811386596265e-5
param,6,boy,0,6,1.6656811386596265e-5
pavan,6,boy,0,6,1.6656811386596265e-5
peregrine,6,boy,0,6,1.6656811386596265e-5
perez,6,boy,0,6,1.6656811386596265e-5
perseus,6,boy,0,6,1.6656811386596265e-5
petr,6,boy,1,7,1.943294661769564e-5
philippos,6,boy,0,6,1.6656811386596265e-5
phineas,6,boy,0,6,1.6656811386596265e-5
pijus,6,boy,2,8,2.2209081848795018e-5
prabhjot,6,boy,0,6,1.6656811386596265e-5
preslav,6,boy,0,6,1.6656811386596265e-5
prish,6,boy,0,6,1.6656811386596265e-5
przemyslaw,6,boy,1,7,1.943294661769564e-5
quincy,6,boy,0,6,1.6656811386596265e-5
quintin,6,boy,0,6,1.6656811386596265e-5
radin,6,boy,0,6,1.6656811386596265e-5
radoslaw,6,boy,0,6,1.6656811386596265e-5
raffael,6,boy,0,6,1.6656811386596265e-5
rajab,6,boy,0,6,1.6656811386596265e-5
ramin,6,boy,0,6,1.6656811386596265e-5
ramon,6,boy,0,6,1.6656811386596265e-5
ramy,6,boy,1,7,1.943294661769564e-5
ranbir,6,boy,1,7,1.943294661769564e-5
raoul,6,boy,0,6,1.6656811386596265e-5
rasheed,6,boy,1,7,1.943294661769564e-5
ratu,6,boy,0,6,1.6656811386596265e-5
reda,6,boy,0,6,1.6656811386596265e-5
redd,6,boy,0,6,1.6656811386596265e-5
rees,6,boy,0,6,1.6656811386596265e-5
reggie-james,6,boy,0,6,1.6656811386596265e-5
reggie-ray,6,boy,1,7,1.943294661769564e-5
renell,6,boy,0,6,1.6656811386596265e-5
renley,6,boy,0,6,1.6656811386596265e-5
reuban,6,boy,0,6,1.6656811386596265e-5
revan,6,boy,0,6,1.6656811386596265e-5
reyaansh,6,boy,0,6,1.6656811386596265e-5
rhyley,6,boy,1,7,1.943294661769564e-5
ridhwan,6,boy,0,6,1.6656811386596265e-5
riley-ray,6,boy,0,6,1.6656811386596265e-5
ripley,6,boy,0,6,1.6656811386596265e-5
romano,6,boy,0,6,1.6656811386596265e-5
romey,6,boy,0,6,1.6656811386596265e-5
ronak,6,boy,0,6,1.6656811386596265e-5
ronav,6,boy,0,6,1.6656811386596265e-5
ronnie-james,6,boy,0,6,1.6656811386596265e-5
ruban,6,boy,0,6,1.6656811386596265e-5
rumi,6,boy,1,7,1.943294661769564e-5
saarim,6,boy,0,6,1.6656811386596265e-5
sabeel,6,boy,0,6,1.6656811386596265e-5
sakariya,6,boy,0,6,1.6656811386596265e-5
salem,6,boy,0,6,1.6656811386596265e-5
sali,6,boy,0,6,1.6656811386596265e-5
salmaan,6,boy,0,6,1.6656811386596265e-5
samiullah,6,boy,1,7,1.943294661769564e-5
santi,6,boy,0,6,1.6656811386596265e-5
sehaj,6,boy,0,6,1.6656811386596265e-5
sennen,6,boy,0,6,1.6656811386596265e-5
serafim,6,boy,0,6,1.6656811386596265e-5
shahid,6,boy,0,6,1.6656811386596265e-5
shahzain,6,boy,0,6,1.6656811386596265e-5
shaya,6,boy,0,6,1.6656811386596265e-5
shayne,6,boy,1,7,1.943294661769564e-5
shazil,6,boy,1,7,1.943294661769564e-5
siddhant,6,boy,0,6,1.6656811386596265e-5
simonas,6,boy,0,6,1.6656811386596265e-5
sonny-lee,6,boy,0,6,1.6656811386596265e-5
sri,6,boy,0,6,1.6656811386596265e-5
stanislav,6,boy,1,7,1.943294661769564e-5
suhaib,6,boy,0,6,1.6656811386596265e-5
suraj,6,boy,0,6,1.6656811386596265e-5
surya,6,boy,0,6,1.6656811386596265e-5
swaley,6,boy,0,6,1.6656811386596265e-5
syon,6,boy,0,6,1.6656811386596265e-5
tadas,6,boy,0,6,1.6656811386596265e-5
talal,6,boy,0,6,1.6656811386596265e-5
talon,6,boy,0,6,1.6656811386596265e-5
tarek,6,boy,1,7,1.943294661769564e-5
tatum,6,boy,0,6,1.6656811386596265e-5
tawheed,6,boy,0,6,1.6656811386596265e-5
tawhid,6,boy,0,6,1.6656811386596265e-5
taylon,6,boy,0,6,1.6656811386596265e-5
taylor-james,6,boy,0,6,1.6656811386596265e-5
teddy-lee,6,boy,0,6,1.6656811386596265e-5
teilo,6,boy,0,6,1.6656811386596265e-5
tejas,6,boy,0,6,1.6656811386596265e-5
tremaine,6,boy,0,6,1.6656811386596265e-5
trevor,6,boy,1,7,1.943294661769564e-5
triston,6,boy,0,6,1.6656811386596265e-5
uchenna,6,boy,0,6,1.6656811386596265e-5
viren,6,boy,0,6,1.6656811386596265e-5
vittorio,6,boy,0,6,1.6656811386596265e-5
walid,6,boy,0,6,1.6656811386596265e-5
wasim,6,boy,0,6,1.6656811386596265e-5
willow,6,boy,2,8,2.2209081848795018e-5
wisdom,6,boy,0,6,1.6656811386596265e-5
wojtek,6,boy,0,6,1.6656811386596265e-5
wolfe,6,boy,1,7,1.943294661769564e-5
xavi,6,boy,0,6,1.6656811386596265e-5
yahia,6,boy,0,6,1.6656811386596265e-5
yahiya,6,boy,0,6,1.6656811386596265e-5
yannick,6,boy,0,6,1.6656811386596265e-5
yohann,6,boy,0,6,1.6656811386596265e-5
yug,6,boy,0,6,1.6656811386596265e-5
yusaf,6,boy,0,6,1.6656811386596265e-5
yusif,6,boy,1,7,1.943294661769564e-5
zachariya,6,boy,0,6,1.6656811386596265e-5
zaheer,6,boy,0,6,1.6656811386596265e-5
zakariyyah,6,boy,0,6,1.6656811386596265e-5
zalan,6,boy,1,7,1.943294661769564e-5
zarif,6,boy,0,6,1.6656811386596265e-5
zaydaan,6,boy,1,7,1.943294661769564e-5
zenon,6,boy,0,6,1.6656811386596265e-5
zian,6,boy,0,6,1.6656811386596265e-5
zico,6,boy,1,7,1.943294661769564e-5
zohair,6,boy,0,6,1.6656811386596265e-5
zsombor,6,boy,0,6,1.6656811386596265e-5
zyon,6,boy,0,6,1.6656811386596265e-5
aarron,5,boy,1,6,1.6656811386596265e-5
aathiran,5,boy,0,5,1.3880676155496887e-5
abdillahi,5,boy,0,5,1.3880676155496887e-5
abdul-basit,5,boy,0,5,1.3880676155496887e-5
abdul-rehman,5,boy,0,5,1.3880676155496887e-5
abdulhakim,5,boy,0,5,1.3880676155496887e-5
abdulkadir,5,boy,0,5,1.3880676155496887e-5
abhijot,5,boy,0,5,1.3880676155496887e-5
abhimanyu,5,boy,0,5,1.3880676155496887e-5
abiel,5,boy,0,5,1.3880676155496887e-5
abubaker,5,boy,0,5,1.3880676155496887e-5
adair,5,boy,1,6,1.6656811386596265e-5
adam-junior,5,boy,0,5,1.3880676155496887e-5
adarsh,5,boy,0,5,1.3880676155496887e-5
adas,5,boy,2,7,1.943294661769564e-5
adison,5,boy,3,8,2.2209081848795018e-5
advaith,5,boy,0,5,1.3880676155496887e-5
adyaan,5,boy,0,5,1.3880676155496887e-5
ahyaan,5,boy,1,6,1.6656811386596265e-5
aizen,5,boy,0,5,1.3880676155496887e-5
ajani,5,boy,0,5,1.3880676155496887e-5
akaran,5,boy,0,5,1.3880676155496887e-5
akeel,5,boy,0,5,1.3880676155496887e-5
akorede,5,boy,0,5,1.3880676155496887e-5
akos,5,boy,0,5,1.3880676155496887e-5
albey,5,boy,0,5,1.3880676155496887e-5
aleksey,5,boy,0,5,1.3880676155496887e-5
alfie-thomas,5,boy,0,5,1.3880676155496887e-5
alhaji,5,boy,1,6,1.6656811386596265e-5
alim,5,boy,0,5,1.3880676155496887e-5
allister,5,boy,0,5,1.3880676155496887e-5
alper,5,boy,0,5,1.3880676155496887e-5
amadeo,5,boy,0,5,1.3880676155496887e-5
amarion,5,boy,0,5,1.3880676155496887e-5
ander,5,boy,2,7,1.943294661769564e-5
andrew-james,5,boy,2,7,1.943294661769564e-5
anes,5,boy,1,6,1.6656811386596265e-5
anh,5,boy,0,5,1.3880676155496887e-5
anik,5,boy,0,5,1.3880676155496887e-5
anuar,5,boy,0,5,1.3880676155496887e-5
anzar,5,boy,0,5,1.3880676155496887e-5
aous,5,boy,0,5,1.3880676155496887e-5
arash,5,boy,0,5,1.3880676155496887e-5
archie-george,5,boy,0,5,1.3880676155496887e-5
arel,5,boy,0,5,1.3880676155496887e-5
arie,5,boy,0,5,1.3880676155496887e-5
ariyaan,5,boy,0,5,1.3880676155496887e-5
arjen,5,boy,0,5,1.3880676155496887e-5
arto,5,boy,0,5,1.3880676155496887e-5
arty,5,boy,0,5,1.3880676155496887e-5
aryav,5,boy,0,5,1.3880676155496887e-5
asadullah,5,boy,0,5,1.3880676155496887e-5
aser,5,boy,0,5,1.3880676155496887e-5
ashdon,5,boy,0,5,1.3880676155496887e-5
ashraf,5,boy,0,5,1.3880676155496887e-5
astin,5,boy,1,6,1.6656811386596265e-5
aston-james,5,boy,0,5,1.3880676155496887e-5
atreyu,5,boy,0,5,1.3880676155496887e-5
avir,5,boy,0,5,1.3880676155496887e-5
avraham,5,boy,0,5,1.3880676155496887e-5
aws,5,boy,0,5,1.3880676155496887e-5
ayaaz,5,boy,0,5,1.3880676155496887e-5
ayo,5,boy,0,5,1.3880676155496887e-5
ayuub,5,boy,0,5,1.3880676155496887e-5
azai,5,boy,0,5,1.3880676155496887e-5
azhaan,5,boy,0,5,1.3880676155496887e-5
badr,5,boy,0,5,1.3880676155496887e-5
bakary,5,boy,0,5,1.3880676155496887e-5
bale,5,boy,0,5,1.3880676155496887e-5
bashir,5,boy,1,6,1.6656811386596265e-5
basit,5,boy,0,5,1.3880676155496887e-5
bawan,5,boy,0,5,1.3880676155496887e-5
baylee,5,boy,0,5,1.3880676155496887e-5
beaumont,5,boy,0,5,1.3880676155496887e-5
beaux,5,boy,0,5,1.3880676155496887e-5
beni,5,boy,1,6,1.6656811386596265e-5
benn,5,boy,0,5,1.3880676155496887e-5
berkay,5,boy,1,6,1.6656811386596265e-5
blaize,5,boy,0,5,1.3880676155496887e-5
blazej,5,boy,0,5,1.3880676155496887e-5
bob,5,boy,0,5,1.3880676155496887e-5
braidy,5,boy,0,5,1.3880676155496887e-5
brodey,5,boy,0,5,1.3880676155496887e-5
burhaan,5,boy,0,5,1.3880676155496887e-5
c,5,boy,0,5,1.3880676155496887e-5
caison,5,boy,0,5,1.3880676155496887e-5
cal,5,boy,4,9,2.4985217079894396e-5
cale,5,boy,0,5,1.3880676155496887e-5
caleb-james,5,boy,0,5,1.3880676155496887e-5
camron,5,boy,0,5,1.3880676155496887e-5
carsen,5,boy,3,8,2.2209081848795018e-5
casen,5,boy,0,5,1.3880676155496887e-5
cassidy,5,boy,0,5,1.3880676155496887e-5
cem,5,boy,0,5,1.3880676155496887e-5
chaice,5,boy,0,5,1.3880676155496887e-5
chanse,5,boy,0,5,1.3880676155496887e-5
cheikh,5,boy,1,6,1.6656811386596265e-5
chimdindu,5,boy,0,5,1.3880676155496887e-5
chisom,5,boy,0,5,1.3880676155496887e-5
christiano,5,boy,0,5,1.3880676155496887e-5
chuka,5,boy,0,5,1.3880676155496887e-5
chukwuebuka,5,boy,0,5,1.3880676155496887e-5
cobain,5,boy,0,5,1.3880676155496887e-5
coby-lee,5,boy,1,6,1.6656811386596265e-5
collin,5,boy,1,6,1.6656811386596265e-5
coran,5,boy,0,5,1.3880676155496887e-5
cyprian,5,boy,1,6,1.6656811386596265e-5
d'andre,5,boy,0,5,1.3880676155496887e-5
dagmawi,5,boy,0,5,1.3880676155496887e-5
dani,5,boy,0,5,1.3880676155496887e-5
daniel-junior,5,boy,0,5,1.3880676155496887e-5
danilo,5,boy,0,5,1.3880676155496887e-5
dariush,5,boy,0,5,1.3880676155496887e-5
darrell,5,boy,1,6,1.6656811386596265e-5
daryan,5,boy,0,5,1.3880676155496887e-5
david-james,5,boy,1,6,1.6656811386596265e-5
davy,5,boy,0,5,1.3880676155496887e-5
deano,5,boy,0,5,1.3880676155496887e-5
deegan,5,boy,0,5,1.3880676155496887e-5
deividas,5,boy,1,6,1.6656811386596265e-5
demitri,5,boy,0,5,1.3880676155496887e-5
denley,5,boy,0,5,1.3880676155496887e-5
denton,5,boy,0,5,1.3880676155496887e-5
denys,5,boy,0,5,1.3880676155496887e-5
denzil,5,boy,0,5,1.3880676155496887e-5
destin,5,boy,1,6,1.6656811386596265e-5
devontae,5,boy,0,5,1.3880676155496887e-5
devraj,5,boy,0,5,1.3880676155496887e-5
dex,5,boy,0,5,1.3880676155496887e-5
dhyey,5,boy,0,5,1.3880676155496887e-5
diesel,5,boy,0,5,1.3880676155496887e-5
dilraaj,5,boy,0,5,1.3880676155496887e-5
diogo,5,boy,1,6,1.6656811386596265e-5
divit,5,boy,1,6,1.6656811386596265e-5
dmitry,5,boy,0,5,1.3880676155496887e-5
draven,5,boy,0,5,1.3880676155496887e-5
dru,5,boy,0,5,1.3880676155496887e-5
dustin,5,boy,2,7,1.943294661769564e-5
eamonn,5,boy,2,7,1.943294661769564e-5
eimantas,5,boy,0,5,1.3880676155496887e-5
einar,5,boy,0,5,1.3880676155496887e-5
eliasz,5,boy,1,6,1.6656811386596265e-5
elion,5,boy,0,5,1.3880676155496887e-5
eljay,5,boy,0,5,1.3880676155496887e-5
elson,5,boy,0,5,1.3880676155496887e-5
emmerson,5,boy,0,5,1.3880676155496887e-5
eniola,5,boy,0,5,1.3880676155496887e-5
eron,5,boy,0,5,1.3880676155496887e-5
esmail,5,boy,0,5,1.3880676155496887e-5
espen,5,boy,1,6,1.6656811386596265e-5
ethan-lee,5,boy,0,5,1.3880676155496887e-5
ettore,5,boy,0,5,1.3880676155496887e-5
evin,5,boy,0,5,1.3880676155496887e-5
ezaan,5,boy,1,6,1.6656811386596265e-5
ezana,5,boy,0,5,1.3880676155496887e-5
ezequiel,5,boy,0,5,1.3880676155496887e-5
faaiz,5,boy,1,6,1.6656811386596265e-5
faheem,5,boy,0,5,1.3880676155496887e-5
farai,5,boy,0,5,1.3880676155496887e-5
faran,5,boy,0,5,1.3880676155496887e-5
fawzan,5,boy,0,5,1.3880676155496887e-5
ferguson,5,boy,0,5,1.3880676155496887e-5
finbarr,5,boy,0,5,1.3880676155496887e-5
fineas,5,boy,0,5,1.3880676155496887e-5
firas,5,boy,0,5,1.3880676155496887e-5
folarin,5,boy,0,5,1.3880676155496887e-5
fouad,5,boy,0,5,1.3880676155496887e-5
frantisek,5,boy,0,5,1.3880676155496887e-5
freddi,5,boy,0,5,1.3880676155496887e-5
freddie-john,5,boy,0,5,1.3880676155496887e-5
frey,5,boy,1,6,1.6656811386596265e-5
gage,5,boy,1,6,1.6656811386596265e-5
gaston,5,boy,0,5,1.3880676155496887e-5
georges,5,boy,0,5,1.3880676155496887e-5
gerrard,5,boy,1,6,1.6656811386596265e-5
ghassan,5,boy,0,5,1.3880676155496887e-5
gio,5,boy,0,5,1.3880676155496887e-5
giulio,5,boy,0,5,1.3880676155496887e-5
gonzalo,5,boy,1,6,1.6656811386596265e-5
great,5,boy,0,5,1.3880676155496887e-5
gulliver,5,boy,0,5,1.3880676155496887e-5
gurjot,5,boy,0,5,1.3880676155496887e-5
gustav,5,boy,0,5,1.3880676155496887e-5
gustaw,5,boy,2,7,1.943294661769564e-5
haden,5,boy,0,5,1.3880676155496887e-5
hakim,5,boy,0,5,1.3880676155496887e-5
haleem,5,boy,0,5,1.3880676155496887e-5
hamdaan,5,boy,0,5,1.3880676155496887e-5
hammaad,5,boy,0,5,1.3880676155496887e-5
hanif,5,boy,0,5,1.3880676155496887e-5
hank,5,boy,0,5,1.3880676155496887e-5
hans,5,boy,0,5,1.3880676155496887e-5
harleigh,5,boy,0,5,1.3880676155496887e-5
harry-george,5,boy,0,5,1.3880676155496887e-5
harry-joe,5,boy,0,5,1.3880676155496887e-5
harshiv,5,boy,0,5,1.3880676155496887e-5
haru,5,boy,0,5,1.3880676155496887e-5
harvi,5,boy,1,6,1.6656811386596265e-5
hayaan,5,boy,0,5,1.3880676155496887e-5
hayder,5,boy,0,5,1.3880676155496887e-5
heera,5,boy,1,6,1.6656811386596265e-5
hendricks,5,boy,0,5,1.3880676155496887e-5
henson,5,boy,0,5,1.3880676155496887e-5
hershel,5,boy,0,5,1.3880676155496887e-5
hollis,5,boy,0,5,1.3880676155496887e-5
hunor,5,boy,1,6,1.6656811386596265e-5
hussnain,5,boy,0,5,1.3880676155496887e-5
ifeoluwa,5,boy,1,6,1.6656811386596265e-5
ilie,5,boy,0,5,1.3880676155496887e-5
ilyes,5,boy,0,5,1.3880676155496887e-5
imam,5,boy,1,6,1.6656811386596265e-5
iman,5,boy,0,5,1.3880676155496887e-5
imari,5,boy,0,5,1.3880676155496887e-5
indra,5,boy,0,5,1.3880676155496887e-5
innes,5,boy,63,68,1.8877719571475766e-4
irfaan,5,boy,0,5,1.3880676155496887e-5
isaam,5,boy,0,5,1.3880676155496887e-5
isaia,5,boy,0,5,1.3880676155496887e-5
isak,5,boy,0,5,1.3880676155496887e-5
ishar,5,boy,1,6,1.6656811386596265e-5
isher,5,boy,0,5,1.3880676155496887e-5
ishmeet,5,boy,0,5,1.3880676155496887e-5
issam,5,boy,0,5,1.3880676155496887e-5
izac,5,boy,0,5,1.3880676155496887e-5
jabari,5,boy,0,5,1.3880676155496887e-5
jae,5,boy,1,6,1.6656811386596265e-5
jaffar,5,boy,0,5,1.3880676155496887e-5
jahmari,5,boy,0,5,1.3880676155496887e-5
jahvari,5,boy,0,5,1.3880676155496887e-5
janis,5,boy,0,5,1.3880676155496887e-5
jarnail,5,boy,0,5,1.3880676155496887e-5
jaron,5,boy,0,5,1.3880676155496887e-5
jashan,5,boy,0,5,1.3880676155496887e-5
jaskirat,5,boy,0,5,1.3880676155496887e-5
jay-junior,5,boy,0,5,1.3880676155496887e-5
jaydeep,5,boy,0,5,1.3880676155496887e-5
jaymes,5,boy,1,6,1.6656811386596265e-5
jazz,5,boy,0,5,1.3880676155496887e-5
jeffery,5,boy,0,5,1.3880676155496887e-5
jens,5,boy,1,6,1.6656811386596265e-5
jenson-lee,5,boy,0,5,1.3880676155496887e-5
jeorge,5,boy,0,5,1.3880676155496887e-5
jermain,5,boy,0,5,1.3880676155496887e-5
jevin,5,boy,0,5,1.3880676155496887e-5
jia,5,boy,1,6,1.6656811386596265e-5
jidenna,5,boy,0,5,1.3880676155496887e-5
jimmy-lee,5,boy,0,5,1.3880676155496887e-5
jiyaan,5,boy,0,5,1.3880676155496887e-5
joaquin,5,boy,0,5,1.3880676155496887e-5
joash,5,boy,0,5,1.3880676155496887e-5
joey-lee,5,boy,0,5,1.3880676155496887e-5
jonatan,5,boy,0,5,1.3880676155496887e-5
jorden,5,boy,1,6,1.6656811386596265e-5
joziah,5,boy,0,5,1.3880676155496887e-5
julio,5,boy,1,6,1.6656811386596265e-5
justice,5,boy,0,5,1.3880676155496887e-5
kabeer,5,boy,0,5,1.3880676155496887e-5
kaci,5,boy,0,5,1.3880676155496887e-5
kael,5,boy,4,9,2.4985217079894396e-5
kaelen,5,boy,0,5,1.3880676155496887e-5
kaeson,5,boy,1,6,1.6656811386596265e-5
kai-james,5,boy,0,5,1.3880676155496887e-5
kaiden-james,5,boy,0,5,1.3880676155496887e-5
kais,5,boy,0,5,1.3880676155496887e-5
kal,5,boy,4,9,2.4985217079894396e-5
kamden,5,boy,0,5,1.3880676155496887e-5
karamveer,5,boy,0,5,1.3880676155496887e-5
kashif,5,boy,0,5,1.3880676155496887e-5
kaydn,5,boy,0,5,1.3880676155496887e-5
kayin,5,boy,0,5,1.3880676155496887e-5
kayon,5,boy,0,5,1.3880676155496887e-5
keean,5,boy,1,6,1.6656811386596265e-5
keeran,5,boy,1,6,1.6656811386596265e-5
kehinde,5,boy,0,5,1.3880676155496887e-5
kei,5,boy,0,5,1.3880676155496887e-5
kelechi,5,boy,0,5,1.3880676155496887e-5
kelson,5,boy,0,5,1.3880676155496887e-5
kemar,5,boy,0,5,1.3880676155496887e-5
kemuel,5,boy,0,5,1.3880676155496887e-5
kester,5,boy,0,5,1.3880676155496887e-5
khizr,5,boy,1,6,1.6656811386596265e-5
kian-james,5,boy,1,6,1.6656811386596265e-5
kiean,5,boy,1,6,1.6656811386596265e-5
kiefer,5,boy,0,5,1.3880676155496887e-5
kien,5,boy,0,5,1.3880676155496887e-5
kieren,5,boy,2,7,1.943294661769564e-5
kiril,5,boy,0,5,1.3880676155496887e-5
klevis,5,boy,0,5,1.3880676155496887e-5
kodey,5,boy,0,5,1.3880676155496887e-5
korban,5,boy,0,5,1.3880676155496887e-5
kovan,5,boy,0,5,1.3880676155496887e-5
kristiyan,5,boy,0,5,1.3880676155496887e-5
kristopher,5,boy,1,6,1.6656811386596265e-5
ky-mani,5,boy,0,5,1.3880676155496887e-5
kyrell,5,boy,0,5,1.3880676155496887e-5
kyriacos,5,boy,0,5,1.3880676155496887e-5
kyriakos,5,boy,0,5,1.3880676155496887e-5
l,5,boy,0,5,1.3880676155496887e-5
lassana,5,boy,0,5,1.3880676155496887e-5
lauchlan,5,boy,28,33,9.161246262627945e-5
layton-james,5,boy,1,6,1.6656811386596265e-5
leandros,5,boy,0,5,1.3880676155496887e-5
ledion,5,boy,0,5,1.3880676155496887e-5
leejay,5,boy,0,5,1.3880676155496887e-5
leeroy,5,boy,0,5,1.3880676155496887e-5
leigh,5,boy,1,6,1.6656811386596265e-5
lennard,5,boy,0,5,1.3880676155496887e-5
leon-james,5,boy,1,6,1.6656811386596265e-5
lewy,5,boy,0,5,1.3880676155496887e-5
lincon,5,boy,2,7,1.943294661769564e-5
linton,5,boy,0,5,1.3880676155496887e-5
llion,5,boy,0,5,1.3880676155496887e-5
lochie,5,boy,7,12,3.331362277319253e-5
loghan,5,boy,0,5,1.3880676155496887e-5
lord,5,boy,0,5,1.3880676155496887e-5
loughlin,5,boy,2,7,1.943294661769564e-5
lucus,5,boy,1,6,1.6656811386596265e-5
ludovic,5,boy,0,5,1.3880676155496887e-5
luigi,5,boy,0,5,1.3880676155496887e-5
macs,5,boy,0,5,1.3880676155496887e-5
madog,5,boy,0,5,1.3880676155496887e-5
mael,5,boy,0,5,1.3880676155496887e-5
majed,5,boy,1,6,1.6656811386596265e-5
makan,5,boy,0,5,1.3880676155496887e-5
maliq,5,boy,0,5,1.3880676155496887e-5
marcello,5,boy,0,5,1.3880676155496887e-5
marcellus,5,boy,0,5,1.3880676155496887e-5
mark-junior,5,boy,0,5,1.3880676155496887e-5
marks,5,boy,0,5,1.3880676155496887e-5
mason-riley,5,boy,0,5,1.3880676155496887e-5
masroor,5,boy,0,5,1.3880676155496887e-5
mate,5,boy,1,6,1.6656811386596265e-5
mathieu,5,boy,0,5,1.3880676155496887e-5
maxen,5,boy,0,5,1.3880676155496887e-5
maximilien,5,boy,0,5,1.3880676155496887e-5
maxmilian,5,boy,0,5,1.3880676155496887e-5
mayer,5,boy,0,5,1.3880676155496887e-5
mckenzie-lee,5,boy,0,5,1.3880676155496887e-5
messi,5,boy,0,5,1.3880676155496887e-5
messiah,5,boy,0,5,1.3880676155496887e-5
metin,5,boy,0,5,1.3880676155496887e-5
mihails,5,boy,0,5,1.3880676155496887e-5
mikhaeel,5,boy,0,5,1.3880676155496887e-5
mikyle,5,boy,0,5,1.3880676155496887e-5
milton,5,boy,0,5,1.3880676155496887e-5
misha,5,boy,0,5,1.3880676155496887e-5
modou,5,boy,0,5,1.3880676155496887e-5
mohan,5,boy,0,5,1.3880676155496887e-5
moises,5,boy,0,5,1.3880676155496887e-5
moishy,5,boy,0,5,1.3880676155496887e-5
mortimer,5,boy,0,5,1.3880676155496887e-5
moss,5,boy,0,5,1.3880676155496887e-5
motty,5,boy,0,5,1.3880676155496887e-5
mounir,5,boy,0,5,1.3880676155496887e-5
muaaz,5,boy,1,6,1.6656811386596265e-5
mubashir,5,boy,0,5,1.3880676155496887e-5
mujeeb,5,boy,0,5,1.3880676155496887e-5
munro,5,boy,5,10,2.7761352310993775e-5
musawwir,5,boy,0,5,1.3880676155496887e-5
myan,5,boy,0,5,1.3880676155496887e-5
nabhan,5,boy,0,5,1.3880676155496887e-5
najib,5,boy,0,5,1.3880676155496887e-5
naly,5,boy,0,5,1.3880676155496887e-5
nandor,5,boy,0,5,1.3880676155496887e-5
naod,5,boy,0,5,1.3880676155496887e-5
nathanial,5,boy,0,5,1.3880676155496887e-5
nectarie,5,boy,0,5,1.3880676155496887e-5
nedas,5,boy,0,5,1.3880676155496887e-5
newton,5,boy,0,5,1.3880676155496887e-5
nicodem,5,boy,0,5,1.3880676155496887e-5
nilay,5,boy,0,5,1.3880676155496887e-5
nirvaan,5,boy,0,5,1.3880676155496887e-5
nishan,5,boy,1,6,1.6656811386596265e-5
nithin,5,boy,0,5,1.3880676155496887e-5
noman,5,boy,0,5,1.3880676155496887e-5
nuraiz,5,boy,0,5,1.3880676155496887e-5
nyal,5,boy,0,5,1.3880676155496887e-5
oakley-jay,5,boy,0,5,1.3880676155496887e-5
olalekan,5,boy,0,5,1.3880676155496887e-5
oliveris,5,boy,0,5,1.3880676155496887e-5
oliwer,5,boy,0,5,1.3880676155496887e-5
olliver,5,boy,1,6,1.6656811386596265e-5
oluwapelumi,5,boy,0,5,1.3880676155496887e-5
onkar,5,boy,0,5,1.3880676155496887e-5
onur,5,boy,0,5,1.3880676155496887e-5
orestis,5,boy,2,7,1.943294661769564e-5
orlan,5,boy,0,5,1.3880676155496887e-5
oscar-lee,5,boy,0,5,1.3880676155496887e-5
osher,5,boy,0,5,1.3880676155496887e-5
osinachi,5,boy,0,5,1.3880676155496887e-5
ostyn,5,boy,0,5,1.3880676155496887e-5
oumar,5,boy,1,6,1.6656811386596265e-5
ousmane,5,boy,0,5,1.3880676155496887e-5
pa,5,boy,0,5,1.3880676155496887e-5
paarth,5,boy,0,5,1.3880676155496887e-5
paisley,5,boy,0,5,1.3880676155496887e-5
peniel,5,boy,0,5,1.3880676155496887e-5
peter-junior,5,boy,0,5,1.3880676155496887e-5
philippe,5,boy,0,5,1.3880676155496887e-5
pranish,5,boy,0,5,1.3880676155496887e-5
pratik,5,boy,0,5,1.3880676155496887e-5
qazi,5,boy,0,5,1.3880676155496887e-5
radvin,5,boy,0,5,1.3880676155496887e-5
radwan,5,boy,0,5,1.3880676155496887e-5
raegan,5,boy,1,6,1.6656811386596265e-5
raf,5,boy,0,5,1.3880676155496887e-5
rafa,5,boy,1,6,1.6656811386596265e-5
rahat,5,boy,0,5,1.3880676155496887e-5
raith,5,boy,0,5,1.3880676155496887e-5
raj,5,boy,0,5,1.3880676155496887e-5
ralfs,5,boy,0,5,1.3880676155496887e-5
raylan,5,boy,0,5,1.3880676155496887e-5
rayn,5,boy,0,5,1.3880676155496887e-5
razaan,5,boy,1,6,1.6656811386596265e-5
reeyan,5,boy,0,5,1.3880676155496887e-5
reggie-rae,5,boy,0,5,1.3880676155496887e-5
rehman,5,boy,0,5,1.3880676155496887e-5
renato,5,boy,0,5,1.3880676155496887e-5
renly,5,boy,0,5,1.3880676155496887e-5
renny,5,boy,0,5,1.3880676155496887e-5
renz,5,boy,0,5,1.3880676155496887e-5
rheo,5,boy,0,5,1.3880676155496887e-5
ricards,5,boy,0,5,1.3880676155496887e-5
ricco,5,boy,1,6,1.6656811386596265e-5
rikhil,5,boy,0,5,1.3880676155496887e-5
riley-lee,5,boy,0,5,1.3880676155496887e-5
rishon,5,boy,0,5,1.3880676155496887e-5
riven,5,boy,0,5,1.3880676155496887e-5
riyansh,5,boy,0,5,1.3880676155496887e-5
rocko,5,boy,0,5,1.3880676155496887e-5
roel,5,boy,0,5,1.3880676155496887e-5
romel,5,boy,0,5,1.3880676155496887e-5
romelle,5,boy,0,5,1.3880676155496887e-5
ronel,5,boy,0,5,1.3880676155496887e-5
rori,5,boy,0,5,1.3880676155496887e-5
rossco,5,boy,0,5,1.3880676155496887e-5
ruairidh,5,boy,46,51,1.4158289678606824e-4
rudyard,5,boy,0,5,1.3880676155496887e-5
rue,5,boy,0,5,1.3880676155496887e-5
ryan-james,5,boy,0,5,1.3880676155496887e-5
ryan-junior,5,boy,1,6,1.6656811386596265e-5
ryo,5,boy,1,6,1.6656811386596265e-5
saaim,5,boy,0,5,1.3880676155496887e-5
saalih,5,boy,0,5,1.3880676155496887e-5
sabin,5,boy,2,7,1.943294661769564e-5
sabir,5,boy,0,5,1.3880676155496887e-5
sadiq,5,boy,0,5,1.3880676155496887e-5
safi,5,boy,1,6,1.6656811386596265e-5
sahas,5,boy,1,6,1.6656811386596265e-5
saheim,5,boy,0,5,1.3880676155496887e-5
saint,5,boy,2,7,1.943294661769564e-5
sajan,5,boy,0,5,1.3880676155496887e-5
sajid,5,boy,1,6,1.6656811386596265e-5
salaar,5,boy,0,5,1.3880676155496887e-5
sanad,5,boy,0,5,1.3880676155496887e-5
sayan,5,boy,0,5,1.3880676155496887e-5
semih,5,boy,0,5,1.3880676155496887e-5
senay,5,boy,0,5,1.3880676155496887e-5
severiano,5,boy,0,5,1.3880676155496887e-5
seweryn,5,boy,1,6,1.6656811386596265e-5
shad,5,boy,1,6,1.6656811386596265e-5
shahmeer,5,boy,0,5,1.3880676155496887e-5
shakil,5,boy,0,5,1.3880676155496887e-5
shakur,5,boy,0,5,1.3880676155496887e-5
shamar,5,boy,0,5,1.3880676155496887e-5
sharif,5,boy,0,5,1.3880676155496887e-5
shayon,5,boy,0,5,1.3880676155496887e-5
shehryar,5,boy,0,5,1.3880676155496887e-5
shloimy,5,boy,0,5,1.3880676155496887e-5
shmiel,5,boy,0,5,1.3880676155496887e-5
shray,5,boy,0,5,1.3880676155496887e-5
shreyas,5,boy,0,5,1.3880676155496887e-5
shuaib,5,boy,0,5,1.3880676155496887e-5
shulem,5,boy,0,5,1.3880676155496887e-5
simao,5,boy,0,5,1.3880676155496887e-5
skylar,5,boy,0,5,1.3880676155496887e-5
smith,5,boy,1,6,1.6656811386596265e-5
soloman,5,boy,0,5,1.3880676155496887e-5
sorin,5,boy,0,5,1.3880676155496887e-5
stanley-james,5,boy,0,5,1.3880676155496887e-5
suhail,5,boy,0,5,1.3880676155496887e-5
sully,5,boy,0,5,1.3880676155496887e-5
taheem,5,boy,0,5,1.3880676155496887e-5
tahsin,5,boy,0,5,1.3880676155496887e-5
taite,5,boy,0,5,1.3880676155496887e-5
taksh,5,boy,0,5,1.3880676155496887e-5
takudzwa,5,boy,0,5,1.3880676155496887e-5
talhah,5,boy,0,5,1.3880676155496887e-5
tanay,5,boy,0,5,1.3880676155496887e-5
tanish,5,boy,2,7,1.943294661769564e-5
tanner,5,boy,0,5,1.3880676155496887e-5
tanush,5,boy,0,5,1.3880676155496887e-5
taranveer,5,boy,0,5,1.3880676155496887e-5
taye,5,boy,0,5,1.3880676155496887e-5
tayon,5,boy,0,5,1.3880676155496887e-5
temitayo,5,boy,1,6,1.6656811386596265e-5
tennyson,5,boy,1,6,1.6656811386596265e-5
teodoro,5,boy,0,5,1.3880676155496887e-5
terrance,5,boy,0,5,1.3880676155496887e-5
theeran,5,boy,0,5,1.3880676155496887e-5
titan,5,boy,0,5,1.3880676155496887e-5
tobiloba,5,boy,0,5,1.3880676155496887e-5
toma,5,boy,0,5,1.3880676155496887e-5
tomass,5,boy,1,6,1.6656811386596265e-5
tory,5,boy,0,5,1.3880676155496887e-5
treyvon,5,boy,0,5,1.3880676155496887e-5
tristen,5,boy,0,5,1.3880676155496887e-5
tucker,5,boy,1,6,1.6656811386596265e-5
tyree,5,boy,0,5,1.3880676155496887e-5
tyrelle,5,boy,0,5,1.3880676155496887e-5
ubaydah,5,boy,0,5,1.3880676155496887e-5
ubaydullah,5,boy,0,5,1.3880676155496887e-5
uday,5,boy,0,5,1.3880676155496887e-5
ulysse,5,boy,0,5,1.3880676155496887e-5
umayr,5,boy,0,5,1.3880676155496887e-5
vasil,5,boy,0,5,1.3880676155496887e-5
vasileios,5,boy,0,5,1.3880676155496887e-5
vishnu,5,boy,0,5,1.3880676155496887e-5
vito,5,boy,0,5,1.3880676155496887e-5
vitor,5,boy,0,5,1.3880676155496887e-5
vivan,5,boy,1,6,1.6656811386596265e-5
vivek,5,boy,0,5,1.3880676155496887e-5
warwick,5,boy,0,5,1.3880676155496887e-5
wen,5,boy,0,5,1.3880676155496887e-5
witold,5,boy,2,7,1.943294661769564e-5
wynter,5,boy,0,5,1.3880676155496887e-5
yacob,5,boy,0,5,1.3880676155496887e-5
yago,5,boy,0,5,1.3880676155496887e-5
yahyaa,5,boy,0,5,1.3880676155496887e-5
yakup,5,boy,0,5,1.3880676155496887e-5
yan,5,boy,1,6,1.6656811386596265e-5
yassine,5,boy,0,5,1.3880676155496887e-5
yassir,5,boy,0,5,1.3880676155496887e-5
yossi,5,boy,0,5,1.3880676155496887e-5
yotam,5,boy,0,5,1.3880676155496887e-5
yuchen,5,boy,0,5,1.3880676155496887e-5
zain-ul-abideen,5,boy,0,5,1.3880676155496887e-5
zaky,5,boy,0,5,1.3880676155496887e-5
zaman,5,boy,0,5,1.3880676155496887e-5
zariyan,5,boy,0,5,1.3880676155496887e-5
zeki,5,boy,1,6,1.6656811386596265e-5
zeno,5,boy,0,5,1.3880676155496887e-5
zeon,5,boy,0,5,1.3880676155496887e-5
zoran,5,boy,0,5,1.3880676155496887e-5
zvi,5,boy,0,5,1.3880676155496887e-5
aadhav,4,boy,0,4,1.1104540924397509e-5
aahaan,4,boy,0,4,1.1104540924397509e-5
aaliyan,4,boy,0,4,1.1104540924397509e-5
aaqib,4,boy,0,4,1.1104540924397509e-5
aariv,4,boy,1,5,1.3880676155496887e-5
aary,4,boy,0,4,1.1104540924397509e-5
aarya,4,boy,0,4,1.1104540924397509e-5
aathavan,4,boy,0,4,1.1104540924397509e-5
abas,4,boy,0,4,1.1104540924397509e-5
abdelrahman,4,boy,0,4,1.1104540924397509e-5
abdilahi,4,boy,0,4,1.1104540924397509e-5
abdou,4,boy,0,4,1.1104540924397509e-5
abdul-sami,4,boy,0,4,1.1104540924397509e-5
abdulrehman,4,boy,0,4,1.1104540924397509e-5
abdurrahmaan,4,boy,0,4,1.1104540924397509e-5
abdussamad,4,boy,0,4,1.1104540924397509e-5
abenezer,4,boy,0,4,1.1104540924397509e-5
abhi,4,boy,0,4,1.1104540924397509e-5
aboubacar,4,boy,0,4,1.1104540924397509e-5
abrar,4,boy,0,4,1.1104540924397509e-5
abubacarr,4,boy,0,4,1.1104540924397509e-5
abukar,4,boy,0,4,1.1104540924397509e-5
abuzar,4,boy,0,4,1.1104540924397509e-5
adedolapo,4,boy,0,4,1.1104540924397509e-5
adhrit,4,boy,0,4,1.1104540924397509e-5
agambir,4,boy,0,4,1.1104540924397509e-5
agasthya,4,boy,0,4,1.1104540924397509e-5
ahtisham,4,boy,0,4,1.1104540924397509e-5
aiden-james,4,boy,1,5,1.3880676155496887e-5
aiken,4,boy,0,4,1.1104540924397509e-5
ainsley,4,boy,1,5,1.3880676155496887e-5
airon,4,boy,0,4,1.1104540924397509e-5
aiyaz,4,boy,0,4,1.1104540924397509e-5
ajaib,4,boy,0,4,1.1104540924397509e-5
akiva,4,boy,0,4,1.1104540924397509e-5
akmal,4,boy,0,4,1.1104540924397509e-5
akwasi,4,boy,0,4,1.1104540924397509e-5
albie-george,4,boy,0,4,1.1104540924397509e-5
albie-joe,4,boy,0,4,1.1104540924397509e-5
albie-lee,4,boy,0,4,1.1104540924397509e-5
aldo,4,boy,0,4,1.1104540924397509e-5
aleksas,4,boy,0,4,1.1104540924397509e-5
aleksej,4,boy,0,4,1.1104540924397509e-5
alen,4,boy,0,4,1.1104540924397509e-5
alexey,4,boy,0,4,1.1104540924397509e-5
alfy,4,boy,1,5,1.3880676155496887e-5
aliakbar,4,boy,0,4,1.1104540924397509e-5
aloniab,4,boy,0,4,1.1104540924397509e-5
alperen,4,boy,0,4,1.1104540924397509e-5
alphonse,4,boy,0,4,1.1104540924397509e-5
alteo,4,boy,0,4,1.1104540924397509e-5
alwaleed,4,boy,0,4,1.1104540924397509e-5
alyas,4,boy,0,4,1.1104540924397509e-5
amare,4,boy,0,4,1.1104540924397509e-5
amelio,4,boy,0,4,1.1104540924397509e-5
amirali,4,boy,0,4,1.1104540924397509e-5
amjed,4,boy,0,4,1.1104540924397509e-5
amran,4,boy,1,5,1.3880676155496887e-5
amritpal,4,boy,0,4,1.1104540924397509e-5
andria,4,boy,0,4,1.1104540924397509e-5
anhad,4,boy,1,5,1.3880676155496887e-5
anmol,4,boy,1,5,1.3880676155496887e-5
ansar,4,boy,0,4,1.1104540924397509e-5
anson,4,boy,2,6,1.6656811386596265e-5
antonis,4,boy,0,4,1.1104540924397509e-5
anush,4,boy,0,4,1.1104540924397509e-5
ara,4,boy,1,5,1.3880676155496887e-5
archie-j,4,boy,0,4,1.1104540924397509e-5
aria,4,boy,0,4,1.1104540924397509e-5
arius,4,boy,0,4,1.1104540924397509e-5
arne,4,boy,0,4,1.1104540924397509e-5
artemis,4,boy,0,4,1.1104540924397509e-5
artemus,4,boy,0,4,1.1104540924397509e-5
arvi,4,boy,0,4,1.1104540924397509e-5
arwin,4,boy,0,4,1.1104540924397509e-5
asen,4,boy,0,4,1.1104540924397509e-5
ashley-junior,4,boy,0,4,1.1104540924397509e-5
asriel,4,boy,0,4,1.1104540924397509e-5
astor,4,boy,0,4,1.1104540924397509e-5
atanas,4,boy,0,4,1.1104540924397509e-5
atharva,4,boy,0,4,1.1104540924397509e-5
athos,4,boy,0,4,1.1104540924397509e-5
auberon,4,boy,0,4,1.1104540924397509e-5
aun,4,boy,0,4,1.1104540924397509e-5
aurelian,4,boy,0,4,1.1104540924397509e-5
auron,4,boy,3,7,1.943294661769564e-5
avaneesh,4,boy,0,4,1.1104540924397509e-5
avigdor,4,boy,0,4,1.1104540924397509e-5
avrumi,4,boy,0,4,1.1104540924397509e-5
avyukth,4,boy,0,4,1.1104540924397509e-5
ayodele,4,boy,0,4,1.1104540924397509e-5
ayoola,4,boy,0,4,1.1104540924397509e-5
ayyaan,4,boy,0,4,1.1104540924397509e-5
azeez,4,boy,0,4,1.1104540924397509e-5
azim,4,boy,0,4,1.1104540924397509e-5
azlaan,4,boy,1,5,1.3880676155496887e-5
bai,4,boy,0,4,1.1104540924397509e-5
bailee,4,boy,0,4,1.1104540924397509e-5
baljot,4,boy,0,4,1.1104540924397509e-5
bao,4,boy,0,4,1.1104540924397509e-5
barin,4,boy,0,4,1.1104540924397509e-5
baris,4,boy,1,5,1.3880676155496887e-5
barnie,4,boy,0,4,1.1104540924397509e-5
basim,4,boy,0,4,1.1104540924397509e-5
batu,4,boy,0,4,1.1104540924397509e-5
bellamy,4,boy,1,5,1.3880676155496887e-5
benjamim,4,boy,0,4,1.1104540924397509e-5
benjamin-james,4,boy,0,4,1.1104540924397509e-5
benton,4,boy,0,4,1.1104540924397509e-5
bevan,4,boy,0,4,1.1104540924397509e-5
bhavya,4,boy,0,4,1.1104540924397509e-5
binyamin,4,boy,0,4,1.1104540924397509e-5
binyomin,4,boy,0,4,1.1104540924397509e-5
bleddyn,4,boy,0,4,1.1104540924397509e-5
bobby-george,4,boy,0,4,1.1104540924397509e-5
bobby-jay,4,boy,0,4,1.1104540924397509e-5
bode,4,boy,1,5,1.3880676155496887e-5
boluwatife,4,boy,0,4,1.1104540924397509e-5
borislav,4,boy,0,4,1.1104540924397509e-5
boruch,4,boy,0,4,1.1104540924397509e-5
bosco,4,boy,1,5,1.3880676155496887e-5
brannon,4,boy,0,4,1.1104540924397509e-5
braylin,4,boy,0,4,1.1104540924397509e-5
brixton,4,boy,0,4,1.1104540924397509e-5
brodee,4,boy,0,4,1.1104540924397509e-5
brodie-lee,4,boy,0,4,1.1104540924397509e-5
bunyamin,4,boy,0,4,1.1104540924397509e-5
cadan,4,boy,0,4,1.1104540924397509e-5
cael,4,boy,2,6,1.6656811386596265e-5
caian,4,boy,0,4,1.1104540924397509e-5
caileb,4,boy,5,9,2.4985217079894396e-5
cairan,4,boy,1,5,1.3880676155496887e-5
calen,4,boy,2,6,1.6656811386596265e-5
carlson,4,boy,1,5,1.3880676155496887e-5
carol,4,boy,0,4,1.1104540924397509e-5
carter-jai,4,boy,0,4,1.1104540924397509e-5
cary,4,boy,0,4,1.1104540924397509e-5
caydon,4,boy,0,4,1.1104540924397509e-5
caylan,4,boy,1,5,1.3880676155496887e-5
cayleb,4,boy,0,4,1.1104540924397509e-5
caylen,4,boy,0,4,1.1104540924397509e-5
caylum,4,boy,0,4,1.1104540924397509e-5
cee-jay,4,boy,0,4,1.1104540924397509e-5
cellan,4,boy,0,4,1.1104540924397509e-5
cesar,4,boy,1,5,1.3880676155496887e-5
chae,4,boy,0,4,1.1104540924397509e-5
charan,4,boy,0,4,1.1104540924397509e-5
charlie-joe,4,boy,0,4,1.1104540924397509e-5
charlie-junior,4,boy,0,4,1.1104540924397509e-5
charlton,4,boy,0,4,1.1104540924397509e-5
charly,4,boy,0,4,1.1104540924397509e-5
chimeremeze,4,boy,0,4,1.1104540924397509e-5
choudhry,4,boy,0,4,1.1104540924397509e-5
christopher-john,4,boy,0,4,1.1104540924397509e-5
claudio,4,boy,0,4,1.1104540924397509e-5
claydon,4,boy,0,4,1.1104540924397509e-5
clint,4,boy,0,4,1.1104540924397509e-5
cody-jay,4,boy,0,4,1.1104540924397509e-5
colbie,4,boy,1,5,1.3880676155496887e-5
connah,4,boy,0,4,1.1104540924397509e-5
cosimo,4,boy,1,5,1.3880676155496887e-5
cruiz,4,boy,1,5,1.3880676155496887e-5
cynan,4,boy,0,4,1.1104540924397509e-5
dacian,4,boy,0,4,1.1104540924397509e-5
daman,4,boy,0,4,1.1104540924397509e-5
damilare,4,boy,0,4,1.1104540924397509e-5
dantae,4,boy,0,4,1.1104540924397509e-5
dariusz,4,boy,0,4,1.1104540924397509e-5
darnell,4,boy,0,4,1.1104540924397509e-5
dawit,4,boy,0,4,1.1104540924397509e-5
dayne,4,boy,0,4,1.1104540924397509e-5
dayyan,4,boy,0,4,1.1104540924397509e-5
deakon,4,boy,0,4,1.1104540924397509e-5
deian,4,boy,0,4,1.1104540924397509e-5
delano,4,boy,0,4,1.1104540924397509e-5
demari,4,boy,0,4,1.1104540924397509e-5
demba,4,boy,1,5,1.3880676155496887e-5
deren,4,boy,0,4,1.1104540924397509e-5
devonte,4,boy,0,4,1.1104540924397509e-5
devyn,4,boy,2,6,1.6656811386596265e-5
deyan,4,boy,0,4,1.1104540924397509e-5
dharamveer,4,boy,0,4,1.1104540924397509e-5
dhiaan,4,boy,0,4,1.1104540924397509e-5
dhillon,4,boy,0,4,1.1104540924397509e-5
dhiyaan,4,boy,0,4,1.1104540924397509e-5
dhiyan,4,boy,0,4,1.1104540924397509e-5
dian,4,boy,0,4,1.1104540924397509e-5
diar,4,boy,0,4,1.1104540924397509e-5
diaz,4,boy,1,5,1.3880676155496887e-5
dilans,4,boy,0,4,1.1104540924397509e-5
dinis,4,boy,0,4,1.1104540924397509e-5
dino,4,boy,0,4,1.1104540924397509e-5
dionis,4,boy,0,4,1.1104540924397509e-5
diyar,4,boy,0,4,1.1104540924397509e-5
diyon,4,boy,0,4,1.1104540924397509e-5
djibril,4,boy,0,4,1.1104540924397509e-5
donatas,4,boy,0,4,1.1104540924397509e-5
donnell,4,boy,0,4,1.1104540924397509e-5
doruk,4,boy,0,4,1.1104540924397509e-5
dusan,4,boy,0,4,1.1104540924397509e-5
dyako,4,boy,0,4,1.1104540924397509e-5
eagan,4,boy,0,4,1.1104540924397509e-5
ebrima,4,boy,0,4,1.1104540924397509e-5
edin,4,boy,0,4,1.1104540924397509e-5
edis,4,boy,0,4,1.1104540924397509e-5
edvardas,4,boy,0,4,1.1104540924397509e-5
eeren,4,boy,0,4,1.1104540924397509e-5
eesaa,4,boy,0,4,1.1104540924397509e-5
egan,4,boy,0,4,1.1104540924397509e-5
ehaan,4,boy,0,4,1.1104540924397509e-5
eidan,4,boy,0,4,1.1104540924397509e-5
ekamjit,4,boy,0,4,1.1104540924397509e-5
ekamveer,4,boy,0,4,1.1104540924397509e-5
ektoras,4,boy,0,4,1.1104540924397509e-5
elai,4,boy,0,4,1.1104540924397509e-5
elbie,4,boy,0,4,1.1104540924397509e-5
elham,4,boy,0,4,1.1104540924397509e-5
eliab,4,boy,0,4,1.1104540924397509e-5
elie,4,boy,0,4,1.1104540924397509e-5
ellery,4,boy,0,4,1.1104540924397509e-5
ellias,4,boy,0,4,1.1104540924397509e-5
elwin,4,boy,0,4,1.1104540924397509e-5
elya,4,boy,0,4,1.1104540924397509e-5
elyan,4,boy,0,4,1.1104540924397509e-5
emanuele,4,boy,1,5,1.3880676155496887e-5
emetas,4,boy,0,4,1.1104540924397509e-5
emilijus,4,boy,0,4,1.1104540924397509e-5
emin,4,boy,0,4,1.1104540924397509e-5
ennio,4,boy,0,4,1.1104540924397509e-5
eray,4,boy,0,4,1.1104540924397509e-5
eriks,4,boy,0,4,1.1104540924397509e-5
erlis,4,boy,0,4,1.1104540924397509e-5
errol,4,boy,2,6,1.6656811386596265e-5
essam,4,boy,0,4,1.1104540924397509e-5
ethan-daniel,4,boy,0,4,1.1104540924397509e-5
ever,4,boy,0,4,1.1104540924397509e-5
eyob,4,boy,0,4,1.1104540924397509e-5
eyoel,4,boy,0,4,1.1104540924397509e-5
ezra-james,4,boy,0,4,1.1104540924397509e-5
fadel,4,boy,0,4,1.1104540924397509e-5
faelan,4,boy,0,4,1.1104540924397509e-5
fallon,4,boy,0,4,1.1104540924397509e-5
fareed,4,boy,0,4,1.1104540924397509e-5
ferris,4,boy,0,4,1.1104540924397509e-5
fiachra,4,boy,0,4,1.1104540924397509e-5
finan,4,boy,0,4,1.1104540924397509e-5
finbar,4,boy,2,6,1.6656811386596265e-5
finch,4,boy,0,4,1.1104540924397509e-5
findley,4,boy,0,4,1.1104540924397509e-5
finnan,4,boy,1,5,1.3880676155496887e-5
fortune,4,boy,0,4,1.1104540924397509e-5
francie,4,boy,0,4,1.1104540924397509e-5
frankey,4,boy,0,4,1.1104540924397509e-5
frankie-joe,4,boy,0,4,1.1104540924397509e-5
freddy-george,4,boy,0,4,1.1104540924397509e-5
fredric,4,boy,0,4,1.1104540924397509e-5
gabriels,4,boy,0,4,1.1104540924397509e-5
garrett,4,boy,2,6,1.6656811386596265e-5
george-henry,4,boy,1,5,1.3880676155496887e-5
gergo,4,boy,1,5,1.3880676155496887e-5
glory,4,boy,0,4,1.1104540924397509e-5
godson,4,boy,0,4,1.1104540924397509e-5
golam,4,boy,0,4,1.1104540924397509e-5
gurdit,4,boy,0,4,1.1104540924397509e-5
gurjeevan,4,boy,0,4,1.1104540924397509e-5
gurshan,4,boy,0,4,1.1104540924397509e-5
gurtej,4,boy,0,4,1.1104540924397509e-5
gurvir,4,boy,0,4,1.1104540924397509e-5
gustave,4,boy,0,4,1.1104540924397509e-5
gyan,4,boy,1,5,1.3880676155496887e-5
gyorgy,4,boy,0,4,1.1104540924397509e-5
hadleigh,4,boy,0,4,1.1104540924397509e-5
hadriel,4,boy,0,4,1.1104540924397509e-5
haider-ali,4,boy,0,4,1.1104540924397509e-5
hameed,4,boy,0,4,1.1104540924397509e-5
hameem,4,boy,0,4,1.1104540924397509e-5
hanad,4,boy,0,4,1.1104540924397509e-5
hani,4,boy,0,4,1.1104540924397509e-5
hanson,4,boy,0,4,1.1104540924397509e-5
hardeep,4,boy,0,4,1.1104540924397509e-5
hargun,4,boy,1,5,1.3880676155496887e-5
harish,4,boy,0,4,1.1104540924397509e-5
harison,4,boy,0,4,1.1104540924397509e-5
harkirat,4,boy,0,4,1.1104540924397509e-5
harley-j,4,boy,0,4,1.1104540924397509e-5
harrison-lee,4,boy,0,4,1.1104540924397509e-5
harryson,4,boy,0,4,1.1104540924397509e-5
harshaan,4,boy,0,4,1.1104540924397509e-5
harvinder,4,boy,0,4,1.1104540924397509e-5
hassnain,4,boy,0,4,1.1104540924397509e-5
hazim,4,boy,0,4,1.1104540924397509e-5
henil,4,boy,0,4,1.1104540924397509e-5
henley-james,4,boy,0,4,1.1104540924397509e-5
henrikas,4,boy,0,4,1.1104540924397509e-5
henry-lee,4,boy,1,5,1.3880676155496887e-5
herb,4,boy,0,4,1.1104540924397509e-5
hershy,4,boy,0,4,1.1104540924397509e-5
hesham,4,boy,0,4,1.1104540924397509e-5
het,4,boy,0,4,1.1104540924397509e-5
heyan,4,boy,0,4,1.1104540924397509e-5
huckleberry,4,boy,0,4,1.1104540924397509e-5
hudson-lee,4,boy,0,4,1.1104540924397509e-5
humayl,4,boy,0,4,1.1104540924397509e-5
humzah,4,boy,0,4,1.1104540924397509e-5
iason,4,boy,0,4,1.1104540924397509e-5
ifeanyi,4,boy,0,4,1.1104540924397509e-5
iggy,4,boy,0,4,1.1104540924397509e-5
iker,4,boy,1,5,1.3880676155496887e-5
ikram,4,boy,0,4,1.1104540924397509e-5
iliyas,4,boy,0,4,1.1104540924397509e-5
imraan,4,boy,0,4,1.1104540924397509e-5
inayat,4,boy,0,4,1.1104540924397509e-5
inioluwa,4,boy,0,4,1.1104540924397509e-5
ion,4,boy,0,4,1.1104540924397509e-5
irtaza,4,boy,0,4,1.1104540924397509e-5
isac,4,boy,1,5,1.3880676155496887e-5
ishak,4,boy,1,5,1.3880676155496887e-5
j,4,boy,0,4,1.1104540924397509e-5
jaabir,4,boy,0,4,1.1104540924397509e-5
jaap,4,boy,0,4,1.1104540924397509e-5
jacey,4,boy,0,4,1.1104540924397509e-5
jack-james,4,boy,0,4,1.1104540924397509e-5
jacky,4,boy,1,5,1.3880676155496887e-5
jacopo,4,boy,0,4,1.1104540924397509e-5
jade,4,boy,0,4,1.1104540924397509e-5
jahiem,4,boy,0,4,1.1104540924397509e-5
jahmai,4,boy,0,4,1.1104540924397509e-5
jahmiah,4,boy,0,4,1.1104540924397509e-5
jahvon,4,boy,1,5,1.3880676155496887e-5
jai-jai,4,boy,2,6,1.6656811386596265e-5
jaideep,4,boy,0,4,1.1104540924397509e-5
jaimin,4,boy,0,4,1.1104540924397509e-5
jainish,4,boy,0,4,1.1104540924397509e-5
jairus,4,boy,0,4,1.1104540924397509e-5
jakson,4,boy,1,5,1.3880676155496887e-5
jalal,4,boy,0,4,1.1104540924397509e-5
jaleel,4,boy,1,5,1.3880676155496887e-5
jalen,4,boy,0,4,1.1104540924397509e-5
jamel,4,boy,0,4,1.1104540924397509e-5
jamiel,4,boy,0,4,1.1104540924397509e-5
jarrell,4,boy,0,4,1.1104540924397509e-5
javan,4,boy,0,4,1.1104540924397509e-5
jaxson-james,4,boy,0,4,1.1104540924397509e-5
jay-lee,4,boy,0,4,1.1104540924397509e-5
jayceon,4,boy,1,5,1.3880676155496887e-5
jaysen,4,boy,0,4,1.1104540924397509e-5
jediah,4,boy,0,4,1.1104540924397509e-5
jeff,4,boy,1,5,1.3880676155496887e-5
jelani,4,boy,0,4,1.1104540924397509e-5
jenish,4,boy,0,4,1.1104540924397509e-5
jeremi,4,boy,2,6,1.6656811386596265e-5
jeremie,4,boy,0,4,1.1104540924397509e-5
jeron,4,boy,0,4,1.1104540924397509e-5
jerzy,4,boy,1,5,1.3880676155496887e-5
jetson,4,boy,0,4,1.1104540924397509e-5
jevan,4,boy,0,4,1.1104540924397509e-5
jezreel,4,boy,0,4,1.1104540924397509e-5
jibraeel,4,boy,1,5,1.3880676155496887e-5
jimmy-joe,4,boy,0,4,1.1104540924397509e-5
joab,4,boy,0,4,1.1104540924397509e-5
joaquim,4,boy,0,4,1.1104540924397509e-5
jocelyn,4,boy,1,5,1.3880676155496887e-5
joell,4,boy,0,4,1.1104540924397509e-5
john-junior,4,boy,0,4,1.1104540924397509e-5
john-luke,4,boy,0,4,1.1104540924397509e-5
john-thomas,4,boy,0,4,1.1104540924397509e-5
john-william,4,boy,0,4,1.1104540924397509e-5
johnathon,4,boy,0,4,1.1104540924397509e-5
johnpaul,4,boy,1,5,1.3880676155496887e-5
jonnie,4,boy,0,4,1.1104540924397509e-5
jora,4,boy,0,4,1.1104540924397509e-5
joseph-lee,4,boy,0,4,1.1104540924397509e-5
jovi,4,boy,0,4,1.1104540924397509e-5
jozsef,4,boy,0,4,1.1104540924397509e-5
juliusz,4,boy,2,6,1.6656811386596265e-5
juno,4,boy,0,4,1.1104540924397509e-5
jupiter,4,boy,0,4,1.1104540924397509e-5
juraj,4,boy,1,5,1.3880676155496887e-5
justinas,4,boy,0,4,1.1104540924397509e-5
justyn,4,boy,0,4,1.1104540924397509e-5
jusuf,4,boy,0,4,1.1104540924397509e-5
kace,4,boy,0,4,1.1104540924397509e-5
kage,4,boy,0,4,1.1104540924397509e-5
kaid,4,boy,1,5,1.3880676155496887e-5
kailem,4,boy,0,4,1.1104540924397509e-5
kailo,4,boy,0,4,1.1104540924397509e-5
kairos,4,boy,1,5,1.3880676155496887e-5
kalani,4,boy,0,4,1.1104540924397509e-5
kalem,4,boy,0,4,1.1104540924397509e-5
kalo,4,boy,0,4,1.1104540924397509e-5
kamai,4,boy,0,4,1.1104540924397509e-5
kamali,4,boy,0,4,1.1104540924397509e-5
karlo,4,boy,0,4,1.1104540924397509e-5
karlos,4,boy,0,4,1.1104540924397509e-5
karo,4,boy,1,5,1.3880676155496887e-5
kase,4,boy,0,4,1.1104540924397509e-5
kaseem,4,boy,0,4,1.1104540924397509e-5
kasen,4,boy,0,4,1.1104540924397509e-5
kasra,4,boy,0,4,1.1104540924397509e-5
kavell,4,boy,0,4,1.1104540924397509e-5
kaven,4,boy,0,4,1.1104540924397509e-5
kaylub,4,boy,0,4,1.1104540924397509e-5
kayode,4,boy,0,4,1.1104540924397509e-5
keigo,4,boy,0,4,1.1104540924397509e-5
keion,4,boy,0,4,1.1104540924397509e-5
kelby,4,boy,0,4,1.1104540924397509e-5
kelsey,4,boy,0,4,1.1104540924397509e-5
kemari,4,boy,0,4,1.1104540924397509e-5
kenzie-lee,4,boy,0,4,1.1104540924397509e-5
kevins,4,boy,0,4,1.1104540924397509e-5
khalifah,4,boy,0,4,1.1104540924397509e-5
khamari,4,boy,0,4,1.1104540924397509e-5
khawaja,4,boy,1,5,1.3880676155496887e-5
khaylen,4,boy,0,4,1.1104540924397509e-5
khyree,4,boy,0,4,1.1104540924397509e-5
kinley,4,boy,2,6,1.6656811386596265e-5
kitson,4,boy,0,4,1.1104540924397509e-5
kitto,4,boy,0,4,1.1104540924397509e-5
konstanty,4,boy,1,5,1.3880676155496887e-5
kori,4,boy,1,5,1.3880676155496887e-5
kray,4,boy,1,5,1.3880676155496887e-5
krishay,4,boy,0,4,1.1104540924397509e-5
krithik,4,boy,0,4,1.1104540924397509e-5
kwabena,4,boy,0,4,1.1104540924397509e-5
kyian,4,boy,0,4,1.1104540924397509e-5
kylian,4,boy,0,4,1.1104540924397509e-5
kyrone,4,boy,0,4,1.1104540924397509e-5
kyzer,4,boy,0,4,1.1104540924397509e-5
laiken,4,boy,1,5,1.3880676155496887e-5
lakai,4,boy,0,4,1.1104540924397509e-5
landen,4,boy,0,4,1.1104540924397509e-5
larson,4,boy,1,5,1.3880676155496887e-5
laurent,4,boy,0,4,1.1104540924397509e-5
laurentiu,4,boy,0,4,1.1104540924397509e-5
lawan,4,boy,0,4,1.1104540924397509e-5
lawrie,4,boy,2,6,1.6656811386596265e-5
leeson,4,boy,0,4,1.1104540924397509e-5
leiland,4,boy,0,4,1.1104540924397509e-5
lennix,4,boy,0,4,1.1104540924397509e-5
leo-john,4,boy,1,5,1.3880676155496887e-5
leone,4,boy,0,4,1.1104540924397509e-5
leslie,4,boy,0,4,1.1104540924397509e-5
leuan,4,boy,0,4,1.1104540924397509e-5
levon,4,boy,0,4,1.1104540924397509e-5
lewyn,4,boy,0,4,1.1104540924397509e-5
leylan,4,boy,2,6,1.6656811386596265e-5
liam-james,4,boy,1,5,1.3880676155496887e-5
lincoln-james,4,boy,0,4,1.1104540924397509e-5
lio,4,boy,0,4,1.1104540924397509e-5
lleu,4,boy,0,4,1.1104540924397509e-5
logen,4,boy,0,4,1.1104540924397509e-5
london,4,boy,0,4,1.1104540924397509e-5
lorenz,4,boy,0,4,1.1104540924397509e-5
louay,4,boy,1,5,1.3880676155496887e-5
louix,4,boy,0,4,1.1104540924397509e-5
lovell,4,boy,0,4,1.1104540924397509e-5
lowell,4,boy,0,4,1.1104540924397509e-5
luca-jay,4,boy,0,4,1.1104540924397509e-5
lucifer,4,boy,0,4,1.1104540924397509e-5
ludwig,4,boy,0,4,1.1104540924397509e-5
ludwik,4,boy,0,4,1.1104540924397509e-5
luie,4,boy,1,5,1.3880676155496887e-5
lyall,4,boy,11,15,4.164202846649066e-5
lyam,4,boy,0,4,1.1104540924397509e-5
lycan,4,boy,0,4,1.1104540924397509e-5
maazin,4,boy,0,4,1.1104540924397509e-5
mackinley,4,boy,0,4,1.1104540924397509e-5
mahi,4,boy,0,4,1.1104540924397509e-5
mahid,4,boy,0,4,1.1104540924397509e-5
mahin,4,boy,0,4,1.1104540924397509e-5
maikls,4,boy,0,4,1.1104540924397509e-5
majd,4,boy,0,4,1.1104540924397509e-5
maksimilian,4,boy,1,5,1.3880676155496887e-5
maleik,4,boy,0,4,1.1104540924397509e-5
malick,4,boy,0,4,1.1104540924397509e-5
malikai,4,boy,0,4,1.1104540924397509e-5
manan,4,boy,0,4,1.1104540924397509e-5
manjot,4,boy,0,4,1.1104540924397509e-5
mankirat,4,boy,1,5,1.3880676155496887e-5
mansoor,4,boy,0,4,1.1104540924397509e-5
marceli,4,boy,0,4,1.1104540924397509e-5
mard,4,boy,0,4,1.1104540924397509e-5
mariusz,4,boy,0,4,1.1104540924397509e-5
markos,4,boy,0,4,1.1104540924397509e-5
marky,4,boy,0,4,1.1104540924397509e-5
marlee,4,boy,0,4,1.1104540924397509e-5
marley-jay,4,boy,0,4,1.1104540924397509e-5
martino,4,boy,1,5,1.3880676155496887e-5
marton,4,boy,0,4,1.1104540924397509e-5
martynas,4,boy,0,4,1.1104540924397509e-5
marwaan,4,boy,0,4,1.1104540924397509e-5
mason-jay,4,boy,0,4,1.1104540924397509e-5
masood,4,boy,0,4,1.1104540924397509e-5
math,4,boy,0,4,1.1104540924397509e-5
mathis,4,boy,0,4,1.1104540924397509e-5
mats,4,boy,1,5,1.3880676155496887e-5
matthews,4,boy,0,4,1.1104540924397509e-5
matty,4,boy,0,4,1.1104540924397509e-5
matvei,4,boy,0,4,1.1104540924397509e-5
maximillion,4,boy,0,4,1.1104540924397509e-5
meher,4,boy,0,4,1.1104540924397509e-5
mehraj,4,boy,0,4,1.1104540924397509e-5
menelik,4,boy,0,4,1.1104540924397509e-5
merdan,4,boy,0,4,1.1104540924397509e-5
meron,4,boy,0,4,1.1104540924397509e-5
mick,4,boy,0,4,1.1104540924397509e-5
mikah,4,boy,0,4,1.1104540924397509e-5
miks,4,boy,0,4,1.1104540924397509e-5
milano,4,boy,0,4,1.1104540924397509e-5
miqdad,4,boy,0,4,1.1104540924397509e-5
mircea,4,boy,0,4,1.1104540924397509e-5
miro,4,boy,0,4,1.1104540924397509e-5
miron,4,boy,0,4,1.1104540924397509e-5
mithun,4,boy,0,4,1.1104540924397509e-5
moeen,4,boy,0,4,1.1104540924397509e-5
mohammed-yahya,4,boy,0,4,1.1104540924397509e-5
mohamoud,4,boy,0,4,1.1104540924397509e-5
morocco,4,boy,0,4,1.1104540924397509e-5
morrison,4,boy,0,4,1.1104540924397509e-5
motti,4,boy,0,4,1.1104540924397509e-5
mudassir,4,boy,0,4,1.1104540924397509e-5
muhammad-isa,4,boy,0,4,1.1104540924397509e-5
muhammad-ismail,4,boy,0,4,1.1104540924397509e-5
muhammad-yahya,4,boy,0,4,1.1104540924397509e-5
muhammad-zakariya,4,boy,0,4,1.1104540924397509e-5
muhammadali,4,boy,0,4,1.1104540924397509e-5
murat,4,boy,0,4,1.1104540924397509e-5
musaab,4,boy,0,4,1.1104540924397509e-5
mussa,4,boy,0,4,1.1104540924397509e-5
mustafaa,4,boy,0,4,1.1104540924397509e-5
naayel,4,boy,0,4,1.1104540924397509e-5
nadeem,4,boy,1,5,1.3880676155496887e-5
nakai,4,boy,0,4,1.1104540924397509e-5
nam,4,boy,0,4,1.1104540924397509e-5
namir,4,boy,0,4,1.1104540924397509e-5
namish,4,boy,0,4,1.1104540924397509e-5
naseem,4,boy,0,4,1.1104540924397509e-5
navid,4,boy,2,6,1.6656811386596265e-5
nawaf,4,boy,0,4,1.1104540924397509e-5
nazim,4,boy,0,4,1.1104540924397509e-5
nazir,4,boy,0,4,1.1104540924397509e-5
neal,4,boy,0,4,1.1104540924397509e-5
neitanas,4,boy,0,4,1.1104540924397509e-5
neville,4,boy,0,4,1.1104540924397509e-5
niels,4,boy,0,4,1.1104540924397509e-5
nii,4,boy,0,4,1.1104540924397509e-5
nikan,4,boy,0,4,1.1104540924397509e-5
nikos,4,boy,1,5,1.3880676155496887e-5
nivin,4,boy,0,4,1.1104540924397509e-5
niyan,4,boy,0,4,1.1104540924397509e-5
nnamdi,4,boy,0,4,1.1104540924397509e-5
nobel,4,boy,0,4,1.1104540924397509e-5
o'shea,4,boy,0,4,1.1104540924397509e-5
oaklan,4,boy,0,4,1.1104540924397509e-5
obadiah,4,boy,0,4,1.1104540924397509e-5
oban,4,boy,0,4,1.1104540924397509e-5
oberon,4,boy,0,4,1.1104540924397509e-5
octave,4,boy,0,4,1.1104540924397509e-5
octavio,4,boy,0,4,1.1104540924397509e-5
oden,4,boy,0,4,1.1104540924397509e-5
odysseas,4,boy,1,5,1.3880676155496887e-5
okkes,4,boy,0,4,1.1104540924397509e-5
olamiposi,4,boy,0,4,1.1104540924397509e-5
olawale,4,boy,0,4,1.1104540924397509e-5
olek,4,boy,0,4,1.1104540924397509e-5
olly-jay,4,boy,0,4,1.1104540924397509e-5
oluwadamilola,4,boy,0,4,1.1104540924397509e-5
oluwafemi,4,boy,1,5,1.3880676155496887e-5
oluwanifemi,4,boy,0,4,1.1104540924397509e-5
oluwatamilore,4,boy,0,4,1.1104540924397509e-5
oluwatise,4,boy,0,4,1.1104540924397509e-5
omarion,4,boy,1,5,1.3880676155496887e-5
omran,4,boy,0,4,1.1104540924397509e-5
orry,4,boy,0,4,1.1104540924397509e-5
osborne,4,boy,0,4,1.1104540924397509e-5
oscar-george,4,boy,0,4,1.1104540924397509e-5
osias,4,boy,0,4,1.1104540924397509e-5
osiris,4,boy,0,4,1.1104540924397509e-5
oska,4,boy,0,4,1.1104540924397509e-5
oskars,4,boy,2,6,1.6656811386596265e-5
othman,4,boy,0,4,1.1104540924397509e-5
otter,4,boy,0,4,1.1104540924397509e-5
ottis,4,boy,0,4,1.1104540924397509e-5
pak,4,boy,0,4,1.1104540924397509e-5
panth,4,boy,0,4,1.1104540924397509e-5
papa,4,boy,0,4,1.1104540924397509e-5
pascal,4,boy,0,4,1.1104540924397509e-5
pavish,4,boy,0,4,1.1104540924397509e-5
perran,4,boy,0,4,1.1104540924397509e-5
phanuel,4,boy,0,4,1.1104540924397509e-5
pharaoh,4,boy,0,4,1.1104540924397509e-5
pheonix,4,boy,0,4,1.1104540924397509e-5
piero,4,boy,0,4,1.1104540924397509e-5
pieter,4,boy,0,4,1.1104540924397509e-5
prabh,4,boy,0,4,1.1104540924397509e-5
pranay,4,boy,0,4,1.1104540924397509e-5
pratham,4,boy,0,4,1.1104540924397509e-5
prayan,4,boy,0,4,1.1104540924397509e-5
preet,4,boy,0,4,1.1104540924397509e-5
princeton,4,boy,1,5,1.3880676155496887e-5
priyan,4,boy,0,4,1.1104540924397509e-5
ptolemy,4,boy,0,4,1.1104540924397509e-5
qaasim,4,boy,0,4,1.1104540924397509e-5
qays,4,boy,0,4,1.1104540924397509e-5
raahil,4,boy,0,4,1.1104540924397509e-5
rafan,4,boy,0,4,1.1104540924397509e-5
rahman,4,boy,0,4,1.1104540924397509e-5
rain,4,boy,0,4,1.1104540924397509e-5
ralfie,4,boy,0,4,1.1104540924397509e-5
ramazan,4,boy,0,4,1.1104540924397509e-5
ramzi,4,boy,2,6,1.6656811386596265e-5
ramzy,4,boy,0,4,1.1104540924397509e-5
raqeeb,4,boy,0,4,1.1104540924397509e-5
rashed,4,boy,0,4,1.1104540924397509e-5
rasim,4,boy,0,4,1.1104540924397509e-5
raunak,4,boy,0,4,1.1104540924397509e-5
rawen,4,boy,0,4,1.1104540924397509e-5
rayansh,4,boy,1,5,1.3880676155496887e-5
reeko,4,boy,0,4,1.1104540924397509e-5
refoel,4,boy,0,4,1.1104540924397509e-5
reg,4,boy,0,4,1.1104540924397509e-5
reggie-joe,4,boy,0,4,1.1104540924397509e-5
reigan,4,boy,0,4,1.1104540924397509e-5
reiko,4,boy,0,4,1.1104540924397509e-5
reily,4,boy,0,4,1.1104540924397509e-5
rejan,4,boy,1,5,1.3880676155496887e-5
remel,4,boy,0,4,1.1104540924397509e-5
reubyn,4,boy,0,4,1.1104540924397509e-5
rexhep,4,boy,0,4,1.1104540924397509e-5
rexley,4,boy,0,4,1.1104540924397509e-5
rhema,4,boy,0,4,1.1104540924397509e-5
rheon,4,boy,0,4,1.1104540924397509e-5
rhion,4,boy,0,4,1.1104540924397509e-5
riordan,4,boy,0,4,1.1104540924397509e-5
ritchie,4,boy,8,12,3.331362277319253e-5
rithik,4,boy,0,4,1.1104540924397509e-5
rivers,4,boy,1,5,1.3880676155496887e-5
riyaad,4,boy,0,4,1.1104540924397509e-5
robert-james,4,boy,0,4,1.1104540924397509e-5
roby,4,boy,0,4,1.1104540924397509e-5
rockie,4,boy,0,4,1.1104540924397509e-5
roddy,4,boy,6,10,2.7761352310993775e-5
roen,4,boy,1,5,1.3880676155496887e-5
roman-james,4,boy,1,5,1.3880676155496887e-5
romari,4,boy,0,4,1.1104540924397509e-5
romi,4,boy,0,4,1.1104540924397509e-5
romy,4,boy,0,4,1.1104540924397509e-5
rowan-james,4,boy,0,4,1.1104540924397509e-5
ruben-james,4,boy,0,4,1.1104540924397509e-5
rudolf,4,boy,0,4,1.1104540924397509e-5
rufael,4,boy,0,4,1.1104540924397509e-5
rushil,4,boy,0,4,1.1104540924397509e-5
ryden,4,boy,1,5,1.3880676155496887e-5
sa'ad,4,boy,0,4,1.1104540924397509e-5
saam,4,boy,0,4,1.1104540924397509e-5
saami,4,boy,0,4,1.1104540924397509e-5
saarth,4,boy,0,4,1.1104540924397509e-5
sabri,4,boy,0,4,1.1104540924397509e-5
safa,4,boy,0,4,1.1104540924397509e-5
saifuddin,4,boy,0,4,1.1104540924397509e-5
saihaan,4,boy,0,4,1.1104540924397509e-5
saimon,4,boy,0,4,1.1104540924397509e-5
samad,4,boy,0,4,1.1104540924397509e-5
samarveer,4,boy,0,4,1.1104540924397509e-5
samet,4,boy,0,4,1.1104540924397509e-5
sandor,4,boy,2,6,1.6656811386596265e-5
sandro,4,boy,1,5,1.3880676155496887e-5
saqib,4,boy,0,4,1.1104540924397509e-5
sava,4,boy,2,6,1.6656811386596265e-5
savir,4,boy,0,4,1.1104540924397509e-5
sayhan,4,boy,0,4,1.1104540924397509e-5
sebastiao,4,boy,0,4,1.1104540924397509e-5
seeley,4,boy,1,5,1.3880676155496887e-5
sehajdeep,4,boy,0,4,1.1104540924397509e-5
sem,4,boy,0,4,1.1104540924397509e-5
serge,4,boy,1,5,1.3880676155496887e-5
sergiu,4,boy,0,4,1.1104540924397509e-5
seyon,4,boy,0,4,1.1104540924397509e-5
shaheed,4,boy,0,4,1.1104540924397509e-5
shakir,4,boy,0,4,1.1104540924397509e-5
sharan,4,boy,0,4,1.1104540924397509e-5
sharjeel,4,boy,0,4,1.1104540924397509e-5
shehroz,4,boy,0,4,1.1104540924397509e-5
shelby,4,boy,0,4,1.1104540924397509e-5
shraga,4,boy,0,4,1.1104540924397509e-5
simone,4,boy,1,5,1.3880676155496887e-5
simran,4,boy,0,4,1.1104540924397509e-5
siyam,4,boy,0,4,1.1104540924397509e-5
sohaib,4,boy,0,4,1.1104540924397509e-5
solal,4,boy,0,4,1.1104540924397509e-5
sonney,4,boy,0,4,1.1104540924397509e-5
sriyan,4,boy,0,4,1.1104540924397509e-5
stan-lee,4,boy,0,4,1.1104540924397509e-5
stewart,4,boy,9,13,3.60897580042919e-5
suhas,4,boy,0,4,1.1104540924397509e-5
suheyb,4,boy,0,4,1.1104540924397509e-5
svetoslav,4,boy,0,4,1.1104540924397509e-5
syd,4,boy,0,4,1.1104540924397509e-5
sylvan,4,boy,2,6,1.6656811386596265e-5
syrus,4,boy,0,4,1.1104540924397509e-5
taaha,4,boy,0,4,1.1104540924397509e-5
tahmid,4,boy,0,4,1.1104540924397509e-5
taiga,4,boy,0,4,1.1104540924397509e-5
tait,4,boy,6,10,2.7761352310993775e-5
tanaka,4,boy,0,4,1.1104540924397509e-5
tauren,4,boy,0,4,1.1104540924397509e-5
tayyib,4,boy,0,4,1.1104540924397509e-5
teddie-lee,4,boy,0,4,1.1104540924397509e-5
tee-jay,4,boy,0,4,1.1104540924397509e-5
tejasveer,4,boy,0,4,1.1104540924397509e-5
temidayo,4,boy,0,4,1.1104540924397509e-5
terrell,4,boy,0,4,1.1104540924397509e-5
tervel,4,boy,0,4,1.1104540924397509e-5
thane,4,boy,1,5,1.3880676155496887e-5
thelonious,4,boy,0,4,1.1104540924397509e-5
theoden,4,boy,0,4,1.1104540924397509e-5
theodoros,4,boy,0,4,1.1104540924397509e-5
theophile,4,boy,0,4,1.1104540924397509e-5
thorben,4,boy,0,4,1.1104540924397509e-5
thorley,4,boy,0,4,1.1104540924397509e-5
tiam,4,boy,0,4,1.1104540924397509e-5
tien,4,boy,0,4,1.1104540924397509e-5
tihomir,4,boy,0,4,1.1104540924397509e-5
timurs,4,boy,1,5,1.3880676155496887e-5
tinaye,4,boy,1,5,1.3880676155496887e-5
tiwatope,4,boy,0,4,1.1104540924397509e-5
toby-james,4,boy,0,4,1.1104540924397509e-5
tolulope,4,boy,0,4,1.1104540924397509e-5
tommie-lee,4,boy,0,4,1.1104540924397509e-5
tommylee,4,boy,0,4,1.1104540924397509e-5
tor,4,boy,2,6,1.6656811386596265e-5
toryn,4,boy,0,4,1.1104540924397509e-5
trayvon,4,boy,0,4,1.1104540924397509e-5
turki,4,boy,0,4,1.1104540924397509e-5
tylor,4,boy,0,4,1.1104540924397509e-5
ubaidullah,4,boy,0,4,1.1104540924397509e-5
ugonna,4,boy,0,4,1.1104540924397509e-5
vedaant,4,boy,0,4,1.1104540924397509e-5
vedansh,4,boy,0,4,1.1104540924397509e-5
vedanth,4,boy,0,4,1.1104540924397509e-5
vinnie-lee,4,boy,0,4,1.1104540924397509e-5
vishal,4,boy,1,5,1.3880676155496887e-5
vishan,4,boy,0,4,1.1104540924397509e-5
viyan,4,boy,0,4,1.1104540924397509e-5
vladyslav,4,boy,0,4,1.1104540924397509e-5
waaris,4,boy,0,4,1.1104540924397509e-5
wael,4,boy,0,4,1.1104540924397509e-5
wahaab,4,boy,0,4,1.1104540924397509e-5
waheeb,4,boy,0,4,1.1104540924397509e-5
walt,4,boy,0,4,1.1104540924397509e-5
wesam,4,boy,0,4,1.1104540924397509e-5
wil,4,boy,0,4,1.1104540924397509e-5
william-james,4,boy,1,5,1.3880676155496887e-5
wladyslaw,4,boy,0,4,1.1104540924397509e-5
xavian,4,boy,0,4,1.1104540924397509e-5
ya'qub,4,boy,0,4,1.1104540924397509e-5
yacqub,4,boy,0,4,1.1104540924397509e-5
yakoub,4,boy,0,4,1.1104540924397509e-5
yaman,4,boy,1,5,1.3880676155496887e-5
yamen,4,boy,0,4,1.1104540924397509e-5
yaroslav,4,boy,0,4,1.1104540924397509e-5
yavuz,4,boy,0,4,1.1104540924397509e-5
yechiel,4,boy,0,4,1.1104540924397509e-5
yeshua,4,boy,1,5,1.3880676155496887e-5
yitzi,4,boy,0,4,1.1104540924397509e-5
yordan,4,boy,0,4,1.1104540924397509e-5
yosief,4,boy,0,4,1.1104540924397509e-5
yousof,4,boy,0,4,1.1104540924397509e-5
yuven,4,boy,0,4,1.1104540924397509e-5
yuvi,4,boy,0,4,1.1104540924397509e-5
zaaki,4,boy,0,4,1.1104540924397509e-5
zachari,4,boy,0,4,1.1104540924397509e-5
zafer,4,boy,0,4,1.1104540924397509e-5
zaim,4,boy,1,5,1.3880676155496887e-5
zaiyan,4,boy,0,4,1.1104540924397509e-5
zakriya,4,boy,1,5,1.3880676155496887e-5
zamaan,4,boy,0,4,1.1104540924397509e-5
zana,4,boy,0,4,1.1104540924397509e-5
zaryab,4,boy,0,4,1.1104540924397509e-5
ze,4,boy,0,4,1.1104540924397509e-5
zeyd,4,boy,0,4,1.1104540924397509e-5
zhi,4,boy,0,4,1.1104540924397509e-5
zihao,4,boy,0,4,1.1104540924397509e-5
ziya,4,boy,1,5,1.3880676155496887e-5
ziyaad,4,boy,0,4,1.1104540924397509e-5
zuhaib,4,boy,0,4,1.1104540924397509e-5
zunair,4,boy,0,4,1.1104540924397509e-5
aaban,3,boy,0,3,8.328405693298133e-6
aabid,3,boy,0,3,8.328405693298133e-6
aadhvik,3,boy,0,3,8.328405693298133e-6
aadit,3,boy,1,4,1.1104540924397509e-5
aakif,3,boy,0,3,8.328405693298133e-6
aanay,3,boy,0,3,8.328405693298133e-6
aaraf,3,boy,0,3,8.328405693298133e-6
aaron-james,3,boy,0,3,8.328405693298133e-6
aaronas,3,boy,0,3,8.328405693298133e-6
aarun,3,boy,0,3,8.328405693298133e-6
aashir,3,boy,0,3,8.328405693298133e-6
aayden,3,boy,1,4,1.1104540924397509e-5
aazil,3,boy,0,3,8.328405693298133e-6
aban,3,boy,0,3,8.328405693298133e-6
abass,3,boy,0,3,8.328405693298133e-6
abd,3,boy,0,3,8.328405693298133e-6
abdel,3,boy,0,3,8.328405693298133e-6
abdelaziz,3,boy,0,3,8.328405693298133e-6
abdellah,3,boy,0,3,8.328405693298133e-6
abdirahim,3,boy,0,3,8.328405693298133e-6
abdoulaye,3,boy,0,3,8.328405693298133e-6
abdrahman,3,boy,0,3,8.328405693298133e-6
abdu,3,boy,0,3,8.328405693298133e-6
abdul-wadood,3,boy,0,3,8.328405693298133e-6
abdulbasit,3,boy,0,3,8.328405693298133e-6
abdulhaadi,3,boy,2,5,1.3880676155496887e-5
abdulhamid,3,boy,0,3,8.328405693298133e-6
abduljabbar,3,boy,0,3,8.328405693298133e-6
abdulkarim,3,boy,0,3,8.328405693298133e-6
abdulmuizz,3,boy,0,3,8.328405693298133e-6
abdulqadir,3,boy,0,3,8.328405693298133e-6
abdulrahim,3,boy,0,3,8.328405693298133e-6
abdulsalam,3,boy,1,4,1.1104540924397509e-5
abdur-rehman,3,boy,0,3,8.328405693298133e-6
abhiraj,3,boy,0,3,8.328405693298133e-6
acey,3,boy,0,3,8.328405693298133e-6
achille,3,boy,0,3,8.328405693298133e-6
achilleas,3,boy,0,3,8.328405693298133e-6
adal,3,boy,0,3,8.328405693298133e-6
adama,3,boy,0,3,8.328405693298133e-6
adedamola,3,boy,0,3,8.328405693298133e-6
adeem,3,boy,0,3,8.328405693298133e-6
adelin,3,boy,0,3,8.328405693298133e-6
ademide,3,boy,0,3,8.328405693298133e-6
adetayo,3,boy,0,3,8.328405693298133e-6
adham,3,boy,0,3,8.328405693298133e-6
adin,3,boy,0,3,8.328405693298133e-6
adler,3,boy,0,3,8.328405693298133e-6
adley,3,boy,0,3,8.328405693298133e-6
adriano,3,boy,1,4,1.1104540924397509e-5
advit,3,boy,0,3,8.328405693298133e-6
aeden,3,boy,1,4,1.1104540924397509e-5
aengus,3,boy,0,3,8.328405693298133e-6
affaan,3,boy,0,3,8.328405693298133e-6
agamdeep,3,boy,0,3,8.328405693298133e-6
agrim,3,boy,0,3,8.328405693298133e-6
aidaan,3,boy,0,3,8.328405693298133e-6
aijaz,3,boy,0,3,8.328405693298133e-6
aime,3,boy,0,3,8.328405693298133e-6
ajax,3,boy,0,3,8.328405693298133e-6
ajibola,3,boy,0,3,8.328405693298133e-6
akain,3,boy,0,3,8.328405693298133e-6
akashdeep,3,boy,0,3,8.328405693298133e-6
akbar,3,boy,0,3,8.328405693298133e-6
akber,3,boy,0,3,8.328405693298133e-6
akito,3,boy,0,3,8.328405693298133e-6
aksayan,3,boy,0,3,8.328405693298133e-6
al-ameen,3,boy,0,3,8.328405693298133e-6
al-amin,3,boy,0,3,8.328405693298133e-6
alazar,3,boy,0,3,8.328405693298133e-6
albert-joe,3,boy,0,3,8.328405693298133e-6
albie-james,3,boy,0,3,8.328405693298133e-6
albie-jay,3,boy,0,3,8.328405693298133e-6
aldrin,3,boy,0,3,8.328405693298133e-6
aldwin,3,boy,0,3,8.328405693298133e-6
alesio,3,boy,0,3,8.328405693298133e-6
alex-james,3,boy,0,3,8.328405693298133e-6
alexanda,3,boy,0,3,8.328405693298133e-6
alexandar,3,boy,0,3,8.328405693298133e-6
alexandro,3,boy,0,3,8.328405693298133e-6
alf,3,boy,0,3,8.328405693298133e-6
alfee,3,boy,0,3,8.328405693298133e-6
alfie-j,3,boy,0,3,8.328405693298133e-6
alfie-jai,3,boy,0,3,8.328405693298133e-6
alfie-paul,3,boy,0,3,8.328405693298133e-6
alfio,3,boy,0,3,8.328405693298133e-6
algernon,3,boy,0,3,8.328405693298133e-6
alieu,3,boy,0,3,8.328405693298133e-6
alix,3,boy,1,4,1.1104540924397509e-5
alonzo,3,boy,0,3,8.328405693298133e-6
alphie,3,boy,1,4,1.1104540924397509e-5
altair,3,boy,0,3,8.328405693298133e-6
alun,3,boy,0,3,8.328405693298133e-6
alwyn,3,boy,0,3,8.328405693298133e-6
amad,3,boy,1,4,1.1104540924397509e-5
amal,3,boy,0,3,8.328405693298133e-6
amani,3,boy,0,3,8.328405693298133e-6
amarii,3,boy,0,3,8.328405693298133e-6
amarni,3,boy,0,3,8.328405693298133e-6
amaru,3,boy,0,3,8.328405693298133e-6
amed,3,boy,0,3,8.328405693298133e-6
amiel,3,boy,0,3,8.328405693298133e-6
amit,3,boy,0,3,8.328405693298133e-6
amro,3,boy,0,3,8.328405693298133e-6
an,3,boy,0,3,8.328405693298133e-6
anashe,3,boy,0,3,8.328405693298133e-6
andrae,3,boy,0,3,8.328405693298133e-6
aness,3,boy,0,3,8.328405693298133e-6
angadveer,3,boy,0,3,8.328405693298133e-6
aniket,3,boy,0,3,8.328405693298133e-6
ankit,3,boy,0,3,8.328405693298133e-6
ankush,3,boy,0,3,8.328405693298133e-6
anoop,3,boy,0,3,8.328405693298133e-6
anshveer,3,boy,0,3,8.328405693298133e-6
antek,3,boy,0,3,8.328405693298133e-6
anthony-john,3,boy,0,3,8.328405693298133e-6
anthony-junior,3,boy,0,3,8.328405693298133e-6
antonie,3,boy,0,3,8.328405693298133e-6
antonin,3,boy,0,3,8.328405693298133e-6
anu,3,boy,0,3,8.328405693298133e-6
aqil,3,boy,0,3,8.328405693298133e-6
arayan,3,boy,0,3,8.328405693298133e-6
arbie,3,boy,0,3,8.328405693298133e-6
archie-jack,3,boy,1,4,1.1104540924397509e-5
archie-john,3,boy,2,5,1.3880676155496887e-5
ardan,3,boy,0,3,8.328405693298133e-6
arees,3,boy,0,3,8.328405693298133e-6
aretas,3,boy,0,3,8.328405693298133e-6
arez,3,boy,0,3,8.328405693298133e-6
arihan,3,boy,0,3,8.328405693298133e-6
arinzechukwu,3,boy,0,3,8.328405693298133e-6
ariyo,3,boy,0,3,8.328405693298133e-6
arjuna,3,boy,0,3,8.328405693298133e-6
arli,3,boy,0,3,8.328405693298133e-6
arlo-jay,3,boy,0,3,8.328405693298133e-6
arry,3,boy,0,3,8.328405693298133e-6
arseniy,3,boy,0,3,8.328405693298133e-6
arshad,3,boy,0,3,8.328405693298133e-6
arthur-george,3,boy,0,3,8.328405693298133e-6
arthur-john,3,boy,0,3,8.328405693298133e-6
artyom,3,boy,0,3,8.328405693298133e-6
arush,3,boy,0,3,8.328405693298133e-6
arvind,3,boy,0,3,8.328405693298133e-6
asaiah,3,boy,0,3,8.328405693298133e-6
asaph,3,boy,0,3,8.328405693298133e-6
aseel,3,boy,0,3,8.328405693298133e-6
ashaan,3,boy,0,3,8.328405693298133e-6
ashal,3,boy,0,3,8.328405693298133e-6
ashan,3,boy,0,3,8.328405693298133e-6
ashby,3,boy,0,3,8.328405693298133e-6
ashden,3,boy,1,4,1.1104540924397509e-5
ashish,3,boy,0,3,8.328405693298133e-6
ashkan,3,boy,0,3,8.328405693298133e-6
ashlee,3,boy,0,3,8.328405693298133e-6
ashton-james,3,boy,0,3,8.328405693298133e-6
ashton-lee,3,boy,0,3,8.328405693298133e-6
ashveer,3,boy,0,3,8.328405693298133e-6
ashwyn,3,boy,0,3,8.328405693298133e-6
asier,3,boy,0,3,8.328405693298133e-6
asil,3,boy,0,3,8.328405693298133e-6
assim,3,boy,0,3,8.328405693298133e-6
atas,3,boy,0,3,8.328405693298133e-6
ateeb,3,boy,0,3,8.328405693298133e-6
athan,3,boy,0,3,8.328405693298133e-6
athanasios,3,boy,0,3,8.328405693298133e-6
athavan,3,boy,0,3,8.328405693298133e-6
audley,3,boy,0,3,8.328405693298133e-6
auguste,3,boy,0,3,8.328405693298133e-6
aurelio,3,boy,0,3,8.328405693298133e-6
aurelius,3,boy,0,3,8.328405693298133e-6
avan,3,boy,0,3,8.328405693298133e-6
aviel,3,boy,0,3,8.328405693298133e-6
avik,3,boy,0,3,8.328405693298133e-6
avinash,3,boy,0,3,8.328405693298133e-6
axton,3,boy,1,4,1.1104540924397509e-5
ayad,3,boy,0,3,8.328405693298133e-6
ayce,3,boy,0,3,8.328405693298133e-6
aymaan,3,boy,0,3,8.328405693298133e-6
ayyoub,3,boy,0,3,8.328405693298133e-6
azar,3,boy,0,3,8.328405693298133e-6
aziel,3,boy,0,3,8.328405693298133e-6
azil,3,boy,0,3,8.328405693298133e-6
azrael,3,boy,0,3,8.328405693298133e-6
azriel,3,boy,0,3,8.328405693298133e-6
azuolas,3,boy,0,3,8.328405693298133e-6
azyan,3,boy,0,3,8.328405693298133e-6
baboucarr,3,boy,1,4,1.1104540924397509e-5
baden,3,boy,0,3,8.328405693298133e-6
bailey-rae,3,boy,0,3,8.328405693298133e-6
baine,3,boy,0,3,8.328405693298133e-6
baker,3,boy,0,3,8.328405693298133e-6
balazs,3,boy,3,6,1.6656811386596265e-5
balint,3,boy,0,3,8.328405693298133e-6
baltazar,3,boy,0,3,8.328405693298133e-6
bane,3,boy,0,3,8.328405693298133e-6
baron,3,boy,0,3,8.328405693298133e-6
barsam,3,boy,0,3,8.328405693298133e-6
basile,3,boy,0,3,8.328405693298133e-6
basir,3,boy,0,3,8.328405693298133e-6
bayden,3,boy,0,3,8.328405693298133e-6
behrouz,3,boy,0,3,8.328405693298133e-6
behzad,3,boy,0,3,8.328405693298133e-6
believe,3,boy,0,3,8.328405693298133e-6
bendeguz,3,boy,0,3,8.328405693298133e-6
benediktas,3,boy,0,3,8.328405693298133e-6
benicio,3,boy,0,3,8.328405693298133e-6
benito,3,boy,0,3,8.328405693298133e-6
benoit,3,boy,0,3,8.328405693298133e-6
benyameen,3,boy,0,3,8.328405693298133e-6
beran,3,boy,0,3,8.328405693298133e-6
bereket,3,boy,0,3,8.328405693298133e-6
bertrand,3,boy,0,3,8.328405693298133e-6
berty,3,boy,0,3,8.328405693298133e-6
bhavesh,3,boy,0,3,8.328405693298133e-6
billal,3,boy,0,3,8.328405693298133e-6
billy-james,3,boy,0,3,8.328405693298133e-6
billy-john,3,boy,0,3,8.328405693298133e-6
billy-rae,3,boy,0,3,8.328405693298133e-6
billy-thomas,3,boy,0,3,8.328405693298133e-6
blakely,3,boy,0,3,8.328405693298133e-6
blayke,3,boy,1,4,1.1104540924397509e-5
blessed,3,boy,0,3,8.328405693298133e-6
bobby-john,3,boy,0,3,8.328405693298133e-6
bobby-paul,3,boy,0,3,8.328405693298133e-6
bogomil,3,boy,0,3,8.328405693298133e-6
bohan,3,boy,0,3,8.328405693298133e-6
bojidar,3,boy,0,3,8.328405693298133e-6
boril,3,boy,0,3,8.328405693298133e-6
bowden,3,boy,0,3,8.328405693298133e-6
bowe,3,boy,0,3,8.328405693298133e-6
bozhidar,3,boy,1,4,1.1104540924397509e-5
bradan,3,boy,1,4,1.1104540924397509e-5
bradlee,3,boy,0,3,8.328405693298133e-6
bradyn,3,boy,0,3,8.328405693298133e-6
brajen,3,boy,0,3,8.328405693298133e-6
bramwell,3,boy,0,3,8.328405693298133e-6
branden,3,boy,0,3,8.328405693298133e-6
brayson,3,boy,0,3,8.328405693298133e-6
breccan,3,boy,0,3,8.328405693298133e-6
brecon,3,boy,0,3,8.328405693298133e-6
brenden,3,boy,0,3,8.328405693298133e-6
brent,3,boy,0,3,8.328405693298133e-6
brodhi,3,boy,0,3,8.328405693298133e-6
bruk,3,boy,0,3,8.328405693298133e-6
brunon,3,boy,0,3,8.328405693298133e-6
burt,3,boy,0,3,8.328405693298133e-6
caerwyn,3,boy,0,3,8.328405693298133e-6
calon,3,boy,0,3,8.328405693298133e-6
cameron-james,3,boy,0,3,8.328405693298133e-6
camille,3,boy,0,3,8.328405693298133e-6
camilo,3,boy,0,3,8.328405693298133e-6
carey,3,boy,0,3,8.328405693298133e-6
carrick,3,boy,6,9,2.4985217079894396e-5
casey-lee,3,boy,0,3,8.328405693298133e-6
cathal,3,boy,2,5,1.3880676155496887e-5
cauley,3,boy,0,3,8.328405693298133e-6
cavell,3,boy,0,3,8.328405693298133e-6
cecil,3,boy,0,3,8.328405693298133e-6
chadley,3,boy,0,3,8.328405693298133e-6
chandler,3,boy,0,3,8.328405693298133e-6
charlie-jack,3,boy,0,3,8.328405693298133e-6
charlie-lee,3,boy,0,3,8.328405693298133e-6
charlie-thomas,3,boy,0,3,8.328405693298133e-6
charvik,3,boy,0,3,8.328405693298133e-6
chayton,3,boy,0,3,8.328405693298133e-6
chet,3,boy,0,3,8.328405693298133e-6
chevy,3,boy,0,3,8.328405693298133e-6
chi,3,boy,0,3,8.328405693298133e-6
chibueze,3,boy,0,3,8.328405693298133e-6
chibuikem,3,boy,0,3,8.328405693298133e-6
chidera,3,boy,0,3,8.328405693298133e-6
chiemeka,3,boy,0,3,8.328405693298133e-6
chikamso,3,boy,0,3,8.328405693298133e-6
chima,3,boy,0,3,8.328405693298133e-6
chirag,3,boy,1,4,1.1104540924397509e-5
chukwudi,3,boy,0,3,8.328405693298133e-6
chukwunonso,3,boy,0,3,8.328405693298133e-6
ciro,3,boy,0,3,8.328405693298133e-6
cleon,3,boy,0,3,8.328405693298133e-6
clive,3,boy,0,3,8.328405693298133e-6
coady,3,boy,0,3,8.328405693298133e-6
coby-jay,3,boy,0,3,8.328405693298133e-6
coda,3,boy,0,3,8.328405693298133e-6
cole-james,3,boy,0,3,8.328405693298133e-6
coleton,3,boy,2,5,1.3880676155496887e-5
coley,3,boy,0,3,8.328405693298133e-6
connell,3,boy,2,5,1.3880676155496887e-5
connor-james,3,boy,0,3,8.328405693298133e-6
connor-lee,3,boy,0,3,8.328405693298133e-6
conran,3,boy,1,4,1.1104540924397509e-5
conroy,3,boy,0,3,8.328405693298133e-6
cooper-james,3,boy,0,3,8.328405693298133e-6
corey-james,3,boy,0,3,8.328405693298133e-6
corey-jay,3,boy,0,3,8.328405693298133e-6
corey-lee,3,boy,0,3,8.328405693298133e-6
cosmin,3,boy,1,4,1.1104540924397509e-5
covey,3,boy,0,3,8.328405693298133e-6
craig-junior,3,boy,0,3,8.328405693298133e-6
crue,3,boy,0,3,8.328405693298133e-6
csongor,3,boy,1,4,1.1104540924397509e-5
cuan,3,boy,2,5,1.3880676155496887e-5
cuban,3,boy,0,3,8.328405693298133e-6
cuinn,3,boy,0,3,8.328405693298133e-6
daan,3,boy,0,3,8.328405693298133e-6
dachi,3,boy,1,4,1.1104540924397509e-5
dahir,3,boy,0,3,8.328405693298133e-6
daichi,3,boy,0,3,8.328405693298133e-6
daiton,3,boy,0,3,8.328405693298133e-6
dalha,3,boy,0,3,8.328405693298133e-6
danielis,3,boy,1,4,1.1104540924397509e-5
danil,3,boy,2,5,1.3880676155496887e-5
danniel,3,boy,0,3,8.328405693298133e-6
danny-james,3,boy,0,3,8.328405693298133e-6
danujan,3,boy,0,3,8.328405693298133e-6
danut,3,boy,0,3,8.328405693298133e-6
danyar,3,boy,0,3,8.328405693298133e-6
darshik,3,boy,0,3,8.328405693298133e-6
daryus,3,boy,0,3,8.328405693298133e-6
david-junior,3,boy,0,3,8.328405693298133e-6
davit,3,boy,0,3,8.328405693298133e-6
dayal,3,boy,0,3,8.328405693298133e-6
dayan,3,boy,0,3,8.328405693298133e-6
de,3,boy,0,3,8.328405693298133e-6
deacon-james,3,boy,0,3,8.328405693298133e-6
deandre,3,boy,0,3,8.328405693298133e-6
deiniol,3,boy,0,3,8.328405693298133e-6
dejan,3,boy,0,3,8.328405693298133e-6
delan,3,boy,0,3,8.328405693298133e-6
delight,3,boy,0,3,8.328405693298133e-6
demian,3,boy,0,3,8.328405693298133e-6
denislav,3,boy,1,4,1.1104540924397509e-5
deniss,3,boy,0,3,8.328405693298133e-6
deo,3,boy,0,3,8.328405693298133e-6
deondre,3,boy,0,3,8.328405693298133e-6
derick,3,boy,0,3,8.328405693298133e-6
derin,3,boy,1,4,1.1104540924397509e-5
deuel,3,boy,0,3,8.328405693298133e-6
devaansh,3,boy,0,3,8.328405693298133e-6
devam,3,boy,0,3,8.328405693298133e-6
devrim,3,boy,0,3,8.328405693298133e-6
dhani,3,boy,0,3,8.328405693298133e-6
dhanveer,3,boy,0,3,8.328405693298133e-6
dheer,3,boy,0,3,8.328405693298133e-6
dheeran,3,boy,0,3,8.328405693298133e-6
dhevan,3,boy,0,3,8.328405693298133e-6
dhillan,3,boy,0,3,8.328405693298133e-6
dhyaan,3,boy,0,3,8.328405693298133e-6
diamond,3,boy,1,4,1.1104540924397509e-5
didar,3,boy,0,3,8.328405693298133e-6
didier,3,boy,0,3,8.328405693298133e-6
digory,3,boy,0,3,8.328405693298133e-6
dilawar,3,boy,0,3,8.328405693298133e-6
dionte,3,boy,0,3,8.328405693298133e-6
diyaan,3,boy,0,3,8.328405693298133e-6
diyari,3,boy,0,3,8.328405693298133e-6
dmytro,3,boy,0,3,8.328405693298133e-6
domenic,3,boy,0,3,8.328405693298133e-6
don,3,boy,1,4,1.1104540924397509e-5
donnacha,3,boy,1,4,1.1104540924397509e-5
dontay,3,boy,0,3,8.328405693298133e-6
doran,3,boy,0,3,8.328405693298133e-6
dougal,3,boy,2,5,1.3880676155496887e-5
drue,3,boy,0,3,8.328405693298133e-6
drummond,3,boy,1,4,1.1104540924397509e-5
dumitru,3,boy,0,3,8.328405693298133e-6
duriel,3,boy,0,3,8.328405693298133e-6
dusty,3,boy,0,3,8.328405693298133e-6
dwight,3,boy,0,3,8.328405693298133e-6
dziugas,3,boy,0,3,8.328405693298133e-6
earl,3,boy,0,3,8.328405693298133e-6
eathan,3,boy,0,3,8.328405693298133e-6
ebben,3,boy,0,3,8.328405693298133e-6
ebraheem,3,boy,0,3,8.328405693298133e-6
edas,3,boy,0,3,8.328405693298133e-6
edem,3,boy,0,3,8.328405693298133e-6
eden-james,3,boy,0,3,8.328405693298133e-6
edgaras,3,boy,0,3,8.328405693298133e-6
edi,3,boy,0,3,8.328405693298133e-6
edric,3,boy,0,3,8.328405693298133e-6
edson,3,boy,0,3,8.328405693298133e-6
eduards,3,boy,0,3,8.328405693298133e-6
edvards,3,boy,0,3,8.328405693298133e-6
edward-james,3,boy,0,3,8.328405693298133e-6
edy,3,boy,0,3,8.328405693298133e-6
eeqan,3,boy,0,3,8.328405693298133e-6
eeshan,3,boy,0,3,8.328405693298133e-6
efosa,3,boy,2,5,1.3880676155496887e-5
efren,3,boy,0,3,8.328405693298133e-6
egor,3,boy,0,3,8.328405693298133e-6
eid,3,boy,0,3,8.328405693298133e-6
eidanas,3,boy,0,3,8.328405693298133e-6
eiji,3,boy,0,3,8.328405693298133e-6
eirik,3,boy,1,4,1.1104540924397509e-5
eissa,3,boy,0,3,8.328405693298133e-6
eita,3,boy,0,3,8.328405693298133e-6
eithan,3,boy,0,3,8.328405693298133e-6
eivin,3,boy,0,3,8.328405693298133e-6
ektor,3,boy,0,3,8.328405693298133e-6
el,3,boy,1,4,1.1104540924397509e-5
elchonon,3,boy,0,3,8.328405693298133e-6
eldi,3,boy,0,3,8.328405693298133e-6
elhadj,3,boy,0,3,8.328405693298133e-6
elia,3,boy,0,3,8.328405693298133e-6
eliakim,3,boy,0,3,8.328405693298133e-6
eliam,3,boy,1,4,1.1104540924397509e-5
elih,3,boy,0,3,8.328405693298133e-6
elijas,3,boy,0,3,8.328405693298133e-6
elios,3,boy,0,3,8.328405693298133e-6
eliud,3,boy,0,3,8.328405693298133e-6
eliyah,3,boy,1,4,1.1104540924397509e-5
elkanah,3,boy,0,3,8.328405693298133e-6
elliott-james,3,boy,0,3,8.328405693298133e-6
elyon,3,boy,0,3,8.328405693298133e-6
eman,3,boy,0,3,8.328405693298133e-6
emery,3,boy,0,3,8.328405693298133e-6
emmanouil,3,boy,0,3,8.328405693298133e-6
endeavour,3,boy,0,3,8.328405693298133e-6
enric,3,boy,0,3,8.328405693298133e-6
eran,3,boy,0,3,8.328405693298133e-6
erdi,3,boy,0,3,8.328405693298133e-6
ergi,3,boy,0,3,8.328405693298133e-6
erhan,3,boy,0,3,8.328405693298133e-6
ermis,3,boy,0,3,8.328405693298133e-6
eromosele,3,boy,0,3,8.328405693298133e-6
ertugrul,3,boy,0,3,8.328405693298133e-6
erwan,3,boy,0,3,8.328405693298133e-6
erwin,3,boy,1,4,1.1104540924397509e-5
esam,3,boy,0,3,8.328405693298133e-6
eshwar,3,boy,0,3,8.328405693298133e-6
esmond,3,boy,0,3,8.328405693298133e-6
essey,3,boy,0,3,8.328405693298133e-6
ethan-jay,3,boy,0,3,8.328405693298133e-6
ethan-thomas,3,boy,0,3,8.328405693298133e-6
evaan,3,boy,0,3,8.328405693298133e-6
evans,3,boy,0,3,8.328405693298133e-6
everson,3,boy,0,3,8.328405693298133e-6
evyn,3,boy,0,3,8.328405693298133e-6
excellence,3,boy,0,3,8.328405693298133e-6
eyas,3,boy,0,3,8.328405693298133e-6
eytan,3,boy,0,3,8.328405693298133e-6
ezriel,3,boy,0,3,8.328405693298133e-6
fabrice,3,boy,0,3,8.328405693298133e-6
fabricio,3,boy,0,3,8.328405693298133e-6
fahed,3,boy,0,3,8.328405693298133e-6
farah,3,boy,0,3,8.328405693298133e-6
fardeen,3,boy,0,3,8.328405693298133e-6
farouk,3,boy,1,4,1.1104540924397509e-5
farouq,3,boy,0,3,8.328405693298133e-6
farrell,3,boy,0,3,8.328405693298133e-6
farren,3,boy,1,4,1.1104540924397509e-5
farris,3,boy,2,5,1.3880676155496887e-5
fauzan,3,boy,0,3,8.328405693298133e-6
fayaaz,3,boy,0,3,8.328405693298133e-6
fayaz,3,boy,0,3,8.328405693298133e-6
fernley,3,boy,0,3,8.328405693298133e-6
filipe,3,boy,0,3,8.328405693298133e-6
filippos,3,boy,0,3,8.328405693298133e-6
finton,3,boy,1,4,1.1104540924397509e-5
fiyinfoluwa,3,boy,0,3,8.328405693298133e-6
flinn,3,boy,1,4,1.1104540924397509e-5
flyn,3,boy,0,3,8.328405693298133e-6
forbes,3,boy,10,13,3.60897580042919e-5
foster,3,boy,1,4,1.1104540924397509e-5
foxx,3,boy,0,3,8.328405693298133e-6
franki,3,boy,1,4,1.1104540924397509e-5
freddie-dean,3,boy,0,3,8.328405693298133e-6
freddie-george,3,boy,0,3,8.328405693298133e-6
fredi,3,boy,0,3,8.328405693298133e-6
gabrielis,3,boy,0,3,8.328405693298133e-6
gad,3,boy,0,3,8.328405693298133e-6
gadiel,3,boy,0,3,8.328405693298133e-6
gaurav,3,boy,0,3,8.328405693298133e-6
gershon,3,boy,0,3,8.328405693298133e-6
ghazi,3,boy,0,3,8.328405693298133e-6
gilby,3,boy,0,3,8.328405693298133e-6
gioele,3,boy,0,3,8.328405693298133e-6
glen,3,boy,8,11,3.053748754209315e-5
godfred,3,boy,0,3,8.328405693298133e-6
godswill,3,boy,0,3,8.328405693298133e-6
grady,3,boy,0,3,8.328405693298133e-6
grae,3,boy,0,3,8.328405693298133e-6
grantas,3,boy,0,3,8.328405693298133e-6
griffyn,3,boy,0,3,8.328405693298133e-6
gryffin,3,boy,0,3,8.328405693298133e-6
gulam,3,boy,0,3,8.328405693298133e-6
guled,3,boy,0,3,8.328405693298133e-6
gurpartap,3,boy,0,3,8.328405693298133e-6
gurpreet,3,boy,0,3,8.328405693298133e-6
gurshaan,3,boy,0,3,8.328405693298133e-6
gwyn,3,boy,0,3,8.328405693298133e-6
haamid,3,boy,0,3,8.328405693298133e-6
haaziq,3,boy,0,3,8.328405693298133e-6
habibullah,3,boy,0,3,8.328405693298133e-6
hady,3,boy,0,3,8.328405693298133e-6
haile,3,boy,0,3,8.328405693298133e-6
haitham,3,boy,0,3,8.328405693298133e-6
hale,3,boy,0,3,8.328405693298133e-6
halen,3,boy,0,3,8.328405693298133e-6
hallam,3,boy,0,3,8.328405693298133e-6
hamim,3,boy,0,3,8.328405693298133e-6
hammam,3,boy,0,3,8.328405693298133e-6
haneef,3,boy,0,3,8.328405693298133e-6
hannan,3,boy,0,3,8.328405693298133e-6
hannes,3,boy,0,3,8.328405693298133e-6
hannibal,3,boy,0,3,8.328405693298133e-6
hansel,3,boy,0,3,8.328405693298133e-6
hansen,3,boy,0,3,8.328405693298133e-6
haran,3,boy,0,3,8.328405693298133e-6
harbour,3,boy,0,3,8.328405693298133e-6
harjas,3,boy,0,3,8.328405693298133e-6
harley-jack,3,boy,0,3,8.328405693298133e-6
harli,3,boy,0,3,8.328405693298133e-6
harper-lee,3,boy,0,3,8.328405693298133e-6
harrison-james,3,boy,1,4,1.1104540924397509e-5
harry-john,3,boy,0,3,8.328405693298133e-6
harry-lee,3,boy,0,3,8.328405693298133e-6
harsha,3,boy,0,3,8.328405693298133e-6
harshil,3,boy,0,3,8.328405693298133e-6
harsimran,3,boy,0,3,8.328405693298133e-6
harvey-j,3,boy,0,3,8.328405693298133e-6
harvey-jack,3,boy,0,3,8.328405693298133e-6
harvey-joe,3,boy,0,3,8.328405693298133e-6
harvey-john,3,boy,1,4,1.1104540924397509e-5
haryad,3,boy,0,3,8.328405693298133e-6
hashaam,3,boy,0,3,8.328405693298133e-6
hassaan,3,boy,0,3,8.328405693298133e-6
hayan,3,boy,0,3,8.328405693298133e-6
hayat,3,boy,0,3,8.328405693298133e-6
hazeem,3,boy,0,3,8.328405693298133e-6
hazem,3,boy,0,3,8.328405693298133e-6
heathcliffe,3,boy,0,3,8.328405693298133e-6
heaven,3,boy,0,3,8.328405693298133e-6
hedd,3,boy,0,3,8.328405693298133e-6
hemi,3,boy,0,3,8.328405693298133e-6
henderson,3,boy,0,3,8.328405693298133e-6
hendrick,3,boy,1,4,1.1104540924397509e-5
henok,3,boy,0,3,8.328405693298133e-6
henry-george,3,boy,0,3,8.328405693298133e-6
hermes,3,boy,0,3,8.328405693298133e-6
hesam,3,boy,0,3,8.328405693298133e-6
himat,3,boy,0,3,8.328405693298133e-6
ho,3,boy,0,3,8.328405693298133e-6
hossam,3,boy,0,3,8.328405693298133e-6
hossein,3,boy,0,3,8.328405693298133e-6
hriday,3,boy,1,4,1.1104540924397509e-5
hridhaan,3,boy,0,3,8.328405693298133e-6
hrihaan,3,boy,0,3,8.328405693298133e-6
hudayfa,3,boy,0,3,8.328405693298133e-6
hudayfah,3,boy,0,3,8.328405693298133e-6
hudeyfa,3,boy,0,3,8.328405693298133e-6
hudhaifa,3,boy,0,3,8.328405693298133e-6
hudhaifah,3,boy,0,3,8.328405693298133e-6
hukam,3,boy,0,3,8.328405693298133e-6
hunain,3,boy,0,3,8.328405693298133e-6
hunter-lee,3,boy,0,3,8.328405693298133e-6
huntley,3,boy,0,3,8.328405693298133e-6
hurr,3,boy,0,3,8.328405693298133e-6
huzayfa,3,boy,0,3,8.328405693298133e-6
iacopo,3,boy,0,3,8.328405693298133e-6
ian-junior,3,boy,0,3,8.328405693298133e-6
ibad,3,boy,0,3,8.328405693298133e-6
ibrahem,3,boy,0,3,8.328405693298133e-6
ibrar,3,boy,0,3,8.328405693298133e-6
ibukunoluwa,3,boy,0,3,8.328405693298133e-6
idan,3,boy,0,3,8.328405693298133e-6
iden,3,boy,0,3,8.328405693298133e-6
ifeanyichukwu,3,boy,1,4,1.1104540924397509e-5
ike,3,boy,2,5,1.3880676155496887e-5
ilay,3,boy,0,3,8.328405693298133e-6
ilhan,3,boy,0,3,8.328405693298133e-6
iliya,3,boy,0,3,8.328405693298133e-6
ilkay,3,boy,0,3,8.328405693298133e-6
illya,3,boy,0,3,8.328405693298133e-6
ilyan,3,boy,1,4,1.1104540924397509e-5
inder,3,boy,0,3,8.328405693298133e-6
ionel,3,boy,0,3,8.328405693298133e-6
iremide,3,boy,0,3,8.328405693298133e-6
ireoluwatomiwa,3,boy,0,3,8.328405693298133e-6
iroh,3,boy,0,3,8.328405693298133e-6
is'haq,3,boy,0,3,8.328405693298133e-6
isaa,3,boy,0,3,8.328405693298133e-6
isaac-jay,3,boy,0,3,8.328405693298133e-6
isacc,3,boy,0,3,8.328405693298133e-6
isma'il,3,boy,0,3,8.328405693298133e-6
ismaael,3,boy,0,3,8.328405693298133e-6
issak,3,boy,0,3,8.328405693298133e-6
ivaylo,3,boy,0,3,8.328405693298133e-6
iven,3,boy,0,3,8.328405693298133e-6
iwinosa,3,boy,0,3,8.328405693298133e-6
iyaaz,3,boy,0,3,8.328405693298133e-6
iyan,3,boy,1,4,1.1104540924397509e-5
izacc,3,boy,0,3,8.328405693298133e-6
izack,3,boy,0,3,8.328405693298133e-6
izan,3,boy,0,3,8.328405693298133e-6
izeyah,3,boy,0,3,8.328405693298133e-6
izhaan,3,boy,0,3,8.328405693298133e-6
izyaan,3,boy,1,4,1.1104540924397509e-5
jabril,3,boy,0,3,8.328405693298133e-6
jacob-joe,3,boy,0,3,8.328405693298133e-6
jacob-john,3,boy,0,3,8.328405693298133e-6
jacobi,3,boy,0,3,8.328405693298133e-6
jagger,3,boy,0,3,8.328405693298133e-6
jagnoor,3,boy,0,3,8.328405693298133e-6
jagraj,3,boy,0,3,8.328405693298133e-6
jahaziel,3,boy,0,3,8.328405693298133e-6
jahdel,3,boy,0,3,8.328405693298133e-6
jahid,3,boy,0,3,8.328405693298133e-6
jahmal,3,boy,0,3,8.328405693298133e-6
jahmel,3,boy,0,3,8.328405693298133e-6
jahmoy,3,boy,0,3,8.328405693298133e-6
james-anthony,3,boy,0,3,8.328405693298133e-6
james-dean,3,boy,0,3,8.328405693298133e-6
janek,3,boy,1,4,1.1104540924397509e-5
japman,3,boy,0,3,8.328405693298133e-6
jareth,3,boy,0,3,8.328405693298133e-6
jarryd,3,boy,0,3,8.328405693298133e-6
jasdeep,3,boy,0,3,8.328405693298133e-6
jash,3,boy,0,3,8.328405693298133e-6
jasiah,3,boy,0,3,8.328405693298133e-6
jaskaran,3,boy,0,3,8.328405693298133e-6
jasman,3,boy,0,3,8.328405693298133e-6
jason-junior,3,boy,0,3,8.328405693298133e-6
jaspar,3,boy,0,3,8.328405693298133e-6
jaspreet,3,boy,0,3,8.328405693298133e-6
jassim,3,boy,0,3,8.328405693298133e-6
jawaad,3,boy,0,3,8.328405693298133e-6
jaxson-jay,3,boy,0,3,8.328405693298133e-6
jaxson-lee,3,boy,0,3,8.328405693298133e-6
jayanth,3,boy,0,3,8.328405693298133e-6
jaycub,3,boy,0,3,8.328405693298133e-6
jayden-jay,3,boy,0,3,8.328405693298133e-6
jayden-leigh,3,boy,0,3,8.328405693298133e-6
jaye,3,boy,2,5,1.3880676155496887e-5
jaykob,3,boy,0,3,8.328405693298133e-6
jaymin,3,boy,0,3,8.328405693298133e-6
jayraj,3,boy,0,3,8.328405693298133e-6
jayse,3,boy,1,4,1.1104540924397509e-5
jazaiah,3,boy,0,3,8.328405693298133e-6
jedd,3,boy,1,4,1.1104540924397509e-5
jeevansh,3,boy,0,3,8.328405693298133e-6
jensen-james,3,boy,0,3,8.328405693298133e-6
jenson-john,3,boy,0,3,8.328405693298133e-6
jenson-joseph,3,boy,0,3,8.328405693298133e-6
jesaiah,3,boy,0,3,8.328405693298133e-6
jeshurun,3,boy,0,3,8.328405693298133e-6
jesse-lee,3,boy,0,3,8.328405693298133e-6
jeston,3,boy,0,3,8.328405693298133e-6
jian,3,boy,0,3,8.328405693298133e-6
jibrael,3,boy,0,3,8.328405693298133e-6
jimmy-dean,3,boy,0,3,8.328405693298133e-6
jimmy-james,3,boy,0,3,8.328405693298133e-6
jimmy-ray,3,boy,0,3,8.328405693298133e-6
jing,3,boy,0,3,8.328405693298133e-6
jiraiya,3,boy,0,3,8.328405693298133e-6
jireh,3,boy,0,3,8.328405693298133e-6
jivan,3,boy,0,3,8.328405693298133e-6
jo,3,boy,0,3,8.328405693298133e-6
joben,3,boy,0,3,8.328405693298133e-6
jobey,3,boy,0,3,8.328405693298133e-6
jobi,3,boy,0,3,8.328405693298133e-6
joeseph,3,boy,0,3,8.328405693298133e-6
john-boy,3,boy,0,3,8.328405693298133e-6
john-henry,3,boy,0,3,8.328405693298133e-6
johny,3,boy,0,3,8.328405693298133e-6
jolyon,3,boy,0,3,8.328405693298133e-6
jon-paul,3,boy,0,3,8.328405693298133e-6
jools,3,boy,0,3,8.328405693298133e-6
jordy,3,boy,0,3,8.328405693298133e-6
jorgie,3,boy,0,3,8.328405693298133e-6
jori,3,boy,0,3,8.328405693298133e-6
joseph-john,3,boy,0,3,8.328405693298133e-6
joseph-junior,3,boy,0,3,8.328405693298133e-6
joshuah,3,boy,1,4,1.1104540924397509e-5
jud,3,boy,0,3,8.328405693298133e-6
jugaad,3,boy,0,3,8.328405693298133e-6
jugraj,3,boy,0,3,8.328405693298133e-6
juma,3,boy,0,3,8.328405693298133e-6
junkai,3,boy,0,3,8.328405693298133e-6
justus,3,boy,0,3,8.328405693298133e-6
kabel,3,boy,0,3,8.328405693298133e-6
kaelem,3,boy,0,3,8.328405693298133e-6
kaenan,3,boy,0,3,8.328405693298133e-6
kagan,3,boy,0,3,8.328405693298133e-6
kaidon,3,boy,0,3,8.328405693298133e-6
kaien,3,boy,0,3,8.328405693298133e-6
kaii,3,boy,1,4,1.1104540924397509e-5
kainan,3,boy,0,3,8.328405693298133e-6
kairan,3,boy,0,3,8.328405693298133e-6
kaiyaan,3,boy,0,3,8.328405693298133e-6
kaiyon,3,boy,0,3,8.328405693298133e-6
kalan,3,boy,0,3,8.328405693298133e-6
kalil,3,boy,0,3,8.328405693298133e-6
kalin,3,boy,0,3,8.328405693298133e-6
kalman,3,boy,0,3,8.328405693298133e-6
kalub,3,boy,0,3,8.328405693298133e-6
kalum,3,boy,0,3,8.328405693298133e-6
kamar,3,boy,0,3,8.328405693298133e-6
kamarni,3,boy,0,3,8.328405693298133e-6
kamau,3,boy,0,3,8.328405693298133e-6
kanan,3,boy,0,3,8.328405693298133e-6
karanvir,3,boy,0,3,8.328405693298133e-6
kardin,3,boy,0,3,8.328405693298133e-6
karel,3,boy,0,3,8.328405693298133e-6
kasparas,3,boy,0,3,8.328405693298133e-6
kavalli,3,boy,0,3,8.328405693298133e-6
kayde,3,boy,1,4,1.1104540924397509e-5
kayden-jay,3,boy,0,3,8.328405693298133e-6
kayson-james,3,boy,0,3,8.328405693298133e-6
kayvan,3,boy,0,3,8.328405693298133e-6
kayyan,3,boy,0,3,8.328405693298133e-6
kaziah,3,boy,0,3,8.328405693298133e-6
kebba,3,boy,0,3,8.328405693298133e-6
keelen,3,boy,0,3,8.328405693298133e-6
keita,3,boy,0,3,8.328405693298133e-6
kendall,3,boy,0,3,8.328405693298133e-6
keston,3,boy,0,3,8.328405693298133e-6
kevan,3,boy,0,3,8.328405693298133e-6
khadim,3,boy,0,3,8.328405693298133e-6
khalel,3,boy,0,3,8.328405693298133e-6
khang,3,boy,0,3,8.328405693298133e-6
khaqan,3,boy,1,4,1.1104540924397509e-5
khodi,3,boy,0,3,8.328405693298133e-6
khyan,3,boy,0,3,8.328405693298133e-6
kia,3,boy,0,3,8.328405693298133e-6
kiarash,3,boy,0,3,8.328405693298133e-6
kiedis,3,boy,0,3,8.328405693298133e-6
kieon,3,boy,0,3,8.328405693298133e-6
kimani,3,boy,0,3,8.328405693298133e-6
kinaan,3,boy,0,3,8.328405693298133e-6
kinsley,3,boy,0,3,8.328405693298133e-6
kipp,3,boy,0,3,8.328405693298133e-6
kirills,3,boy,0,3,8.328405693298133e-6
klaus,3,boy,0,3,8.328405693298133e-6
kleart,3,boy,0,3,8.328405693298133e-6
koan,3,boy,0,3,8.328405693298133e-6
koban,3,boy,0,3,8.328405693298133e-6
kobyn,3,boy,1,4,1.1104540924397509e-5
kohan,3,boy,2,5,1.3880676155496887e-5
koi,3,boy,0,3,8.328405693298133e-6
kolbie,3,boy,0,3,8.328405693298133e-6
konnor,3,boy,1,4,1.1104540924397509e-5
kooper,3,boy,1,4,1.1104540924397509e-5
korbin,3,boy,0,3,8.328405693298133e-6
korey-lee,3,boy,0,3,8.328405693298133e-6
kosta,3,boy,0,3,8.328405693298133e-6
krasimir,3,boy,0,3,8.328405693298133e-6
kristaps,3,boy,0,3,8.328405693298133e-6
krisztian,3,boy,0,3,8.328405693298133e-6
kumail,3,boy,0,3,8.328405693298133e-6
kunal,3,boy,0,3,8.328405693298133e-6
kushal,3,boy,0,3,8.328405693298133e-6
kwadwo,3,boy,0,3,8.328405693298133e-6
kyaan,3,boy,0,3,8.328405693298133e-6
kyle-junior,3,boy,0,3,8.328405693298133e-6
kylon,3,boy,0,3,8.328405693298133e-6
kyran-james,3,boy,0,3,8.328405693298133e-6
kyree,3,boy,0,3,8.328405693298133e-6
labib,3,boy,0,3,8.328405693298133e-6
lachezar,3,boy,0,3,8.328405693298133e-6
laighton,3,boy,0,3,8.328405693298133e-6
lakhan,3,boy,0,3,8.328405693298133e-6
lakshan,3,boy,0,3,8.328405693298133e-6
lakshya,3,boy,1,4,1.1104540924397509e-5
lamont,3,boy,0,3,8.328405693298133e-6
lando,3,boy,0,3,8.328405693298133e-6
larenz,3,boy,0,3,8.328405693298133e-6
lavell,3,boy,0,3,8.328405693298133e-6
lawee,3,boy,0,3,8.328405693298133e-6
lawin,3,boy,0,3,8.328405693298133e-6
lawy,3,boy,1,4,1.1104540924397509e-5
layad,3,boy,0,3,8.328405693298133e-6
laylan,3,boy,0,3,8.328405693298133e-6
layson,3,boy,0,3,8.328405693298133e-6
layton-jay,3,boy,0,3,8.328405693298133e-6
layton-lee,3,boy,0,3,8.328405693298133e-6
lazar,3,boy,0,3,8.328405693298133e-6
lazarus,3,boy,0,3,8.328405693298133e-6
lazer,3,boy,0,3,8.328405693298133e-6
leart,3,boy,0,3,8.328405693298133e-6
ledley,3,boy,0,3,8.328405693298133e-6
lee-junior,3,boy,0,3,8.328405693298133e-6
lei,3,boy,0,3,8.328405693298133e-6
leighland,3,boy,0,3,8.328405693298133e-6
lenny-joe,3,boy,0,3,8.328405693298133e-6
leonardas,3,boy,0,3,8.328405693298133e-6
leonas,3,boy,0,3,8.328405693298133e-6
leonid,3,boy,0,3,8.328405693298133e-6
leonis,3,boy,0,3,8.328405693298133e-6
levan,3,boy,0,3,8.328405693298133e-6
levin,3,boy,0,3,8.328405693298133e-6
levy,3,boy,0,3,8.328405693298133e-6
lewan,3,boy,0,3,8.328405693298133e-6
lewen,3,boy,0,3,8.328405693298133e-6
liban,3,boy,0,3,8.328405693298133e-6
liev,3,boy,0,3,8.328405693298133e-6
lin,3,boy,0,3,8.328405693298133e-6
linas,3,boy,0,3,8.328405693298133e-6
linkin,3,boy,0,3,8.328405693298133e-6
lir,3,boy,0,3,8.328405693298133e-6
lj,3,boy,0,3,8.328405693298133e-6
ljay,3,boy,1,4,1.1104540924397509e-5
loay,3,boy,0,3,8.328405693298133e-6
lochlain,3,boy,1,4,1.1104540924397509e-5
lochlainn,3,boy,3,6,1.6656811386596265e-5
lochlyn,3,boy,5,8,2.2209081848795018e-5
locklen,3,boy,0,3,8.328405693298133e-6
logan-jack,3,boy,0,3,8.328405693298133e-6
lonan,3,boy,0,3,8.328405693298133e-6
lorand,3,boy,0,3,8.328405693298133e-6
lorien,3,boy,0,3,8.328405693298133e-6
lou,3,boy,0,3,8.328405693298133e-6
louey,3,boy,0,3,8.328405693298133e-6
louie-joe,3,boy,0,3,8.328405693298133e-6
luca-gabriel,3,boy,0,3,8.328405693298133e-6
luca-george,3,boy,0,3,8.328405693298133e-6
lucah,3,boy,0,3,8.328405693298133e-6
lucjan,3,boy,1,4,1.1104540924397509e-5
lukah,3,boy,0,3,8.328405693298133e-6
luke-junior,3,boy,0,3,8.328405693298133e-6
lux,3,boy,0,3,8.328405693298133e-6
lyncoln,3,boy,0,3,8.328405693298133e-6
lyncon,3,boy,0,3,8.328405693298133e-6
maan,3,boy,0,3,8.328405693298133e-6
mads,3,boy,1,4,1.1104540924397509e-5
madyan,3,boy,0,3,8.328405693298133e-6
magor,3,boy,0,3,8.328405693298133e-6
mahaan,3,boy,0,3,8.328405693298133e-6
mahammed,3,boy,0,3,8.328405693298133e-6
mahamud,3,boy,0,3,8.328405693298133e-6
mahan,3,boy,0,3,8.328405693298133e-6
maheer,3,boy,0,3,8.328405693298133e-6
mahomed,3,boy,0,3,8.328405693298133e-6
mahrez,3,boy,0,3,8.328405693298133e-6
maiwand,3,boy,0,3,8.328405693298133e-6
major,3,boy,0,3,8.328405693298133e-6
makaio,3,boy,0,3,8.328405693298133e-6
malachai,3,boy,1,4,1.1104540924397509e-5
malakhi,3,boy,0,3,8.328405693298133e-6
maliki,3,boy,0,3,8.328405693298133e-6
malique,3,boy,0,3,8.328405693298133e-6
malone,3,boy,0,3,8.328405693298133e-6
manasseh,3,boy,0,3,8.328405693298133e-6
maneet,3,boy,0,3,8.328405693298133e-6
manel,3,boy,0,3,8.328405693298133e-6
manfred,3,boy,0,3,8.328405693298133e-6
manni,3,boy,0,3,8.328405693298133e-6
mannix,3,boy,0,3,8.328405693298133e-6
manroop,3,boy,1,4,1.1104540924397509e-5
manson,3,boy,0,3,8.328405693298133e-6
mansour,3,boy,0,3,8.328405693298133e-6
manu,3,boy,0,3,8.328405693298133e-6
manvir,3,boy,0,3,8.328405693298133e-6
marat,3,boy,0,3,8.328405693298133e-6
markel,3,boy,0,3,8.328405693298133e-6
marlie,3,boy,0,3,8.328405693298133e-6
maros,3,boy,0,3,8.328405693298133e-6
marsel,3,boy,0,3,8.328405693298133e-6
martial,3,boy,0,3,8.328405693298133e-6
martyn,3,boy,1,4,1.1104540924397509e-5
marvellous,3,boy,0,3,8.328405693298133e-6
marvelous,3,boy,0,3,8.328405693298133e-6
maryo,3,boy,0,3,8.328405693298133e-6
mason-john,3,boy,0,3,8.328405693298133e-6
masoud,3,boy,0,3,8.328405693298133e-6
masud,3,boy,0,3,8.328405693298133e-6
matan,3,boy,0,3,8.328405693298133e-6
matej,3,boy,0,3,8.328405693298133e-6
matey,3,boy,0,3,8.328405693298133e-6
matis,3,boy,0,3,8.328405693298133e-6
mattheus,3,boy,0,3,8.328405693298133e-6
mawgan,3,boy,0,3,8.328405693298133e-6
mayank,3,boy,0,3,8.328405693298133e-6
mccauley,3,boy,0,3,8.328405693298133e-6
mckenzie-james,3,boy,0,3,8.328405693298133e-6
md.,3,boy,0,3,8.328405693298133e-6
mendel,3,boy,0,3,8.328405693298133e-6
merlyn,3,boy,0,3,8.328405693298133e-6
merrick,3,boy,0,3,8.328405693298133e-6
michael-john,3,boy,0,3,8.328405693298133e-6
michael-junior,3,boy,0,3,8.328405693298133e-6
michelangelo,3,boy,1,4,1.1104540924397509e-5
michele,3,boy,0,3,8.328405693298133e-6
midhun,3,boy,0,3,8.328405693298133e-6
mihaly,3,boy,0,3,8.328405693298133e-6
mikaal,3,boy,0,3,8.328405693298133e-6
mikayeel,3,boy,0,3,8.328405693298133e-6
millar,3,boy,7,10,2.7761352310993775e-5
mio,3,boy,0,3,8.328405693298133e-6
miraz,3,boy,0,3,8.328405693298133e-6
mirwais,3,boy,0,3,8.328405693298133e-6
mirzan,3,boy,0,3,8.328405693298133e-6
mishael,3,boy,0,3,8.328405693298133e-6
mitch,3,boy,4,7,1.943294661769564e-5
mitchel,3,boy,1,4,1.1104540924397509e-5
mivaan,3,boy,1,4,1.1104540924397509e-5
mizan,3,boy,0,3,8.328405693298133e-6
mo,3,boy,0,3,8.328405693298133e-6
mobeen,3,boy,0,3,8.328405693298133e-6
mohab,3,boy,0,3,8.328405693298133e-6
mohamedamin,3,boy,0,3,8.328405693298133e-6
mohammad-ibrahim,3,boy,0,3,8.328405693298133e-6
mohammed-ayaan,3,boy,0,3,8.328405693298133e-6
mohammed-hamza,3,boy,0,3,8.328405693298133e-6
mohammed-musa,3,boy,0,3,8.328405693298133e-6
mohammed-yusuf,3,boy,0,3,8.328405693298133e-6
mohib,3,boy,0,3,8.328405693298133e-6
mohit,3,boy,0,3,8.328405693298133e-6
moksh,3,boy,1,4,1.1104540924397509e-5
moncef,3,boy,0,3,8.328405693298133e-6
montagu,3,boy,0,3,8.328405693298133e-6
mordche,3,boy,0,3,8.328405693298133e-6
mordecai,3,boy,0,3,8.328405693298133e-6
mordechi,3,boy,0,3,8.328405693298133e-6
moritz,3,boy,0,3,8.328405693298133e-6
morley,3,boy,0,3,8.328405693298133e-6
mosey,3,boy,0,3,8.328405693298133e-6
mosiah,3,boy,0,3,8.328405693298133e-6
mouhamed,3,boy,0,3,8.328405693298133e-6
mourad,3,boy,0,3,8.328405693298133e-6
moustafa,3,boy,0,3,8.328405693298133e-6
moustapha,3,boy,0,3,8.328405693298133e-6
muayid,3,boy,0,3,8.328405693298133e-6
mudasir,3,boy,1,4,1.1104540924397509e-5
muhaimin,3,boy,0,3,8.328405693298133e-6
muhamet,3,boy,0,3,8.328405693298133e-6
muhammad-adam,3,boy,0,3,8.328405693298133e-6
muhammad-deen,3,boy,0,3,8.328405693298133e-6
muhammad-hassaan,3,boy,0,3,8.328405693298133e-6
muhammad-hassan,3,boy,0,3,8.328405693298133e-6
muhammad-hussain,3,boy,0,3,8.328405693298133e-6
muhammad-ismaeel,3,boy,0,3,8.328405693298133e-6
muhammad-umar,3,boy,0,3,8.328405693298133e-6
muhammad-yousuf,3,boy,0,3,8.328405693298133e-6
muhammad-zakariyya,3,boy,0,3,8.328405693298133e-6
muhammed-ibrahim,3,boy,0,3,8.328405693298133e-6
muhammed-musa,3,boy,0,3,8.328405693298133e-6
muhammet,3,boy,0,3,8.328405693298133e-6
muhammod,3,boy,0,3,8.328405693298133e-6
muhib,3,boy,0,3,8.328405693298133e-6
mukarram,3,boy,0,3,8.328405693298133e-6
mukhtar,3,boy,0,3,8.328405693298133e-6
munashe,3,boy,0,3,8.328405693298133e-6
munawar,3,boy,0,3,8.328405693298133e-6
murdo,3,boy,10,13,3.60897580042919e-5
mustaqeem,3,boy,0,3,8.328405693298133e-6
mutasim,3,boy,0,3,8.328405693298133e-6
naail,3,boy,0,3,8.328405693298133e-6
nabhaan,3,boy,0,3,8.328405693298133e-6
naftali,3,boy,0,3,8.328405693298133e-6
naftuli,3,boy,0,3,8.328405693298133e-6
naiel,3,boy,0,3,8.328405693298133e-6
naitik,3,boy,0,3,8.328405693298133e-6
najeeb,3,boy,0,3,8.328405693298133e-6
nalan,3,boy,0,3,8.328405693298133e-6
nameer,3,boy,0,3,8.328405693298133e-6
naoise,3,boy,1,4,1.1104540924397509e-5
naphtali,3,boy,0,3,8.328405693298133e-6
naryan,3,boy,0,3,8.328405693298133e-6
nash,3,boy,0,3,8.328405693298133e-6
nasim,3,boy,0,3,8.328405693298133e-6
nasr,3,boy,0,3,8.328405693298133e-6
nasri,3,boy,0,3,8.328405693298133e-6
nathan-james,3,boy,0,3,8.328405693298133e-6
natnael,3,boy,0,3,8.328405693298133e-6
navin,3,boy,0,3,8.328405693298133e-6
nawfal,3,boy,0,3,8.328405693298133e-6
nayeem,3,boy,0,3,8.328405693298133e-6
nebi,3,boy,0,3,8.328405693298133e-6
neeko,3,boy,1,4,1.1104540924397509e-5
negan,3,boy,1,4,1.1104540924397509e-5
neilas,3,boy,0,3,8.328405693298133e-6
neitonas,3,boy,0,3,8.328405693298133e-6
neriah,3,boy,0,3,8.328405693298133e-6
nevin,3,boy,0,3,8.328405693298133e-6
neziah,3,boy,0,3,8.328405693298133e-6
nial,3,boy,0,3,8.328405693298133e-6
nian,3,boy,0,3,8.328405693298133e-6
niaz,3,boy,0,3,8.328405693298133e-6
nicky,3,boy,0,3,8.328405693298133e-6
nicola,3,boy,0,3,8.328405693298133e-6
nicos,3,boy,0,3,8.328405693298133e-6
nihan,3,boy,0,3,8.328405693298133e-6
nik,3,boy,0,3,8.328405693298133e-6
nikesh,3,boy,0,3,8.328405693298133e-6
nikko,3,boy,0,3,8.328405693298133e-6
niklas,3,boy,0,3,8.328405693298133e-6
nils,3,boy,0,3,8.328405693298133e-6
nirav,3,boy,1,4,1.1104540924397509e-5
nishant,3,boy,0,3,8.328405693298133e-6
nitya,3,boy,0,3,8.328405693298133e-6
niyaz,3,boy,0,3,8.328405693298133e-6
nizam,3,boy,0,3,8.328405693298133e-6
noah-george,3,boy,0,3,8.328405693298133e-6
noah-john,3,boy,0,3,8.328405693298133e-6
noan,3,boy,0,3,8.328405693298133e-6
nolen,3,boy,1,4,1.1104540924397509e-5
noraiz,3,boy,0,3,8.328405693298133e-6
norton,3,boy,0,3,8.328405693298133e-6
nosakhare,3,boy,0,3,8.328405693298133e-6
nosson,3,boy,0,3,8.328405693298133e-6
noyan,3,boy,1,4,1.1104540924397509e-5
nuaym,3,boy,0,3,8.328405693298133e-6
nur,3,boy,0,3,8.328405693298133e-6
oak,3,boy,1,4,1.1104540924397509e-5
oakleigh,3,boy,0,3,8.328405693298133e-6
oaklyn,3,boy,0,3,8.328405693298133e-6
obaloluwa,3,boy,0,3,8.328405693298133e-6
odysseus,3,boy,1,4,1.1104540924397509e-5
oghenebrume,3,boy,0,3,8.328405693298133e-6
oghenetega,3,boy,1,4,1.1104540924397509e-5
ohene,3,boy,0,3,8.328405693298133e-6
oktawian,3,boy,2,5,1.3880676155496887e-5
olan,3,boy,0,3,8.328405693298133e-6
olanrewaju,3,boy,0,3,8.328405693298133e-6
olaoluwakitan,3,boy,0,3,8.328405693298133e-6
olasubomi,3,boy,0,3,8.328405693298133e-6
oliver-lee,3,boy,0,3,8.328405693298133e-6
ollie-jai,3,boy,0,3,8.328405693298133e-6
olly-james,3,boy,0,3,8.328405693298133e-6
olti,3,boy,0,3,8.328405693298133e-6
olumide,3,boy,0,3,8.328405693298133e-6
oluwakayode,3,boy,0,3,8.328405693298133e-6
oluwasemilore,3,boy,0,3,8.328405693298133e-6
oluwaseun,3,boy,0,3,8.328405693298133e-6
omi,3,boy,0,3,8.328405693298133e-6
ondrej,3,boy,0,3,8.328405693298133e-6
onyedikachi,3,boy,0,3,8.328405693298133e-6
onyekachukwu,3,boy,0,3,8.328405693298133e-6
orges,3,boy,0,3,8.328405693298133e-6
orley,3,boy,0,3,8.328405693298133e-6
osian-lee,3,boy,0,3,8.328405693298133e-6
oslo,3,boy,0,3,8.328405693298133e-6
ossie,3,boy,0,3,8.328405693298133e-6
oswin,3,boy,0,3,8.328405693298133e-6
oszkar,3,boy,0,3,8.328405693298133e-6
owi,3,boy,0,3,8.328405693298133e-6
ozias,3,boy,0,3,8.328405693298133e-6
panav,3,boy,0,3,8.328405693298133e-6
parham,3,boy,0,3,8.328405693298133e-6
parin,3,boy,0,3,8.328405693298133e-6
patric,3,boy,0,3,8.328405693298133e-6
patricio,3,boy,0,3,8.328405693298133e-6
patriks,3,boy,1,4,1.1104540924397509e-5
pau,3,boy,0,3,8.328405693298133e-6
paulie,3,boy,0,3,8.328405693298133e-6
pavith,3,boy,0,3,8.328405693298133e-6
pavlos,3,boy,0,3,8.328405693298133e-6
pavol,3,boy,0,3,8.328405693298133e-6
pearce,3,boy,4,7,1.943294661769564e-5
pearse,3,boy,2,5,1.3880676155496887e-5
pete,3,boy,0,3,8.328405693298133e-6
pharez,3,boy,0,3,8.328405693298133e-6
prabhgun,3,boy,0,3,8.328405693298133e-6
prabhnoor,3,boy,0,3,8.328405693298133e-6
prabhveer,3,boy,0,3,8.328405693298133e-6
praneel,3,boy,0,3,8.328405693298133e-6
prateek,3,boy,0,3,8.328405693298133e-6
pravan,3,boy,0,3,8.328405693298133e-6
pravin,3,boy,0,3,8.328405693298133e-6
prayaag,3,boy,0,3,8.328405693298133e-6
prayag,3,boy,0,3,8.328405693298133e-6
precious,3,boy,0,3,8.328405693298133e-6
prehaan,3,boy,0,3,8.328405693298133e-6
qaim,3,boy,0,3,8.328405693298133e-6
quade,3,boy,1,4,1.1104540924397509e-5
quan,3,boy,0,3,8.328405693298133e-6
raahim,3,boy,0,3,8.328405693298133e-6
raam,3,boy,0,3,8.328405693298133e-6
radek,3,boy,0,3,8.328405693298133e-6
raeon,3,boy,0,3,8.328405693298133e-6
rafaele,3,boy,0,3,8.328405693298133e-6
raffy,3,boy,0,3,8.328405693298133e-6
rafiq,3,boy,0,3,8.328405693298133e-6
rahmel,3,boy,0,3,8.328405693298133e-6
raine,3,boy,0,3,8.328405693298133e-6
raiveer,3,boy,0,3,8.328405693298133e-6
raivo,3,boy,0,3,8.328405693298133e-6
raiyaan,3,boy,0,3,8.328405693298133e-6
rakai,3,boy,0,3,8.328405693298133e-6
raleigh,3,boy,0,3,8.328405693298133e-6
rameez,3,boy,0,3,8.328405693298133e-6
ramiro,3,boy,0,3,8.328405693298133e-6
ramiz,3,boy,0,3,8.328405693298133e-6
randall,3,boy,0,3,8.328405693298133e-6
ranell,3,boy,0,3,8.328405693298133e-6
ranulf,3,boy,0,3,8.328405693298133e-6
rao,3,boy,0,3,8.328405693298133e-6
rapha,3,boy,0,3,8.328405693298133e-6
raqib,3,boy,0,3,8.328405693298133e-6
rasan,3,boy,0,3,8.328405693298133e-6
rasmus,3,boy,0,3,8.328405693298133e-6
rauf,3,boy,0,3,8.328405693298133e-6
rauri,3,boy,0,3,8.328405693298133e-6
rayden,3,boy,0,3,8.328405693298133e-6
raygan,3,boy,0,3,8.328405693298133e-6
razin,3,boy,0,3,8.328405693298133e-6
razwan,3,boy,0,3,8.328405693298133e-6
reeco,3,boy,0,3,8.328405693298133e-6
rega,3,boy,0,3,8.328405693298133e-6
regan-lee,3,boy,0,3,8.328405693298133e-6
reggi,3,boy,0,3,8.328405693298133e-6
remari,3,boy,0,3,8.328405693298133e-6
remiel,3,boy,0,3,8.328405693298133e-6
remigiusz,3,boy,1,4,1.1104540924397509e-5
remmy,3,boy,0,3,8.328405693298133e-6
remzi,3,boy,0,3,8.328405693298133e-6
renat,3,boy,0,3,8.328405693298133e-6
reuben-james,3,boy,1,4,1.1104540924397509e-5
reuben-lee,3,boy,0,3,8.328405693298133e-6
reuven,3,boy,0,3,8.328405693298133e-6
reyhan,3,boy,1,4,1.1104540924397509e-5
reyon,3,boy,0,3,8.328405693298133e-6
rhian,3,boy,1,4,1.1104540924397509e-5
rhiley,3,boy,1,4,1.1104540924397509e-5
rhuben,3,boy,2,5,1.3880676155496887e-5
rhun,3,boy,0,3,8.328405693298133e-6
rhyan,3,boy,0,3,8.328405693298133e-6
richmond,3,boy,0,3,8.328405693298133e-6
ricky-lee,3,boy,0,3,8.328405693298133e-6
ridwaan,3,boy,0,3,8.328405693298133e-6
rien,3,boy,0,3,8.328405693298133e-6
rifat,3,boy,0,3,8.328405693298133e-6
rikardo,3,boy,1,4,1.1104540924397509e-5
rilee,3,boy,0,3,8.328405693298133e-6
riley-joe,3,boy,0,3,8.328405693298133e-6
riley-john,3,boy,0,3,8.328405693298133e-6
rishav,3,boy,0,3,8.328405693298133e-6
rithwik,3,boy,0,3,8.328405693298133e-6
rivan,3,boy,0,3,8.328405693298133e-6
river-lee,3,boy,0,3,8.328405693298133e-6
riyyan,3,boy,0,3,8.328405693298133e-6
rob,3,boy,0,3,8.328405693298133e-6
robel,3,boy,0,3,8.328405693298133e-6
rock,3,boy,0,3,8.328405693298133e-6
rocket,3,boy,0,3,8.328405693298133e-6
roderick,3,boy,1,4,1.1104540924397509e-5
rodin,3,boy,0,3,8.328405693298133e-6
rohin,3,boy,0,3,8.328405693298133e-6
rolan,3,boy,0,3,8.328405693298133e-6
romaan,3,boy,2,5,1.3880676155496887e-5
romae,3,boy,0,3,8.328405693298133e-6
romain,3,boy,0,3,8.328405693298133e-6
ronell,3,boy,0,3,8.328405693298133e-6
ronit,3,boy,0,3,8.328405693298133e-6
roop,3,boy,0,3,8.328405693298133e-6
ruben-lee,3,boy,0,3,8.328405693298133e-6
rudraksh,3,boy,0,3,8.328405693298133e-6
rudransh,3,boy,2,5,1.3880676155496887e-5
rueban,3,boy,0,3,8.328405693298133e-6
rune,3,boy,1,4,1.1104540924397509e-5
ruslans,3,boy,0,3,8.328405693298133e-6
rusty,3,boy,0,3,8.328405693298133e-6
ruthvik,3,boy,0,3,8.328405693298133e-6
ryad,3,boy,0,3,8.328405693298133e-6
ryder-james,3,boy,0,3,8.328405693298133e-6
rye,3,boy,0,3,8.328405693298133e-6
s,3,boy,0,3,8.328405693298133e-6
saabir,3,boy,0,3,8.328405693298133e-6
saahil,3,boy,1,4,1.1104540924397509e-5
saahir,3,boy,0,3,8.328405693298133e-6
saaleh,3,boy,0,3,8.328405693298133e-6
saavan,3,boy,0,3,8.328405693298133e-6
sabastian,3,boy,0,3,8.328405693298133e-6
sabiq,3,boy,0,3,8.328405693298133e-6
safeer,3,boy,0,3,8.328405693298133e-6
sagar,3,boy,0,3,8.328405693298133e-6
saha,3,boy,0,3,8.328405693298133e-6
saheb,3,boy,0,3,8.328405693298133e-6
sahibdeep,3,boy,0,3,8.328405693298133e-6
sahibjot,3,boy,0,3,8.328405693298133e-6
sahibpreet,3,boy,0,3,8.328405693298133e-6
sakib,3,boy,1,4,1.1104540924397509e-5
salahuddeen,3,boy,0,3,8.328405693298133e-6
salahudin,3,boy,0,3,8.328405693298133e-6
salar,3,boy,0,3,8.328405693298133e-6
salih,3,boy,1,4,1.1104540924397509e-5
saman,3,boy,0,3,8.328405693298133e-6
samanyu,3,boy,0,3,8.328405693298133e-6
samatar,3,boy,0,3,8.328405693298133e-6
samay,3,boy,0,3,8.328405693298133e-6
samraj,3,boy,0,3,8.328405693298133e-6
samrat,3,boy,2,5,1.3880676155496887e-5
samvir,3,boy,0,3,8.328405693298133e-6
samyar,3,boy,0,3,8.328405693298133e-6
sanav,3,boy,3,6,1.6656811386596265e-5
sanchit,3,boy,0,3,8.328405693298133e-6
sandeep,3,boy,0,3,8.328405693298133e-6
sandy,3,boy,12,15,4.164202846649066e-5
sanjay,3,boy,0,3,8.328405693298133e-6
sansar,3,boy,0,3,8.328405693298133e-6
santana,3,boy,0,3,8.328405693298133e-6
sanvir,3,boy,0,3,8.328405693298133e-6
sathvik,3,boy,0,3,8.328405693298133e-6
savan,3,boy,0,3,8.328405693298133e-6
savio,3,boy,1,4,1.1104540924397509e-5
savraj,3,boy,0,3,8.328405693298133e-6
saymon,3,boy,0,3,8.328405693298133e-6
sayyed,3,boy,0,3,8.328405693298133e-6
sebastiaan,3,boy,0,3,8.328405693298133e-6
sebastianas,3,boy,1,4,1.1104540924397509e-5
seif,3,boy,0,3,8.328405693298133e-6
selby,3,boy,0,3,8.328405693298133e-6
senna,3,boy,1,4,1.1104540924397509e-5
senon,3,boy,0,3,8.328405693298133e-6
serafin,3,boy,0,3,8.328405693298133e-6
seren,3,boy,0,3,8.328405693298133e-6
serigne,3,boy,0,3,8.328405693298133e-6
sethika,3,boy,0,3,8.328405693298133e-6
shaban,3,boy,0,3,8.328405693298133e-6
shafin,3,boy,0,3,8.328405693298133e-6
shahaan,3,boy,0,3,8.328405693298133e-6
shaheem,3,boy,0,3,8.328405693298133e-6
shahin,3,boy,0,3,8.328405693298133e-6
shahwaiz,3,boy,0,3,8.328405693298133e-6
shaikh,3,boy,0,3,8.328405693298133e-6
shailen,3,boy,0,3,8.328405693298133e-6
shakai,3,boy,0,3,8.328405693298133e-6
shakeem,3,boy,0,3,8.328405693298133e-6
shammai,3,boy,0,3,8.328405693298133e-6
shams,3,boy,0,3,8.328405693298133e-6
shamus,3,boy,0,3,8.328405693298133e-6
shane-junior,3,boy,0,3,8.328405693298133e-6
sharvil,3,boy,0,3,8.328405693298133e-6
sharvin,3,boy,0,3,8.328405693298133e-6
sheik,3,boy,0,3,8.328405693298133e-6
shekh,3,boy,0,3,8.328405693298133e-6
shem,3,boy,0,3,8.328405693298133e-6
shepherd,3,boy,0,3,8.328405693298133e-6
shervin,3,boy,0,3,8.328405693298133e-6
shiro,3,boy,0,3,8.328405693298133e-6
shivaan,3,boy,0,3,8.328405693298133e-6
shivay,3,boy,0,3,8.328405693298133e-6
shivraj,3,boy,0,3,8.328405693298133e-6
shlomie,3,boy,0,3,8.328405693298133e-6
sholom,3,boy,0,3,8.328405693298133e-6
sholto,3,boy,0,3,8.328405693298133e-6
shourya,3,boy,0,3,8.328405693298133e-6
shreyansh,3,boy,0,3,8.328405693298133e-6
shrihan,3,boy,0,3,8.328405693298133e-6
shuayb,3,boy,0,3,8.328405693298133e-6
shuraim,3,boy,0,3,8.328405693298133e-6
shyam,3,boy,1,4,1.1104540924397509e-5
sibtain,3,boy,0,3,8.328405693298133e-6
sidar,3,boy,0,3,8.328405693298133e-6
siem,3,boy,0,3,8.328405693298133e-6
silviu,3,boy,0,3,8.328405693298133e-6
simba,3,boy,0,3,8.328405693298133e-6
siraaj,3,boy,0,3,8.328405693298133e-6
sire,3,boy,0,3,8.328405693298133e-6
sirus,3,boy,0,3,8.328405693298133e-6
siyaam,3,boy,0,3,8.328405693298133e-6
smit,3,boy,0,3,8.328405693298133e-6
sofiane,3,boy,0,3,8.328405693298133e-6
sohail,3,boy,0,3,8.328405693298133e-6
sparsh,3,boy,0,3,8.328405693298133e-6
srihan,3,boy,1,4,1.1104540924397509e-5
sruli,3,boy,0,3,8.328405693298133e-6
stanimir,3,boy,0,3,8.328405693298133e-6
stanlee,3,boy,0,3,8.328405693298133e-6
stepan,3,boy,0,3,8.328405693298133e-6
stewie,3,boy,0,3,8.328405693298133e-6
stiles,3,boy,0,3,8.328405693298133e-6
stone,3,boy,0,3,8.328405693298133e-6
stylianos,3,boy,0,3,8.328405693298133e-6
subhan-ali,3,boy,0,3,8.328405693298133e-6
sufiyaan,3,boy,0,3,8.328405693298133e-6
suhan,3,boy,1,4,1.1104540924397509e-5
sukhdeep,3,boy,0,3,8.328405693298133e-6
sukhveer,3,boy,0,3,8.328405693298133e-6
sutton,3,boy,0,3,8.328405693298133e-6
svanik,3,boy,0,3,8.328405693298133e-6
sylar,3,boy,0,3,8.328405693298133e-6
sylas,3,boy,0,3,8.328405693298133e-6
sylwester,3,boy,0,3,8.328405693298133e-6
taafeef,3,boy,0,3,8.328405693298133e-6
tabish,3,boy,0,3,8.328405693298133e-6
tadgh,3,boy,0,3,8.328405693298133e-6
taher,3,boy,0,3,8.328405693298133e-6
taison,3,boy,0,3,8.328405693298133e-6
taiwo,3,boy,0,3,8.328405693298133e-6
tajveer,3,boy,0,3,8.328405693298133e-6
tajwar,3,boy,0,3,8.328405693298133e-6
talan,3,boy,0,3,8.328405693298133e-6
talen,3,boy,0,3,8.328405693298133e-6
talib,3,boy,0,3,8.328405693298133e-6
tallon,3,boy,0,3,8.328405693298133e-6
tam,3,boy,0,3,8.328405693298133e-6
tamer,3,boy,0,3,8.328405693298133e-6
tanzeel,3,boy,0,3,8.328405693298133e-6
tarik,3,boy,0,3,8.328405693298133e-6
tarka,3,boy,0,3,8.328405693298133e-6
taseen,3,boy,0,3,8.328405693298133e-6
tatenda,3,boy,0,3,8.328405693298133e-6
tauras,3,boy,0,3,8.328405693298133e-6
tayden,3,boy,0,3,8.328405693298133e-6
tayte,3,boy,0,3,8.328405693298133e-6
tayvon,3,boy,0,3,8.328405693298133e-6
taze,3,boy,0,3,8.328405693298133e-6
tazneem,3,boy,0,3,8.328405693298133e-6
teghveer,3,boy,0,3,8.328405693298133e-6
teifion,3,boy,1,4,1.1104540924397509e-5
tejan,3,boy,0,3,8.328405693298133e-6
temiloluwa,3,boy,0,3,8.328405693298133e-6
teniola,3,boy,0,3,8.328405693298133e-6
tey,3,boy,0,3,8.328405693298133e-6
thabo,3,boy,0,3,8.328405693298133e-6
thai,3,boy,1,4,1.1104540924397509e-5
thaswin,3,boy,0,3,8.328405693298133e-6
thatcher,3,boy,0,3,8.328405693298133e-6
theo-john,3,boy,0,3,8.328405693298133e-6
theo-lee,3,boy,0,3,8.328405693298133e-6
thibault,3,boy,0,3,8.328405693298133e-6
thivyan,3,boy,0,3,8.328405693298133e-6
thom,3,boy,4,7,1.943294661769564e-5
thomas-jay,3,boy,1,4,1.1104540924397509e-5
thomas-john,3,boy,0,3,8.328405693298133e-6
thompson,3,boy,0,3,8.328405693298133e-6
thorn,3,boy,0,3,8.328405693298133e-6
tihami,3,boy,0,3,8.328405693298133e-6
tijan,3,boy,0,3,8.328405693298133e-6
tijus,3,boy,0,3,8.328405693298133e-6
tilak,3,boy,0,3,8.328405693298133e-6
tilen,3,boy,0,3,8.328405693298133e-6
timo,3,boy,0,3,8.328405693298133e-6
tion,3,boy,0,3,8.328405693298133e-6
tishan,3,boy,0,3,8.328405693298133e-6
titobioluwa,3,boy,0,3,8.328405693298133e-6
tjay,3,boy,0,3,8.328405693298133e-6
tobenna,3,boy,1,4,1.1104540924397509e-5
tobia,3,boy,0,3,8.328405693298133e-6
toluwani,3,boy,0,3,8.328405693298133e-6
toluwanimi,3,boy,0,3,8.328405693298133e-6
tommy-ray,3,boy,0,3,8.328405693298133e-6
toms,3,boy,0,3,8.328405693298133e-6
toni,3,boy,0,3,8.328405693298133e-6
tony-junior,3,boy,0,3,8.328405693298133e-6
torren,3,boy,0,3,8.328405693298133e-6
trae,3,boy,0,3,8.328405693298133e-6
trim,3,boy,0,3,8.328405693298133e-6
trishan,3,boy,0,3,8.328405693298133e-6
tristan-james,3,boy,0,3,8.328405693298133e-6
tristian,3,boy,0,3,8.328405693298133e-6
tristyn,3,boy,0,3,8.328405693298133e-6
triumph,3,boy,0,3,8.328405693298133e-6
tudur,3,boy,0,3,8.328405693298133e-6
tyberius,3,boy,0,3,8.328405693298133e-6
tyga,3,boy,0,3,8.328405693298133e-6
tylen,3,boy,0,3,8.328405693298133e-6
tyler-jai,3,boy,0,3,8.328405693298133e-6
tyler-ray,3,boy,0,3,8.328405693298133e-6
tyrae,3,boy,0,3,8.328405693298133e-6
tyran,3,boy,0,3,8.328405693298133e-6
tyrus,3,boy,0,3,8.328405693298133e-6
uche,3,boy,0,3,8.328405693298133e-6
ugnius,3,boy,0,3,8.328405693298133e-6
ugur,3,boy,0,3,8.328405693298133e-6
ulysses,3,boy,0,3,8.328405693298133e-6
umais,3,boy,0,3,8.328405693298133e-6
unai,3,boy,0,3,8.328405693298133e-6
urijah,3,boy,0,3,8.328405693298133e-6
vaaris,3,boy,0,3,8.328405693298133e-6
van,3,boy,0,3,8.328405693298133e-6
varin,3,boy,0,3,8.328405693298133e-6
vasco,3,boy,2,5,1.3880676155496887e-5
vasilis,3,boy,0,3,8.328405693298133e-6
vedh,3,boy,0,3,8.328405693298133e-6
vehaan,3,boy,0,3,8.328405693298133e-6
vencel,3,boy,0,3,8.328405693298133e-6
viet,3,boy,0,3,8.328405693298133e-6
vignesh,3,boy,0,3,8.328405693298133e-6
vihan,3,boy,0,3,8.328405693298133e-6
vijay,3,boy,0,3,8.328405693298133e-6
vikrant,3,boy,0,3,8.328405693298133e-6
vincentas,3,boy,0,3,8.328405693298133e-6
vinnie-george,3,boy,0,3,8.328405693298133e-6
vinnie-j,3,boy,0,3,8.328405693298133e-6
vinnie-jay,3,boy,0,3,8.328405693298133e-6
vinnie-ray,3,boy,0,3,8.328405693298133e-6
vishwa,3,boy,0,3,8.328405693298133e-6
wahaj,3,boy,0,3,8.328405693298133e-6
wahib,3,boy,0,3,8.328405693298133e-6
wahid,3,boy,0,3,8.328405693298133e-6
westley,3,boy,0,3,8.328405693298133e-6
wilfie,3,boy,0,3,8.328405693298133e-6
wiliam,3,boy,0,3,8.328405693298133e-6
willie,3,boy,1,4,1.1104540924397509e-5
wolfie,3,boy,0,3,8.328405693298133e-6
wraith,3,boy,0,3,8.328405693298133e-6
yaaqub,3,boy,0,3,8.328405693298133e-6
yaasir,3,boy,0,3,8.328405693298133e-6
yacoob,3,boy,0,3,8.328405693298133e-6
yagiz,3,boy,0,3,8.328405693298133e-6
yair,3,boy,0,3,8.328405693298133e-6
yakob,3,boy,0,3,8.328405693298133e-6
yani,3,boy,0,3,8.328405693298133e-6
yankuba,3,boy,0,3,8.328405693298133e-6
yanky,3,boy,0,3,8.328405693298133e-6
yared,3,boy,0,3,8.328405693298133e-6
yashveer,3,boy,0,3,8.328405693298133e-6
yaw,3,boy,0,3,8.328405693298133e-6
yazeed,3,boy,0,3,8.328405693298133e-6
yechezkel,3,boy,0,3,8.328405693298133e-6
yehia,3,boy,0,3,8.328405693298133e-6
yiddy,3,boy,0,3,8.328405693298133e-6
yishai,3,boy,0,3,8.328405693298133e-6
yona,3,boy,0,3,8.328405693298133e-6
yonatan,3,boy,1,4,1.1104540924397509e-5
yonus,3,boy,0,3,8.328405693298133e-6
yosif,3,boy,0,3,8.328405693298133e-6
yosuf,3,boy,0,3,8.328405693298133e-6
yuma,3,boy,0,3,8.328405693298133e-6
yussef,3,boy,1,4,1.1104540924397509e-5
yussuf,3,boy,0,3,8.328405693298133e-6
yuto,3,boy,0,3,8.328405693298133e-6
yuvansh,3,boy,0,3,8.328405693298133e-6
zacary,3,boy,0,3,8.328405693298133e-6
zaccai,3,boy,0,3,8.328405693298133e-6
zachariyah,3,boy,0,3,8.328405693298133e-6
zachary-james,3,boy,0,3,8.328405693298133e-6
zade,3,boy,0,3,8.328405693298133e-6
zahidullah,3,boy,0,3,8.328405693298133e-6
zahin,3,boy,0,3,8.328405693298133e-6
zaiyaan,3,boy,0,3,8.328405693298133e-6
zakareeya,3,boy,0,3,8.328405693298133e-6
zakari,3,boy,0,3,8.328405693298133e-6
zamar,3,boy,0,3,8.328405693298133e-6
zayer,3,boy,0,3,8.328405693298133e-6
zebediah,3,boy,0,3,8.328405693298133e-6
zed,3,boy,0,3,8.328405693298133e-6
zenith,3,boy,0,3,8.328405693298133e-6
zente,3,boy,0,3,8.328405693298133e-6
zeph,3,boy,0,3,8.328405693298133e-6
zephan,3,boy,1,4,1.1104540924397509e-5
zethan,3,boy,0,3,8.328405693298133e-6
zohaan,3,boy,0,3,8.328405693298133e-6
zoraiz,3,boy,0,3,8.328405693298133e-6
zuriel,3,boy,0,3,8.328405693298133e-6
zylan,3,boy,0,3,8.328405693298133e-6
olivia,5017,girl,529,5546,0.016634972435016826
amelia,4777,girl,342,5119,0.015354205534592704
emily,3551,girl,522,4073,0.012216776546668506
isla,3476,girl,391,3867,0.0115988890022016
ava,3285,girl,360,3645,0.010933010192145029
isabella,2729,girl,126,2855,0.008563441453655434
lily,2722,girl,251,2973,0.008917377037379198
jessica,2703,girl,309,3012,0.009034355747253999
ella,2702,girl,285,2987,0.008959369394770152
mia,2662,girl,182,2844,0.008530447458562542
sophia,2636,girl,223,2859,0.00857543927005285
charlotte,2596,girl,265,2861,0.008581438178251558
poppy,2506,girl,110,2616,0.007846571923909848
sophie,2505,girl,416,2921,0.008761405424212793
grace,2498,girl,257,2755,0.008263496043720044
evie,2487,girl,210,2697,0.008089527705957516
alice,2264,girl,106,2370,0.0071087062154687845
scarlett,2096,girl,94,2190,0.006568804477585079
freya,2079,girl,245,2324,0.006970731326898505
florence,2072,girl,54,2126,0.006376839415226428
isabelle,2066,girl,20,2086,0.006256861251252272
daisy,2020,girl,109,2129,0.00638583777752449
chloe,1980,girl,201,2181,0.0065418093906908946
phoebe,1975,girl,71,2046,0.006136883087278115
matilda,1915,girl,50,1965,0.005893927305230448
ruby,1904,girl,146,2050,0.006148880903675531
evelyn,1877,girl,31,1908,0.005722958421567274
sienna,1815,girl,76,1891,0.005671967701878258
sofia,1683,girl,111,1794,0.005381020654240928
eva,1641,girl,171,1812,0.0054350108280292984
elsie,1574,girl,54,1628,0.004883111273748178
willow,1536,girl,85,1621,0.0048621150950527
ivy,1509,girl,93,1602,0.004805125467164976
millie,1456,girl,192,1648,0.004943100355735256
esme,1416,girl,95,1511,0.00453217514412377
rosie,1403,girl,111,1514,0.0045411735064218315
imogen,1400,girl,91,1491,0.004472186062136691
elizabeth,1384,girl,85,1469,0.004406198071950905
maya,1374,girl,90,1464,0.004391200801454135
layla,1358,girl,152,1510,0.004529175690024416
emilia,1356,girl,110,1466,0.0043971997096528435
lola,1298,girl,72,1370,0.004109252116114867
lucy,1273,girl,279,1552,0.00465515276219728
harper,1256,girl,142,1398,0.004193236830896777
eliza,1226,girl,26,1252,0.003755316532391105
erin,1212,girl,156,1368,0.004103253207916159
eleanor,1147,girl,38,1185,0.0035543531077343923
ellie,1142,girl,251,1393,0.004178239560400007
harriet,1132,girl,19,1151,0.003452371668356359
thea,1132,girl,86,1218,0.003653335093013072
maisie,1111,girl,129,1240,0.0037193230831988576
holly,1098,girl,132,1230,0.003689328542205319
emma,1080,girl,194,1274,0.003821304522576891
georgia,1078,girl,131,1209,0.0036263400061188862
amber,1066,girl,115,1181,0.0035423552913369767
molly,1041,girl,81,1122,0.0033653874994750955
hannah,1033,girl,176,1209,0.0036263400061188862
abigail,1023,girl,96,1119,0.0033563891371770336
jasmine,1018,girl,27,1045,0.003134429533824844
lilly,1014,girl,102,1116,0.003347390774878972
annabelle,1009,girl,40,1049,0.0031464273502222594
rose,974,girl,73,1047,0.0031404284420235517
penelope,972,girl,37,1009,0.003026449186248103
amelie,964,girl,47,1011,0.0030324480944468107
violet,959,girl,50,1009,0.003026449186248103
bella,946,girl,55,1001,0.0030024535534532715
aria,926,girl,251,1177,0.003530357474939561
zara,876,girl,113,989,0.0029664601042610245
maria,853,girl,53,906,0.0027175054140146492
nancy,842,girl,6,848,0.002543537076252122
darcie,791,girl,35,826,0.002477549086066336
lottie,782,girl,26,808,0.0024235589122779655
anna,779,girl,182,961,0.002882475389479115
summer,760,girl,56,816,0.0024475545450727966
martha,756,girl,32,788,0.002363569830290887
heidi,752,girl,48,800,0.002399563279483134
gracie,744,girl,78,822,0.0024655512696689203
luna,715,girl,36,751,0.002252590028614792
maryam,711,girl,22,733,0.0021985998548264218
beatrice,685,girl,15,700,0.002099617869547742
mila,679,girl,73,752,0.002255589482714146
darcey,662,girl,33,695,0.0020846205990509726
megan,658,girl,66,724,0.002171604767932236
iris,648,girl,23,671,0.0020126337006664786
lexi,626,girl,89,715,0.002144609681038051
robyn,622,girl,116,738,0.0022135971253231914
aisha,617,girl,17,634,0.0019016538989903838
clara,611,girl,43,654,0.001961642980977462
francesca,611,girl,24,635,0.0019046533530897376
sara,606,girl,39,645,0.0019346478940832769
victoria,586,girl,33,619,0.001856662087500075
zoe,584,girl,118,702,0.00210561677774645
julia,578,girl,63,641,0.0019226500776858611
arabella,577,girl,28,605,0.0018146697301091202
maddison,576,girl,24,600,0.0017996724596123506
sarah,572,girl,76,648,0.0019436462563813385
felicity,570,girl,17,587,0.0017606795563207497
darcy,566,girl,38,604,0.0018116702760097663
leah,564,girl,98,662,0.0019856386137722935
lydia,563,girl,20,583,0.001748681739923334
edith,558,girl,29,587,0.0017606795563207497
brooke,557,girl,79,636,0.0019076528071890915
bethany,556,girl,36,592,0.0017756768268175193
lyla,553,girl,31,584,0.0017516811940226878
aurora,552,girl,34,586,0.0017576801022213958
lacey,539,girl,92,631,0.001892655536692322
orla,537,girl,144,681,0.002042628241660018
annie,534,girl,41,575,0.0017246861071285027
niamh,525,girl,95,620,0.0018596615415994288
isabel,514,girl,8,522,0.001565715039862745
paige,505,girl,64,569,0.0017066893825323792
eloise,503,girl,15,518,0.0015537172234653294
alexandra,502,girl,58,560,0.0016796942956381939
bonnie,500,girl,42,542,0.0016257041218498234
esmae,495,girl,5,500,0.0014997270496769587
hollie,495,girl,89,584,0.0017516811940226878
eden,493,girl,34,527,0.0015807123103595145
anaya,484,girl,16,500,0.0014997270496769587
faith,484,girl,38,522,0.001565715039862745
lara,484,girl,41,525,0.0015747134021608068
skye,482,girl,114,596,0.0017876746432149348
fatima,479,girl,16,495,0.0014847297791801893
aaliyah,478,girl,34,512,0.001535720498869206
ariana,475,girl,50,525,0.0015747134021608068
mollie,465,girl,40,505,0.0015147243201737283
madison,462,girl,51,513,0.0015387199529685598
pippa,458,girl,11,469,0.0014067439725969873
ayla,449,girl,65,514,0.0015417194070679137
amy,440,girl,89,529,0.0015867112185582225
nevaeh,435,girl,10,445,0.0013347570742124934
savannah,432,girl,27,459,0.001376749431603448
frankie,430,girl,22,452,0.0013557532529079707
katie,426,girl,126,552,0.0016556986628433626
mya,421,girl,62,483,0.0014487363299879423
edie,415,girl,14,429,0.0012867658086228306
isobel,412,girl,23,435,0.0013047625332189541
zainab,410,girl,9,419,0.0012567712676292914
lena,407,girl,39,446,0.0013377565283118472
gabriella,406,girl,31,437,0.0013107614414176619
tilly,403,girl,30,433,0.0012987636250202464
hanna,400,girl,49,449,0.001346754890609909
delilah,399,girl,6,405,0.0012147789102383367
connie,387,girl,19,406,0.0012177783643376905
hallie,385,girl,43,428,0.0012837663545234768
seren,378,girl,14,392,0.0011757860069467358
esther,375,girl,13,388,0.00116378819054932
marnie,373,girl,29,402,0.0012057805479402748
lillie,368,girl,54,422,0.0012657696299273533
olive,368,girl,11,379,0.0011367931036551347
laura,366,girl,33,399,0.0011967821856422132
elena,361,girl,26,387,0.0011607887364499662
autumn,360,girl,22,382,0.0011457914659531966
skyla,360,girl,15,375,0.0011247952872577192
betsy,359,girl,5,364,0.001091801292164826
zahra,359,girl,17,376,0.001127794741357073
rebecca,356,girl,95,451,0.0013527537988086169
nina,354,girl,38,392,0.0011757860069467358
annabel,350,girl,29,379,0.0011367931036551347
amaya,349,girl,12,361,0.0010828029298667642
inaaya,349,girl,5,354,0.0010618067511712868
alexis,348,girl,42,390,0.0011697870987480278
hope,348,girl,56,404,0.0012117794561389828
paisley,348,girl,16,364,0.001091801292164826
ada,341,girl,32,373,0.0011187963790590112
natalia,341,girl,36,377,0.001130794195456427
elodie,339,girl,19,358,0.0010738045675687026
alexa,332,girl,28,360,0.0010798034757674103
beatrix,330,girl,17,347,0.0010408105724758095
naomi,330,girl,34,364,0.001091801292164826
liliana,328,girl,25,353,0.001058807297071933
zuzanna,327,girl,31,358,0.0010738045675687026
alana,320,girl,8,328,9.838209445880849e-4
sadie,319,girl,41,360,0.0010798034757674103
keira,316,girl,28,344,0.0010318122101777476
myla,316,girl,30,346,0.0010378111183764556
madeleine,311,girl,16,327,9.80821490488731e-4
elise,310,girl,39,349,0.0010468094806745172
khadija,305,girl,6,311,9.328302248990684e-4
penny,305,girl,37,342,0.0010258133019790398
arya,302,girl,48,350,0.001049808934773871
nicole,300,girl,27,327,9.80821490488731e-4
anastasia,299,girl,12,311,9.328302248990684e-4
maja,296,girl,45,341,0.001022813847879686
maggie,295,girl,17,312,9.358296789984223e-4
alisha,294,girl,16,310,9.298307707997144e-4
aoife,293,girl,29,322,9.658242199919615e-4
margot,293,girl,6,299,8.968367757068214e-4
georgina,292,girl,10,302,9.058351380048831e-4
rosa,290,girl,40,330,9.898198527867929e-4
eve,289,girl,55,344,0.0010318122101777476
piper,289,girl,45,334,0.0010018176691842084
lois,287,girl,32,319,9.568258576938998e-4
lauren,283,girl,48,331,9.928193068861467e-4
leila,282,girl,17,299,8.968367757068214e-4
aliza,279,girl,7,286,8.578438724152204e-4
skylar,278,girl,26,304,9.118340462035909e-4
amira,277,girl,17,294,8.818395052100518e-4
aleena,268,girl,7,275,8.248498773223273e-4
alyssa,268,girl,20,288,8.638427806139283e-4
libby,268,girl,34,302,9.058351380048831e-4
alicia,266,girl,21,287,8.608433265145743e-4
amelia-rose,265,girl,10,275,8.248498773223273e-4
lucia,264,girl,32,296,8.878384134087597e-4
ayesha,262,girl,10,272,8.158515150242656e-4
april,259,girl,26,285,8.548444183158665e-4
hattie,257,girl,4,261,7.828575199313725e-4
aizah,255,girl,9,264,7.918558822294342e-4
hazel,255,girl,34,289,8.668422347132822e-4
laila,254,girl,17,271,8.128520609249117e-4
mabel,250,girl,7,257,7.708597035339568e-4
tabitha,249,girl,11,260,7.798580658320186e-4
lyra,248,girl,8,256,7.67860249434603e-4
neve,248,girl,31,279,8.36847693719743e-4
georgie,247,girl,45,292,8.758405970113439e-4
zoya,244,girl,7,251,7.528629789378333e-4
amina,243,girl,6,249,7.468640707391255e-4
india,240,girl,7,247,7.408651625404176e-4
mariam,240,girl,3,243,7.28867346143002e-4
anya,239,girl,27,266,7.978547904281421e-4
melissa,239,girl,17,256,7.67860249434603e-4
jemima,237,girl,2,239,7.168695297455863e-4
caitlin,236,girl,36,272,8.158515150242656e-4
emelia,234,girl,16,250,7.498635248384793e-4
amara,233,girl,11,244,7.318668002423558e-4
nadia,233,girl,20,253,7.588618871365412e-4
yasmin,229,girl,7,236,7.078711674475246e-4
beau,228,girl,16,244,7.318668002423558e-4
cleo,228,girl,9,237,7.108706215468785e-4
khadijah,228,girl,4,232,6.958733510501089e-4
lexie,228,girl,15,243,7.28867346143002e-4
emmie,227,girl,17,244,7.318668002423558e-4
esmee,223,girl,19,242,7.258678920436481e-4
primrose,223,girl,0,223,6.688782641559236e-4
polly,222,girl,6,228,6.838755346526932e-4
zofia,221,girl,28,249,7.468640707391255e-4
maia,219,girl,23,242,7.258678920436481e-4
cara,218,girl,71,289,8.668422347132822e-4
safa,217,girl,2,219,6.56880447758508e-4
faye,215,girl,24,239,7.168695297455863e-4
arianna,214,girl,58,272,8.158515150242656e-4
alexia,213,girl,4,217,6.508815395598001e-4
lana,213,girl,23,236,7.078711674475246e-4
pearl,210,girl,2,212,6.358842690630305e-4
constance,209,girl,10,219,6.56880447758508e-4
jessie,208,girl,18,226,6.778766264539854e-4
alba,205,girl,42,247,7.408651625404176e-4
antonia,205,girl,12,217,6.508815395598001e-4
gabriela,205,girl,12,217,6.508815395598001e-4
jennifer,205,girl,19,224,6.718777182552775e-4
haniya,204,girl,14,218,6.53880993659154e-4
mary,204,girl,15,219,6.56880447758508e-4
ella-rose,203,girl,12,215,6.448826313610923e-4
josephine,201,girl,8,209,6.268859067649688e-4
eliana,200,girl,8,208,6.238864526656149e-4
halle,200,girl,37,237,7.108706215468785e-4
anayah,197,girl,7,204,6.118886362681991e-4
syeda,197,girl,6,203,6.088891821688453e-4
talia,197,girl,9,206,6.17887544466907e-4
lily-rose,196,girl,14,210,6.298853608643226e-4
emilie,195,girl,32,227,6.808760805533392e-4
alicja,194,girl,23,217,6.508815395598001e-4
belle,194,girl,17,211,6.328848149636766e-4
cora,193,girl,45,238,7.138700756462324e-4
kayla,193,girl,60,253,7.588618871365412e-4
rachel,193,girl,43,236,7.078711674475246e-4
hana,192,girl,12,204,6.118886362681991e-4
lilah,187,girl,18,205,6.148880903675531e-4
athena,186,girl,7,193,5.788946411753061e-4
macie,186,girl,22,208,6.238864526656149e-4
honey,185,girl,2,187,5.608979165791825e-4
hafsa,184,girl,3,187,5.608979165791825e-4
zaynab,184,girl,6,190,5.698962788772443e-4
nia,183,girl,6,189,5.668968247778904e-4
dorothy,181,girl,0,181,5.42901191983059e-4
minnie,181,girl,8,189,5.668968247778904e-4
indie,180,girl,20,200,5.998908198707835e-4
melody,180,girl,9,189,5.668968247778904e-4
aiza,179,girl,8,187,5.608979165791825e-4
aurelia,179,girl,6,185,5.548990083804748e-4
aliyah,178,girl,16,194,5.8189409527466e-4
helena,178,girl,11,189,5.668968247778904e-4
scarlet,178,girl,6,184,5.518995542811208e-4
nora,177,girl,13,190,5.698962788772443e-4
ophelia,177,girl,4,181,5.42901191983059e-4
peyton,176,girl,21,197,5.908924575727218e-4
tia,176,girl,11,187,5.608979165791825e-4
lila,175,girl,10,185,5.548990083804748e-4
tallulah,175,girl,2,177,5.309033755856434e-4
louisa,174,girl,26,200,5.998908198707835e-4
katherine,172,girl,27,199,5.968913657714296e-4
diana,171,girl,6,177,5.309033755856434e-4
flora,171,girl,34,205,6.148880903675531e-4
angel,169,girl,8,177,5.309033755856434e-4
harley,169,girl,42,211,6.328848149636766e-4
jorgie,169,girl,46,215,6.448826313610923e-4
lillian,169,girl,7,176,5.279039214862895e-4
fleur,168,girl,2,170,5.099071968901659e-4
ana,167,girl,12,179,5.369022837843513e-4
alessia,166,girl,4,170,5.099071968901659e-4
harlow,166,girl,21,187,5.608979165791825e-4
maisy,165,girl,7,172,5.159061050888738e-4
riley,165,girl,17,182,5.45900646082413e-4
ava-rose,164,girl,10,174,5.219050132875817e-4
callie,163,girl,36,199,5.968913657714296e-4
catherine,163,girl,19,182,5.45900646082413e-4
maddie,163,girl,7,170,5.099071968901659e-4
annabella,162,girl,9,171,5.129066509895199e-4
lucie,161,girl,33,194,5.8189409527466e-4
valentina,160,girl,5,165,4.949099263933964e-4
dolly,159,girl,0,159,4.769132017972729e-4
nellie,159,girl,1,160,4.799126558966268e-4
ottilie,159,girl,2,161,4.8291210999598075e-4
ida,158,girl,4,162,4.8591156409533463e-4
noor,158,girl,5,163,4.889110181946886e-4
alayna,157,girl,6,163,4.889110181946886e-4
alina,157,girl,8,165,4.949099263933964e-4
amirah,157,girl,6,163,4.889110181946886e-4
audrey,157,girl,7,164,4.919104722940424e-4
kiara,157,girl,15,172,5.159061050888738e-4
aminah,156,girl,2,158,4.73913747697919e-4
miriam,156,girl,12,168,5.039082886914582e-4
oliwia,155,girl,9,164,4.919104722940424e-4
fatimah,154,girl,5,159,4.769132017972729e-4
ffion,154,girl,2,156,4.6791483949921113e-4
isla-rose,154,girl,3,157,4.7091429359856507e-4
josie,154,girl,8,162,4.8591156409533463e-4
liyana,154,girl,3,157,4.7091429359856507e-4
nyla,154,girl,3,157,4.7091429359856507e-4
imaan,152,girl,5,157,4.7091429359856507e-4
elisa,151,girl,9,160,4.799126558966268e-4
natalie,150,girl,17,167,5.009088345921042e-4
quinn,150,girl,56,206,6.17887544466907e-4
philippa,149,girl,5,154,4.619159313005033e-4
wren,147,girl,11,158,4.73913747697919e-4
claudia,146,girl,12,158,4.73913747697919e-4
effie,146,girl,10,156,4.6791483949921113e-4
evangeline,146,girl,6,152,4.5591702310179545e-4
ariella,145,girl,6,151,0.00045291756900244157
ebony,145,girl,10,155,4.649153853998572e-4
iyla,145,girl,3,148,4.439192067043798e-4
fearne,143,girl,17,160,4.799126558966268e-4
taylor,143,girl,22,165,4.949099263933964e-4
river,141,girl,10,151,0.00045291756900244157
stella,141,girl,12,153,4.589164772011494e-4
erica,139,girl,13,152,4.5591702310179545e-4
nell,139,girl,3,142,4.259224821082563e-4
kara,138,girl,30,168,5.039082886914582e-4
norah,138,girl,12,150,4.4991811490308764e-4
inayah,137,girl,4,141,4.229230280089024e-4
lily-mae,137,girl,3,140,4.1992357390954846e-4
madeline,137,girl,5,142,4.259224821082563e-4
michelle,136,girl,16,152,4.5591702310179545e-4
rosalie,136,girl,6,142,4.259224821082563e-4
stephanie,135,girl,9,144,4.3192139030696414e-4
verity,135,girl,8,143,4.289219362076102e-4
anais,134,girl,6,140,4.1992357390954846e-4
caitlyn,134,girl,12,146,4.3792029850567196e-4
iqra,134,girl,2,136,4.079257575121328e-4
izabella,134,girl,6,140,4.1992357390954846e-4
vanessa,134,girl,4,138,4.1392466571084065e-4
agnes,133,girl,9,142,4.259224821082563e-4
aya,131,girl,5,136,4.079257575121328e-4
etta,129,girl,4,133,3.9892739521407103e-4
inaya,128,girl,2,130,3.899290329160093e-4
kiera,128,girl,17,145,4.34920844406318e-4
kyra,127,girl,9,136,4.079257575121328e-4
olivia-rose,127,girl,7,134,4.0192684931342497e-4
sapphire,127,girl,4,131,3.929284870153632e-4
cerys,124,girl,13,137,4.109252116114867e-4
demi,124,girl,7,131,3.929284870153632e-4
harmony,124,girl,4,128,3.839301247173015e-4
bella-rose,123,girl,7,130,3.899290329160093e-4
billie,123,girl,14,137,4.109252116114867e-4
leia,123,girl,21,144,4.3192139030696414e-4
livia,123,girl,5,128,3.839301247173015e-4
nikola,123,girl,7,130,3.899290329160093e-4
halima,122,girl,2,124,3.719323083198858e-4
rae,122,girl,9,131,3.929284870153632e-4
abbie,121,girl,83,204,6.118886362681991e-4
tiana,121,girl,4,125,3.7493176241923967e-4
aleksandra,120,girl,10,130,3.899290329160093e-4
aubrey,119,girl,7,126,3.779312165185936e-4
daria,119,girl,4,123,3.6893285422053186e-4
elsa,119,girl,5,124,3.719323083198858e-4
frances,119,girl,6,125,3.7493176241923967e-4
joanna,119,girl,10,129,3.8692957881665535e-4
gracie-mae,118,girl,4,122,3.659334001211779e-4
safaa,118,girl,3,121,3.6293394602182405e-4
saoirse,118,girl,23,141,4.229230280089024e-4
vivienne,118,girl,16,134,4.0192684931342497e-4
ellie-mae,116,girl,7,123,3.6893285422053186e-4
eshaal,116,girl,4,120,3.599344919224701e-4
milly,116,girl,12,128,3.839301247173015e-4
ayah,115,girl,3,118,3.539355837237623e-4
betty,115,girl,1,116,3.4793667552505443e-4
astrid,114,girl,12,126,3.779312165185936e-4
ayda,114,girl,18,132,3.959279411147171e-4
jade,113,girl,5,118,3.539355837237623e-4
lilia,113,girl,2,115,3.449372214257005e-4
aimee,112,girl,41,153,4.589164772011494e-4
everly,112,girl,3,115,3.449372214257005e-4
miley,112,girl,10,122,3.659334001211779e-4
nova,112,girl,19,131,3.929284870153632e-4
reeva,112,girl,11,123,3.6893285422053186e-4
aubree,111,girl,8,119,3.569350378231162e-4
ciara,111,girl,10,121,3.6293394602182405e-4
gabrielle,111,girl,10,121,3.6293394602182405e-4
kaitlyn,111,girl,12,123,3.6893285422053186e-4
emmeline,110,girl,6,116,3.4793667552505443e-4
kira,110,girl,2,112,3.3593885912763875e-4
lacie,109,girl,14,123,3.6893285422053186e-4
clementine,108,girl,2,110,3.2993995092893094e-4
daniella,108,girl,4,112,3.3593885912763875e-4
destiny,108,girl,0,108,3.239410427302231e-4
ayat,107,girl,5,112,3.3593885912763875e-4
louise,107,girl,12,119,3.569350378231162e-4
marley,107,girl,14,121,3.6293394602182405e-4
sydney,107,girl,6,113,3.389383132269927e-4
bianca,106,girl,6,112,3.3593885912763875e-4
dakota,106,girl,4,110,3.2993995092893094e-4
lilly-mae,106,girl,1,107,3.209415886308692e-4
mia-rose,106,girl,5,111,3.3293940502828487e-4
alyssia,105,girl,4,109,3.26940496829577e-4
margaret,105,girl,12,117,3.5093612962440836e-4
pixie,105,girl,6,111,3.3293940502828487e-4
skyler,105,girl,8,113,3.389383132269927e-4
genevieve,104,girl,4,108,3.239410427302231e-4
iona,104,girl,67,171,5.129066509895199e-4
macy,104,girl,19,123,3.6893285422053186e-4
yusra,104,girl,3,107,3.209415886308692e-4
kyla,103,girl,13,116,3.4793667552505443e-4
pola,103,girl,9,112,3.3593885912763875e-4
ameera,102,girl,5,107,3.209415886308692e-4
kitty,102,girl,3,105,3.149426804321613e-4
lily-may,102,girl,6,108,3.239410427302231e-4
miya,102,girl,5,107,3.209415886308692e-4
carys,101,girl,7,108,3.239410427302231e-4
cecilia,101,girl,0,101,3.029448640347457e-4
hareem,101,girl,4,105,3.149426804321613e-4
marwa,101,girl,2,103,3.089437722334535e-4
samantha,101,girl,11,112,3.3593885912763875e-4
evie-rose,100,girl,4,104,3.1194322633280744e-4
haleema,100,girl,2,102,3.0594431813409957e-4
liberty,99,girl,2,101,3.029448640347457e-4
natasha,99,girl,8,107,3.209415886308692e-4
priya,99,girl,10,109,3.26940496829577e-4
alys,98,girl,1,99,2.969459558360378e-4
ariya,98,girl,6,104,3.1194322633280744e-4
lilly-may,98,girl,3,101,3.029448640347457e-4
lilly-rose,98,girl,3,101,3.029448640347457e-4
myah,98,girl,17,115,3.449372214257005e-4
kate,97,girl,15,112,3.3593885912763875e-4
poppie,97,girl,4,101,3.029448640347457e-4
adriana,96,girl,20,116,3.4793667552505443e-4
ela,96,girl,1,97,2.9094704763733e-4
raya,96,girl,5,101,3.029448640347457e-4
ruqayyah,96,girl,0,96,2.879475935379761e-4
aaminah,95,girl,0,95,2.8494813943862214e-4
hermione,95,girl,1,96,2.879475935379761e-4
ivy-rose,95,girl,6,101,3.029448640347457e-4
karina,95,girl,7,102,3.0594431813409957e-4
minahil,95,girl,6,101,3.029448640347457e-4
ria,95,girl,6,101,3.029448640347457e-4
ruth,95,girl,5,100,2.9994540993539176e-4
sylvie,95,girl,6,101,3.029448640347457e-4
leyla,94,girl,5,99,2.969459558360378e-4
macey,94,girl,14,108,3.239410427302231e-4
anika,93,girl,6,99,2.969459558360378e-4
iman,93,girl,3,96,2.879475935379761e-4
khloe,93,girl,25,118,3.539355837237623e-4
maira,93,girl,3,96,2.879475935379761e-4
rowan,93,girl,27,120,3.599344919224701e-4
serena,93,girl,5,98,2.9394650173668395e-4
tara,93,girl,10,103,3.089437722334535e-4
alia,92,girl,7,99,2.969459558360378e-4
ellen,92,girl,10,102,3.0594431813409957e-4
orlaith,92,girl,37,129,3.8692957881665535e-4
renee,92,girl,7,99,2.969459558360378e-4
salma,92,girl,1,93,2.7894923123991433e-4
sasha,92,girl,5,97,2.9094704763733e-4
crystal,91,girl,3,94,2.8194868533926826e-4
neave,91,girl,13,104,3.1194322633280744e-4
bethan,90,girl,6,96,2.879475935379761e-4
vienna,90,girl,1,91,2.729503230412065e-4
brooklyn,89,girl,16,105,3.149426804321613e-4
casey,89,girl,21,110,3.2993995092893094e-4
chelsea,89,girl,5,94,2.8194868533926826e-4
isra,89,girl,3,92,2.759497771405604e-4
jannat,89,girl,4,93,2.7894923123991433e-4
milena,89,girl,6,95,2.8494813943862214e-4
nicola,89,girl,10,99,2.969459558360378e-4
remi,89,girl,11,100,2.9994540993539176e-4
rhea,89,girl,16,105,3.149426804321613e-4
sumayyah,89,girl,2,91,2.729503230412065e-4
esmai,88,girl,1,89,2.6695141484249865e-4
hafsah,88,girl,3,91,2.729503230412065e-4
meadow,88,girl,3,91,2.729503230412065e-4
nylah,88,girl,5,93,2.7894923123991433e-4
ava-grace,87,girl,5,92,2.759497771405604e-4
christina,87,girl,11,98,2.9394650173668395e-4
tiffany,87,girl,6,93,2.7894923123991433e-4
wiktoria,87,girl,10,97,2.9094704763733e-4
amalia,86,girl,2,88,2.6395196074314477e-4
amanda,86,girl,8,94,2.8194868533926826e-4
angelina,86,girl,3,89,2.6695141484249865e-4
erika,86,girl,8,94,2.8194868533926826e-4
riya,86,girl,3,89,2.6695141484249865e-4
shanaya,86,girl,2,88,2.6395196074314477e-4
aleeza,85,girl,1,86,2.579530525444369e-4
eira,85,girl,3,88,2.6395196074314477e-4
juliet,85,girl,4,89,2.6695141484249865e-4
mae,85,girl,2,87,2.6095250664379084e-4
fern,84,girl,18,102,3.0594431813409957e-4
juliette,84,girl,7,91,2.729503230412065e-4
mali,84,girl,2,86,2.579530525444369e-4
ayana,83,girl,3,86,2.579530525444369e-4
charlie,83,girl,18,101,3.029448640347457e-4
daphne,83,girl,2,85,2.5495359844508297e-4
greta,83,girl,3,86,2.579530525444369e-4
hayley,83,girl,31,114,3.419377673263466e-4
liana,83,girl,3,86,2.579530525444369e-4
amiyah,82,girl,1,83,2.4895469024637515e-4
emaan,82,girl,0,82,2.459552361470212e-4
evie-mae,82,girl,0,82,2.459552361470212e-4
freyja,82,girl,7,89,2.6695141484249865e-4
theia,82,girl,9,91,2.729503230412065e-4
aniyah,81,girl,3,84,2.519541443457291e-4
blossom,81,girl,3,84,2.519541443457291e-4
alannah,80,girl,5,85,2.5495359844508297e-4
alma,80,girl,6,86,2.579530525444369e-4
ameerah,80,girl,1,81,2.4295578204766731e-4
courtney,80,girl,11,91,2.729503230412065e-4
elissa,80,girl,1,81,2.4295578204766731e-4
henrietta,80,girl,1,81,2.4295578204766731e-4
manha,80,girl,5,85,2.5495359844508297e-4
sana,80,girl,0,80,2.399563279483134e-4
aliya,79,girl,3,82,2.459552361470212e-4
annalise,79,girl,8,87,2.6095250664379084e-4
ava-mae,79,girl,0,79,2.369568738489595e-4
dua,79,girl,1,80,2.399563279483134e-4
kendall,79,girl,11,90,2.699508689418526e-4
siena,79,girl,7,86,2.579530525444369e-4
tamara,79,girl,4,83,2.4895469024637515e-4
deborah,78,girl,2,80,2.399563279483134e-4
hawa,78,girl,0,78,2.3395741974960557e-4
layla-rose,78,girl,3,81,2.4295578204766731e-4
noa,78,girl,5,83,2.4895469024637515e-4
ruby-rose,78,girl,3,81,2.4295578204766731e-4
tillie,78,girl,7,85,2.5495359844508297e-4
adele,77,girl,8,85,2.5495359844508297e-4
daisy-mae,77,girl,0,77,2.3095796565025166e-4
juno,77,girl,5,82,2.459552361470212e-4
alisa,76,girl,2,78,2.3395741974960557e-4
asiya,76,girl,4,80,2.399563279483134e-4
emmy,76,girl,14,90,2.699508689418526e-4
leela,76,girl,4,80,2.399563279483134e-4
lia,76,girl,7,83,2.4895469024637515e-4
lina,76,girl,3,79,2.369568738489595e-4
simran,76,girl,2,78,2.3395741974960557e-4
ella-mae,75,girl,6,81,2.4295578204766731e-4
ellie-may,75,girl,6,81,2.4295578204766731e-4
eryn,75,girl,8,83,2.4895469024637515e-4
isla-mae,75,girl,1,76,2.2795851155089773e-4
jenna,75,girl,10,85,2.5495359844508297e-4
sia,75,girl,6,81,2.4295578204766731e-4
yasmine,75,girl,0,75,2.2495905745154382e-4
amal,74,girl,1,75,2.2495905745154382e-4
dolcie,74,girl,0,74,2.219596033521899e-4
evelina,74,girl,4,78,2.3395741974960557e-4
kaia,74,girl,6,80,2.399563279483134e-4
may,74,girl,4,78,2.3395741974960557e-4
sienna-rose,74,girl,2,76,2.2795851155089773e-4
adeline,73,girl,5,78,2.3395741974960557e-4
camilla,73,girl,1,74,2.219596033521899e-4
diya,73,girl,1,74,2.219596033521899e-4
dottie,73,girl,0,73,2.1896014925283598e-4
elif,73,girl,0,73,2.1896014925283598e-4
indiana,73,girl,5,78,2.3395741974960557e-4
myra,73,girl,2,75,2.2495905745154382e-4
nola,73,girl,8,81,2.4295578204766731e-4
rita,73,girl,4,77,2.3095796565025166e-4
robin,73,girl,5,78,2.3395741974960557e-4
safiyyah,73,girl,2,75,2.2495905745154382e-4
scarlett-rose,73,girl,3,76,2.2795851155089773e-4
cecily,72,girl,2,74,2.219596033521899e-4
dulcie,72,girl,1,73,2.1896014925283598e-4
isobelle,72,girl,1,73,2.1896014925283598e-4
karolina,72,girl,1,73,2.1896014925283598e-4
mahnoor,72,girl,2,74,2.219596033521899e-4
nelly,72,girl,2,74,2.219596033521899e-4
safiya,72,girl,1,73,2.1896014925283598e-4
saskia,72,girl,5,77,2.3095796565025166e-4
tegan,72,girl,2,74,2.219596033521899e-4
adelaide,71,girl,2,73,2.1896014925283598e-4
amna,71,girl,4,75,2.2495905745154382e-4
ayra,71,girl,2,73,2.1896014925283598e-4
eadie,71,girl,3,74,2.219596033521899e-4
ember,71,girl,5,76,2.2795851155089773e-4
imani,71,girl,0,71,2.1296124105412814e-4
joy,71,girl,5,76,2.2795851155089773e-4
kelsey,71,girl,9,80,2.399563279483134e-4
malaika,71,girl,4,75,2.2495905745154382e-4
paris,71,girl,1,72,2.1596069515348207e-4
tianna,71,girl,6,77,2.3095796565025166e-4
angela,70,girl,6,76,2.2795851155089773e-4
ariah,70,girl,20,90,2.699508689418526e-4
hoorain,70,girl,2,72,2.1596069515348207e-4
ines,70,girl,1,71,2.1296124105412814e-4
kaya,70,girl,3,73,2.1896014925283598e-4
mara,70,girl,7,77,2.3095796565025166e-4
milana,70,girl,11,81,2.4295578204766731e-4
morgan,70,girl,13,83,2.4895469024637515e-4
rumaysa,70,girl,0,70,2.0996178695477423e-4
sky,70,girl,2,72,2.1596069515348207e-4
aarya,69,girl,5,74,2.219596033521899e-4
aysha,69,girl,3,72,2.1596069515348207e-4
brianna,69,girl,6,75,2.2495905745154382e-4
khaleesi,69,girl,4,73,2.1896014925283598e-4
theodora,69,girl,3,72,2.1596069515348207e-4
veronica,69,girl,2,71,2.1296124105412814e-4
zoey,69,girl,15,84,2.519541443457291e-4
aila,68,girl,42,110,3.2993995092893094e-4
aiyla,68,girl,2,70,2.0996178695477423e-4
helen,68,girl,3,71,2.1296124105412814e-4
hettie,68,girl,0,68,2.039628787560664e-4
hiba,68,girl,1,69,2.0696233285542032e-4
lavinia,68,girl,0,68,2.039628787560664e-4
lola-rose,68,girl,3,71,2.1296124105412814e-4
yara,68,girl,5,73,2.1896014925283598e-4
elspeth,67,girl,14,81,2.4295578204766731e-4
humaira,67,girl,2,69,2.0696233285542032e-4
indigo,67,girl,3,70,2.0996178695477423e-4
isabella-rose,67,girl,0,67,2.0096342465671248e-4
lilian,67,girl,3,70,2.0996178695477423e-4
meredith,67,girl,3,70,2.0996178695477423e-4
mira,67,girl,1,68,2.039628787560664e-4
tessa,67,girl,10,77,2.3095796565025166e-4
addison,66,girl,18,84,2.519541443457291e-4
elora,66,girl,0,66,1.9796397055735855e-4
elsie-mae,66,girl,0,66,1.9796397055735855e-4
kayleigh,66,girl,17,83,2.4895469024637515e-4
maeve,66,girl,7,73,2.1896014925283598e-4
nusaybah,66,girl,0,66,1.9796397055735855e-4
xanthe,66,girl,1,67,2.0096342465671248e-4
alesha,65,girl,7,72,2.1596069515348207e-4
beth,65,girl,32,97,2.9094704763733e-4
cassie,65,girl,12,77,2.3095796565025166e-4
esmay,65,girl,2,67,2.0096342465671248e-4
klara,65,girl,12,77,2.3095796565025166e-4
lili,65,girl,0,65,1.9496451645800464e-4
nyah,65,girl,4,69,2.0696233285542032e-4
roxanne,65,girl,2,67,2.0096342465671248e-4
selena,65,girl,4,69,2.0696233285542032e-4
sonia,65,girl,4,69,2.0696233285542032e-4
aida,64,girl,3,67,2.0096342465671248e-4
ashleigh,64,girl,3,67,2.0096342465671248e-4
danielle,64,girl,6,70,2.0996178695477423e-4
emily-rose,64,girl,12,76,2.2795851155089773e-4
evalyn,64,girl,0,64,1.9196506235865074e-4
harriett,64,girl,0,64,1.9196506235865074e-4
jasmin,64,girl,2,66,1.9796397055735855e-4
kiana,64,girl,3,67,2.0096342465671248e-4
leona,64,girl,12,76,2.2795851155089773e-4
michaela,64,girl,6,70,2.0996178695477423e-4
phoenix,64,girl,3,67,2.0096342465671248e-4
adelina,63,girl,2,65,1.9496451645800464e-4
alivia,63,girl,9,72,2.1596069515348207e-4
isha,63,girl,2,65,1.9496451645800464e-4
lacey-mae,63,girl,3,66,1.9796397055735855e-4
maci,63,girl,29,92,2.759497771405604e-4
millicent,63,girl,1,64,1.9196506235865074e-4
nieve,63,girl,25,88,2.6395196074314477e-4
raven,63,girl,6,69,2.0696233285542032e-4
sabrina,63,girl,4,67,2.0096342465671248e-4
winnie,63,girl,1,64,1.9196506235865074e-4
harper-rose,62,girl,5,67,2.0096342465671248e-4
nela,62,girl,5,67,2.0096342465671248e-4
payton,62,girl,17,79,2.369568738489595e-4
princess,62,girl,1,63,1.889656082592968e-4
sumaya,62,girl,1,63,1.889656082592968e-4
marta,61,girl,5,66,1.9796397055735855e-4
mina,61,girl,9,70,2.0996178695477423e-4
saffron,61,girl,3,64,1.9196506235865074e-4
alanna,60,girl,9,69,2.0696233285542032e-4
antonina,60,girl,8,68,2.039628787560664e-4
aqsa,60,girl,0,60,1.7996724596123506e-4
lea,60,girl,4,64,1.9196506235865074e-4
lilianna,60,girl,4,64,1.9196506235865074e-4
lillie-mae,60,girl,4,64,1.9196506235865074e-4
rosanna,60,girl,2,62,1.859661541599429e-4
rosemary,60,girl,5,65,1.9496451645800464e-4
shelby,60,girl,1,61,1.8296670006058896e-4
amani,59,girl,1,60,1.7996724596123506e-4
avery,59,girl,7,66,1.9796397055735855e-4
elin,59,girl,1,60,1.7996724596123506e-4
elle,59,girl,15,74,2.219596033521899e-4
isobella,59,girl,0,59,1.7696779186188115e-4
kornelia,59,girl,6,65,1.9496451645800464e-4
lexi-mae,59,girl,2,61,1.8296670006058896e-4
renae,59,girl,3,62,1.859661541599429e-4
siya,59,girl,1,60,1.7996724596123506e-4
sylvia,59,girl,4,63,1.889656082592968e-4
amalie,58,girl,5,63,1.889656082592968e-4
andrea,58,girl,1,59,1.7696779186188115e-4
anisa,58,girl,1,59,1.7696779186188115e-4
bailey,58,girl,9,67,2.0096342465671248e-4
elisha,58,girl,2,60,1.7996724596123506e-4
farah,58,girl,4,62,1.859661541599429e-4
jannah,58,girl,0,58,0.00017396833776252722
katelyn,58,girl,3,61,1.8296670006058896e-4
kimberley,58,girl,3,61,1.8296670006058896e-4
melanie,58,girl,7,65,1.9496451645800464e-4
melisa,58,girl,1,59,1.7696779186188115e-4
caoimhe,57,girl,25,82,2.459552361470212e-4
darci,57,girl,10,67,2.0096342465671248e-4
elsie-may,57,girl,0,57,1.709688836631733e-4
giulia,57,girl,2,59,1.7696779186188115e-4
gloria,57,girl,0,57,1.709688836631733e-4
adaline,56,girl,1,57,1.709688836631733e-4
arla,56,girl,8,64,1.9196506235865074e-4
caroline,56,girl,2,58,0.00017396833776252722
farrah,56,girl,16,72,2.1596069515348207e-4
maisey,56,girl,0,56,1.6796942956381937e-4
octavia,56,girl,0,56,1.6796942956381937e-4
peggy,56,girl,3,59,1.7696779186188115e-4
thalia,56,girl,1,57,1.709688836631733e-4
agatha,55,girl,1,56,1.6796942956381937e-4
ema,55,girl,2,57,1.709688836631733e-4
marina,55,girl,6,61,1.8296670006058896e-4
martyna,55,girl,5,60,1.7996724596123506e-4
milan,55,girl,1,56,1.6796942956381937e-4
ocean,55,girl,1,56,1.6796942956381937e-4
ronnie,55,girl,1,56,1.6796942956381937e-4
summer-rose,55,girl,2,57,1.709688836631733e-4
aishah,54,girl,0,54,1.6197052136511156e-4
anabia,54,girl,3,57,1.709688836631733e-4
anaiya,54,girl,0,54,1.6197052136511156e-4
charley,54,girl,18,72,2.1596069515348207e-4
daisie,54,girl,6,60,1.7996724596123506e-4
emilija,54,girl,6,60,1.7996724596123506e-4
kaja,54,girl,5,59,1.7696779186188115e-4
lisa,54,girl,4,58,0.00017396833776252722
millie-rose,54,girl,1,55,1.6496997546446547e-4
abby,53,girl,28,81,2.4295578204766731e-4
amayah,53,girl,6,59,1.7696779186188115e-4
amelia-grace,53,girl,1,54,1.6197052136511156e-4
anabelle,53,girl,2,55,1.6496997546446547e-4
carmen,53,girl,8,61,1.8296670006058896e-4
elouise,53,girl,1,54,1.6197052136511156e-4
gia,53,girl,2,55,1.6496997546446547e-4
kacey,53,girl,18,71,2.1296124105412814e-4
katy,53,girl,9,62,1.859661541599429e-4
luisa,53,girl,7,60,1.7996724596123506e-4
marcie,53,girl,2,55,1.6496997546446547e-4
rebeca,53,girl,3,56,1.6796942956381937e-4
una,53,girl,8,61,1.8296670006058896e-4
azra,52,girl,2,54,1.6197052136511156e-4
camille,52,girl,2,54,1.6197052136511156e-4
ellie-rose,52,girl,4,56,1.6796942956381937e-4
gracie-may,52,girl,1,53,1.5897106726575763e-4
husna,52,girl,1,53,1.5897106726575763e-4
indi,52,girl,4,56,1.6796942956381937e-4
laiba,52,girl,2,54,1.6197052136511156e-4
lillia,52,girl,1,53,1.5897106726575763e-4
ruby-mae,52,girl,2,54,1.6197052136511156e-4
selina,52,girl,3,55,1.6496997546446547e-4
vanesa,52,girl,0,52,1.5597161316640372e-4
aamina,51,girl,1,52,1.5597161316640372e-4
aasiyah,51,girl,2,53,1.5897106726575763e-4
angelica,51,girl,2,53,1.5897106726575763e-4
blake,51,girl,18,69,2.0696233285542032e-4
carla,51,girl,11,62,1.859661541599429e-4
chiara,51,girl,5,56,1.6796942956381937e-4
elisabeth,51,girl,3,54,1.6197052136511156e-4
gwen,51,girl,0,51,1.5297215906704979e-4
heather,51,girl,21,72,2.1596069515348207e-4
lillie-rose,51,girl,3,54,1.6197052136511156e-4
nahla,51,girl,0,51,1.5297215906704979e-4
stefania,51,girl,0,51,1.5297215906704979e-4
tahlia,51,girl,5,56,1.6796942956381937e-4
zaynah,51,girl,0,51,1.5297215906704979e-4
avaya,50,girl,3,53,1.5897106726575763e-4
bridget,50,girl,1,51,1.5297215906704979e-4
honor,50,girl,5,55,1.6496997546446547e-4
jocelyn,50,girl,4,54,1.6197052136511156e-4
marie,50,girl,0,50,1.4997270496769588e-4
raisa,50,girl,2,52,1.5597161316640372e-4
samara,50,girl,4,54,1.6197052136511156e-4
samira,50,girl,2,52,1.5597161316640372e-4
andreea,49,girl,0,49,1.4697325086834197e-4
dahlia,49,girl,3,52,1.5597161316640372e-4
ferne,49,girl,11,60,1.7996724596123506e-4
harleen,49,girl,2,51,1.5297215906704979e-4
izabela,49,girl,2,51,1.5297215906704979e-4
kacie,49,girl,9,58,0.00017396833776252722
patricia,49,girl,3,52,1.5597161316640372e-4
prisha,49,girl,2,51,1.5297215906704979e-4
romy,49,girl,9,58,0.00017396833776252722
safia,49,girl,3,52,1.5597161316640372e-4
savanna,49,girl,4,53,1.5897106726575763e-4
soraya,49,girl,3,52,1.5597161316640372e-4
tess,49,girl,5,54,1.6197052136511156e-4
winifred,49,girl,0,49,1.4697325086834197e-4
arwen,48,girl,6,54,1.6197052136511156e-4
avneet,48,girl,2,50,1.4997270496769588e-4
bobbie,48,girl,1,49,1.4697325086834197e-4
ella-louise,48,girl,8,56,1.6796942956381937e-4
keziah,48,girl,1,49,1.4697325086834197e-4
klaudia,48,girl,3,51,1.5297215906704979e-4
maiya,48,girl,5,53,1.5897106726575763e-4
naya,48,girl,3,51,1.5297215906704979e-4
stevie,48,girl,9,57,1.709688836631733e-4
arissa,47,girl,1,48,1.4397379676898804e-4
ayva,47,girl,10,57,1.709688836631733e-4
coco,47,girl,1,48,1.4397379676898804e-4
enya,47,girl,3,50,1.4997270496769588e-4
layla-mae,47,girl,0,47,1.4097434266963413e-4
leena,47,girl,1,48,1.4397379676898804e-4
mariah,47,girl,2,49,1.4697325086834197e-4
olivia-mae,47,girl,0,47,1.4097434266963413e-4
zeynep,47,girl,1,48,1.4397379676898804e-4
alissa,46,girl,2,48,1.4397379676898804e-4
bianka,46,girl,2,48,1.4397379676898804e-4
cali,46,girl,16,62,1.859661541599429e-4
cassidy,46,girl,9,55,1.6496997546446547e-4
daisy-may,46,girl,0,46,1.379748885702802e-4
daniela,46,girl,3,49,1.4697325086834197e-4
estelle,46,girl,7,53,1.5897106726575763e-4
hawwa,46,girl,2,48,1.4397379676898804e-4
huda,46,girl,0,46,1.379748885702802e-4
leilani,46,girl,1,47,1.4097434266963413e-4
lylah,46,girl,2,48,1.4397379676898804e-4
olivia-grace,46,girl,2,48,1.4397379676898804e-4
saara,46,girl,0,46,1.379748885702802e-4
shania,46,girl,2,48,1.4397379676898804e-4
zoha,46,girl,3,49,1.4697325086834197e-4
blessing,45,girl,2,47,1.4097434266963413e-4
dollie,45,girl,0,45,1.349754344709263e-4
eleri,45,girl,0,45,1.349754344709263e-4
elia,45,girl,2,47,1.4097434266963413e-4
hajra,45,girl,1,46,1.379748885702802e-4
leonie,45,girl,2,47,1.4097434266963413e-4
maliha,45,girl,0,45,1.349754344709263e-4
niyah,45,girl,3,48,1.4397379676898804e-4
precious,45,girl,1,46,1.379748885702802e-4
roma,45,girl,5,50,1.4997270496769588e-4
saanvi,45,girl,1,46,1.379748885702802e-4
shannon,45,girl,6,51,1.5297215906704979e-4
trinity,45,girl,2,47,1.4097434266963413e-4
winter,45,girl,1,46,1.379748885702802e-4
zahraa,45,girl,1,46,1.379748885702802e-4
asiyah,44,girl,0,44,1.3197598037157238e-4
claire,44,girl,6,50,1.4997270496769588e-4
georgiana,44,girl,3,47,1.4097434266963413e-4
iga,44,girl,3,47,1.4097434266963413e-4
jana,44,girl,6,50,1.4997270496769588e-4
larissa,44,girl,1,45,1.349754344709263e-4
lilith,44,girl,3,47,1.4097434266963413e-4
sanaya,44,girl,0,44,1.3197598037157238e-4
shreya,44,girl,1,45,1.349754344709263e-4
alara,43,girl,3,46,1.379748885702802e-4
alaya,43,girl,2,45,1.349754344709263e-4
aviana,43,girl,4,47,1.4097434266963413e-4
beatriz,43,girl,1,44,1.3197598037157238e-4
elinor,43,girl,0,43,1.2897652627221845e-4
ellie-mai,43,girl,3,46,1.379748885702802e-4
hajrah,43,girl,1,44,1.3197598037157238e-4
izzy,43,girl,7,50,1.4997270496769588e-4
jasleen,43,girl,1,44,1.3197598037157238e-4
leja,43,girl,1,44,1.3197598037157238e-4
marcelina,43,girl,3,46,1.379748885702802e-4
mariya,43,girl,0,43,1.2897652627221845e-4
marlie,43,girl,3,46,1.379748885702802e-4
martina,43,girl,3,46,1.379748885702802e-4
miah,43,girl,8,51,1.5297215906704979e-4
millie-mae,43,girl,1,44,1.3197598037157238e-4
sandra,43,girl,5,48,1.4397379676898804e-4
tanisha,43,girl,0,43,1.2897652627221845e-4
valerie,43,girl,4,47,1.4097434266963413e-4
weronika,43,girl,4,47,1.4097434266963413e-4
adrianna,42,girl,7,49,1.4697325086834197e-4
ajwa,42,girl,1,43,1.2897652627221845e-4
allegra,42,girl,3,45,1.349754344709263e-4
asma,42,girl,2,44,1.3197598037157238e-4
blanka,42,girl,4,46,1.379748885702802e-4
cassandra,42,girl,3,45,1.349754344709263e-4
elina,42,girl,2,44,1.3197598037157238e-4
jaya,42,girl,3,45,1.349754344709263e-4
madiha,42,girl,0,42,1.2597707217286454e-4
meghan,42,girl,7,49,1.4697325086834197e-4
monica,42,girl,6,48,1.4397379676898804e-4
nel,42,girl,1,43,1.2897652627221845e-4
nikita,42,girl,3,45,1.349754344709263e-4
paula,42,girl,1,43,1.2897652627221845e-4
rania,42,girl,4,46,1.379748885702802e-4
zarah,42,girl,5,47,1.4097434266963413e-4
alishba,41,girl,0,41,1.229776180735106e-4
ayaana,41,girl,0,41,1.229776180735106e-4
bobbi,41,girl,8,49,1.4697325086834197e-4
brielle,41,girl,0,41,1.229776180735106e-4
chanel,41,girl,1,42,1.2597707217286454e-4
chaya,41,girl,0,41,1.229776180735106e-4
cordelia,41,girl,1,42,1.2597707217286454e-4
delia,41,girl,0,41,1.229776180735106e-4
evie-grace,41,girl,1,42,1.2597707217286454e-4
ezmae,41,girl,0,41,1.229776180735106e-4
fiona,41,girl,8,49,1.4697325086834197e-4
inara,41,girl,4,45,1.349754344709263e-4
lilly-mai,41,girl,0,41,1.229776180735106e-4
lowri,41,girl,0,41,1.229776180735106e-4
lula,41,girl,1,42,1.2597707217286454e-4
magdalena,41,girl,3,44,1.3197598037157238e-4
rihanna,41,girl,3,44,1.3197598037157238e-4
rubie,41,girl,0,41,1.229776180735106e-4
teagan,41,girl,2,43,1.2897652627221845e-4
aairah,40,girl,1,41,1.229776180735106e-4
akira,40,girl,1,41,1.229776180735106e-4
ariadne,40,girl,0,40,1.199781639741567e-4
arielle,40,girl,4,44,1.3197598037157238e-4
bluebell,40,girl,1,41,1.229776180735106e-4
cadi,40,girl,1,41,1.229776180735106e-4
cecelia,40,girl,1,41,1.229776180735106e-4
christine,40,girl,3,43,1.2897652627221845e-4
elsie-rose,40,girl,0,40,1.199781639741567e-4
emmanuella,40,girl,0,40,1.199781639741567e-4
inaayah,40,girl,0,40,1.199781639741567e-4
ingrid,40,girl,5,45,1.349754344709263e-4
isla-grace,40,girl,2,42,1.2597707217286454e-4
joni,40,girl,7,47,1.4097434266963413e-4
jorja,40,girl,5,45,1.349754344709263e-4
malak,40,girl,2,42,1.2597707217286454e-4
miyah,40,girl,6,46,1.379748885702802e-4
persephone,40,girl,1,41,1.229776180735106e-4
romilly,40,girl,1,41,1.229776180735106e-4
saarah,40,girl,1,41,1.229776180735106e-4
vivian,40,girl,3,43,1.2897652627221845e-4
zayna,40,girl,1,41,1.229776180735106e-4
arwa,39,girl,3,42,1.2597707217286454e-4
avleen,39,girl,0,39,1.1697870987480278e-4
emme,39,girl,8,47,1.4097434266963413e-4
florrie,39,girl,1,40,1.199781639741567e-4
kathleen,39,girl,6,45,1.349754344709263e-4
kathryn,39,girl,9,48,1.4397379676898804e-4
lilliana,39,girl,2,41,1.229776180735106e-4
lorena,39,girl,4,43,1.2897652627221845e-4
mahi,39,girl,0,39,1.1697870987480278e-4
manahil,39,girl,1,40,1.199781639741567e-4
mathilda,39,girl,1,40,1.199781639741567e-4
neive,39,girl,8,47,1.4097434266963413e-4
sianna,39,girl,0,39,1.1697870987480278e-4
simona,39,girl,2,41,1.229776180735106e-4
sukhmani,39,girl,1,40,1.199781639741567e-4
viktoria,39,girl,6,45,1.349754344709263e-4
zunairah,39,girl,2,41,1.229776180735106e-4
alaina,38,girl,3,41,1.229776180735106e-4
anastazja,38,girl,5,43,1.2897652627221845e-4
anisha,38,girl,0,38,1.1397925577544886e-4
celeste,38,girl,2,40,1.199781639741567e-4
dana,38,girl,1,39,1.1697870987480278e-4
ella-may,38,girl,4,42,1.2597707217286454e-4
frida,38,girl,2,40,1.199781639741567e-4
harlie,38,girl,8,46,1.379748885702802e-4
isla-rae,38,girl,0,38,1.1397925577544886e-4
kelly,38,girl,3,41,1.229776180735106e-4
kimberly,38,girl,6,44,1.3197598037157238e-4
lorelei,38,girl,1,39,1.1697870987480278e-4
margaux,38,girl,0,38,1.1397925577544886e-4
matylda,38,girl,6,44,1.3197598037157238e-4
nancie,38,girl,0,38,1.1397925577544886e-4
paloma,38,girl,1,39,1.1697870987480278e-4
reya,38,girl,3,41,1.229776180735106e-4
rumaisa,38,girl,1,39,1.1697870987480278e-4
taya,38,girl,0,38,1.1397925577544886e-4
vera,38,girl,5,43,1.2897652627221845e-4
aayat,37,girl,1,38,1.1397925577544886e-4
alissia,37,girl,2,39,1.1697870987480278e-4
ammara,37,girl,0,37,1.1097980167609496e-4
ariyah,37,girl,5,42,1.2597707217286454e-4
asia,37,girl,2,39,1.1697870987480278e-4
avani,37,girl,0,37,1.1097980167609496e-4
bryony,37,girl,3,40,1.199781639741567e-4
gracie-mai,37,girl,1,38,1.1397925577544886e-4
hadassah,37,girl,1,38,1.1397925577544886e-4
iylah,37,girl,0,37,1.1097980167609496e-4
jazmin,37,girl,4,41,1.229776180735106e-4
joyce,37,girl,1,38,1.1397925577544886e-4
keeva,37,girl,17,54,1.6197052136511156e-4
luella,37,girl,0,37,1.1097980167609496e-4
marni,37,girl,4,41,1.229776180735106e-4
melina,37,girl,0,37,1.1097980167609496e-4
roisin,37,girl,5,42,1.2597707217286454e-4
serenity,37,girl,1,38,1.1397925577544886e-4
sofija,37,girl,2,39,1.1697870987480278e-4
aniya,36,girl,1,37,1.1097980167609496e-4
anoushka,36,girl,2,38,1.1397925577544886e-4
eilidh,36,girl,184,220,6.598799018578619e-4
eleni,36,girl,0,36,1.0798034757674104e-4
emilee,36,girl,3,39,1.1697870987480278e-4
eshal,36,girl,3,39,1.1697870987480278e-4
fathima,36,girl,0,36,1.0798034757674104e-4
habiba,36,girl,3,39,1.1697870987480278e-4
jagoda,36,girl,2,38,1.1397925577544886e-4
kady,36,girl,5,41,1.229776180735106e-4
kristina,36,girl,6,42,1.2597707217286454e-4
lily-grace,36,girl,2,38,1.1397925577544886e-4
margo,36,girl,1,37,1.1097980167609496e-4
meerab,36,girl,2,38,1.1397925577544886e-4
mikayla,36,girl,6,42,1.2597707217286454e-4
nala,36,girl,0,36,1.0798034757674104e-4
rahma,36,girl,2,38,1.1397925577544886e-4
storm,36,girl,1,37,1.1097980167609496e-4
tasneem,36,girl,2,38,1.1397925577544886e-4
ananya,35,girl,0,35,1.0498089347738712e-4
anwen,35,girl,1,36,1.0798034757674104e-4
arisha,35,girl,2,37,1.1097980167609496e-4
ashley,35,girl,5,40,1.199781639741567e-4
ava-may,35,girl,3,38,1.1397925577544886e-4
dania,35,girl,1,36,1.0798034757674104e-4
darcie-mae,35,girl,0,35,1.0498089347738712e-4
elaina,35,girl,1,36,1.0798034757674104e-4
evie-may,35,girl,2,37,1.1097980167609496e-4
janelle,35,girl,0,35,1.0498089347738712e-4
kamila,35,girl,0,35,1.0498089347738712e-4
liya,35,girl,4,39,1.1697870987480278e-4
madelyn,35,girl,2,37,1.1097980167609496e-4
malika,35,girl,1,36,1.0798034757674104e-4
matilde,35,girl,1,36,1.0798034757674104e-4
monika,35,girl,4,39,1.1697870987480278e-4
petra,35,girl,3,38,1.1397925577544886e-4
umaima,35,girl,0,35,1.0498089347738712e-4
aine,34,girl,5,39,1.1697870987480278e-4
alena,34,girl,2,36,1.0798034757674104e-4
alesia,34,girl,2,36,1.0798034757674104e-4
amaia,34,girl,1,35,1.0498089347738712e-4
asha,34,girl,4,38,1.1397925577544886e-4
barbara,34,girl,2,36,1.0798034757674104e-4
bronte,34,girl,0,34,1.019814393780332e-4
chantelle,34,girl,3,37,1.1097980167609496e-4
dina,34,girl,2,36,1.0798034757674104e-4
ellis,34,girl,31,65,1.9496451645800464e-4
elowen,34,girl,0,34,1.019814393780332e-4
estera,34,girl,2,36,1.0798034757674104e-4
hania,34,girl,0,34,1.019814393780332e-4
jemimah,34,girl,0,34,1.019814393780332e-4
kelsie,34,girl,6,40,1.199781639741567e-4
krystal,34,girl,1,35,1.0498089347738712e-4
lorelai,34,girl,2,36,1.0798034757674104e-4
mari,34,girl,0,34,1.019814393780332e-4
nailah,34,girl,0,34,1.019814393780332e-4
nella,34,girl,0,34,1.019814393780332e-4
niah,34,girl,1,35,1.0498089347738712e-4
poppy-rose,34,girl,3,37,1.1097980167609496e-4
reem,34,girl,0,34,1.019814393780332e-4
renesmae,34,girl,0,34,1.019814393780332e-4
roseanna,34,girl,1,35,1.0498089347738712e-4
safiyah,34,girl,0,34,1.019814393780332e-4
aadhya,33,girl,2,35,1.0498089347738712e-4
alaia,33,girl,2,35,1.0498089347738712e-4
alayah,33,girl,0,33,9.898198527867928e-5
alessandra,33,girl,2,35,1.0498089347738712e-4
artemis,33,girl,0,33,9.898198527867928e-5
bo,33,girl,1,34,1.019814393780332e-4
carolina,33,girl,0,33,9.898198527867928e-5
catrin,33,girl,1,34,1.019814393780332e-4
dalia,33,girl,1,34,1.019814393780332e-4
devon,33,girl,8,41,1.229776180735106e-4
eva-rose,33,girl,4,37,1.1097980167609496e-4
faiza,33,girl,1,34,1.019814393780332e-4
gemma,33,girl,8,41,1.229776180735106e-4
halimah,33,girl,1,34,1.019814393780332e-4
hetty,33,girl,0,33,9.898198527867928e-5
hibah,33,girl,0,33,9.898198527867928e-5
hira,33,girl,1,34,1.019814393780332e-4
ivy-mae,33,girl,0,33,9.898198527867928e-5
jamie,33,girl,1,34,1.019814393780332e-4
lainey,33,girl,2,35,1.0498089347738712e-4
marwah,33,girl,1,34,1.019814393780332e-4
neriah,33,girl,0,33,9.898198527867928e-5
nuala,33,girl,14,47,1.4097434266963413e-4
rayna,33,girl,2,35,1.0498089347738712e-4
rebekah,33,girl,11,44,1.3197598037157238e-4
skyla-rose,33,girl,1,34,1.019814393780332e-4
theadora,33,girl,0,33,9.898198527867928e-5
willow-rose,33,girl,0,33,9.898198527867928e-5
zunaira,33,girl,1,34,1.019814393780332e-4
aanya,32,girl,2,34,1.019814393780332e-4
amie,32,girl,3,35,1.0498089347738712e-4
anne,32,girl,2,34,1.019814393780332e-4
annika,32,girl,2,34,1.019814393780332e-4
ayeza,32,girl,3,35,1.0498089347738712e-4
giovanna,32,girl,2,34,1.019814393780332e-4
hailey,32,girl,5,37,1.1097980167609496e-4
haya,32,girl,0,32,9.598253117932537e-5
jiya,32,girl,0,32,9.598253117932537e-5
juniper,32,girl,2,34,1.019814393780332e-4
kadie,32,girl,2,34,1.019814393780332e-4
laylah,32,girl,8,40,1.199781639741567e-4
leen,32,girl,2,34,1.019814393780332e-4
marissa,32,girl,1,33,9.898198527867928e-5
meera,32,girl,0,32,9.598253117932537e-5
oriana,32,girl,1,33,9.898198527867928e-5
perrie,32,girl,14,46,1.379748885702802e-4
rosie-may,32,girl,0,32,9.598253117932537e-5
roxy,32,girl,1,33,9.898198527867928e-5
ruby-leigh,32,girl,1,33,9.898198527867928e-5
ryleigh,32,girl,9,41,1.229776180735106e-4
sian,32,girl,1,33,9.898198527867928e-5
sophia-rose,32,girl,4,36,1.0798034757674104e-4
teresa,32,girl,1,33,9.898198527867928e-5
tori,32,girl,0,32,9.598253117932537e-5
viola,32,girl,1,33,9.898198527867928e-5
alya,31,girl,3,34,1.019814393780332e-4
amiya,31,girl,0,31,9.298307707997145e-5
ava-mai,31,girl,2,33,9.898198527867928e-5
avni,31,girl,1,32,9.598253117932537e-5
celia,31,girl,1,32,9.598253117932537e-5
celine,31,girl,3,34,1.019814393780332e-4
coral,31,girl,6,37,1.1097980167609496e-4
ellia,31,girl,3,34,1.019814393780332e-4
esha,31,girl,1,32,9.598253117932537e-5
ivie,31,girl,4,35,1.0498089347738712e-4
jia,31,girl,1,32,9.598253117932537e-5
katerina,31,girl,2,33,9.898198527867928e-5
layan,31,girl,7,38,1.1397925577544886e-4
malia,31,girl,3,34,1.019814393780332e-4
manal,31,girl,1,32,9.598253117932537e-5
mariana,31,girl,0,31,9.298307707997145e-5
mariella,31,girl,4,35,1.0498089347738712e-4
mercy,31,girl,0,31,9.298307707997145e-5
meryem,31,girl,0,31,9.298307707997145e-5
michalina,31,girl,2,33,9.898198527867928e-5
noelle,31,girl,3,34,1.019814393780332e-4
pia,31,girl,1,32,9.598253117932537e-5
reina,31,girl,2,33,9.898198527867928e-5
rosalind,31,girl,1,32,9.598253117932537e-5
saira,31,girl,1,32,9.598253117932537e-5
shiloh,31,girl,4,35,1.0498089347738712e-4
tanya,31,girl,0,31,9.298307707997145e-5
teodora,31,girl,1,32,9.598253117932537e-5
wynter,31,girl,3,34,1.019814393780332e-4
zaina,31,girl,2,33,9.898198527867928e-5
aaliya,30,girl,1,31,9.298307707997145e-5
agata,30,girl,3,33,9.898198527867928e-5
alexandria,30,girl,4,34,1.019814393780332e-4
aseel,30,girl,1,31,9.298307707997145e-5
ava-leigh,30,girl,2,32,9.598253117932537e-5
carly,30,girl,35,65,1.9496451645800464e-4
cataleya,30,girl,1,31,9.298307707997145e-5
eesha,30,girl,0,30,8.998362298061753e-5
efa,30,girl,0,30,8.998362298061753e-5
elysia,30,girl,0,30,8.998362298061753e-5
emmi,30,girl,5,35,1.0498089347738712e-4
esme-rose,30,girl,2,32,9.598253117932537e-5
everley,30,girl,0,30,8.998362298061753e-5
gaia,30,girl,2,32,9.598253117932537e-5
hadiya,30,girl,3,33,9.898198527867928e-5
indie-rose,30,girl,2,32,9.598253117932537e-5
isabela,30,girl,0,30,8.998362298061753e-5
kalina,30,girl,2,32,9.598253117932537e-5
lorna,30,girl,2,32,9.598253117932537e-5
luana,30,girl,1,31,9.298307707997145e-5
maizie,30,girl,5,35,1.0498089347738712e-4
mercedes,30,girl,0,30,8.998362298061753e-5
merryn,30,girl,7,37,1.1097980167609496e-4
misha,30,girl,3,33,9.898198527867928e-5
raina,30,girl,2,32,9.598253117932537e-5
remy,30,girl,3,33,9.898198527867928e-5
renesmee,30,girl,5,35,1.0498089347738712e-4
sharon,30,girl,2,32,9.598253117932537e-5
sofie,30,girl,0,30,8.998362298061753e-5
teigan,30,girl,4,34,1.019814393780332e-4
adela,29,girl,0,29,8.698416888126361e-5
adina,29,girl,0,29,8.698416888126361e-5
alaa,29,girl,0,29,8.698416888126361e-5
amaiya,29,girl,0,29,8.698416888126361e-5
amaris,29,girl,1,30,8.998362298061753e-5
amber-rose,29,girl,3,32,9.598253117932537e-5
aria-rose,29,girl,3,32,9.598253117932537e-5
ava-marie,29,girl,3,32,9.598253117932537e-5
bushra,29,girl,1,30,8.998362298061753e-5
cienna,29,girl,2,31,9.298307707997145e-5
clarissa,29,girl,0,29,8.698416888126361e-5
denisa,29,girl,1,30,8.998362298061753e-5
elija,29,girl,0,29,8.698416888126361e-5
ella-mai,29,girl,1,30,8.998362298061753e-5
felicia,29,girl,2,31,9.298307707997145e-5
gracie-leigh,29,girl,0,29,8.698416888126361e-5
havana,29,girl,1,30,8.998362298061753e-5
ioana,29,girl,2,31,9.298307707997145e-5
isadora,29,girl,1,30,8.998362298061753e-5
israa,29,girl,0,29,8.698416888126361e-5
izabelle,29,girl,0,29,8.698416888126361e-5
jamila,29,girl,0,29,8.698416888126361e-5
jayda,29,girl,0,29,8.698416888126361e-5
jazmine,29,girl,0,29,8.698416888126361e-5
kaira,29,girl,1,30,8.998362298061753e-5
lidia,29,girl,3,32,9.598253117932537e-5
mahira,29,girl,0,29,8.698416888126361e-5
maysa,29,girl,1,30,8.998362298061753e-5
mia-grace,29,girl,0,29,8.698416888126361e-5
mika,29,girl,1,30,8.998362298061753e-5
naira,29,girl,1,30,8.998362298061753e-5
nour,29,girl,0,29,8.698416888126361e-5
pandora,29,girl,2,31,9.298307707997145e-5
pollyanna,29,girl,0,29,8.698416888126361e-5
rida,29,girl,0,29,8.698416888126361e-5
roza,29,girl,1,30,8.998362298061753e-5
seerat,29,girl,1,30,8.998362298061753e-5
tayah,29,girl,0,29,8.698416888126361e-5
zuri,29,girl,2,31,9.298307707997145e-5
aaira,28,girl,0,28,8.398471478190969e-5
aima,28,girl,1,29,8.698416888126361e-5
amelija,28,girl,2,30,8.998362298061753e-5
areesha,28,girl,0,28,8.398471478190969e-5
dixie,28,girl,2,30,8.998362298061753e-5
eileen,28,girl,1,29,8.698416888126361e-5
elara,28,girl,1,29,8.698416888126361e-5
enid,28,girl,2,30,8.998362298061753e-5
esma,28,girl,0,28,8.398471478190969e-5
eveline,28,girl,1,29,8.698416888126361e-5
freja,28,girl,2,30,8.998362298061753e-5
harleigh,28,girl,6,34,1.019814393780332e-4
ivana,28,girl,0,28,8.398471478190969e-5
kaylee,28,girl,1,29,8.698416888126361e-5
kennedy,28,girl,6,34,1.019814393780332e-4
kinga,28,girl,0,28,8.398471478190969e-5
lettie,28,girl,0,28,8.398471478190969e-5
lilly-ann,28,girl,1,29,8.698416888126361e-5
marla,28,girl,1,29,8.698416888126361e-5
marlowe,28,girl,1,29,8.698416888126361e-5
orlagh,28,girl,25,53,1.5897106726575763e-4
pheobe,28,girl,2,30,8.998362298061753e-5
poppy-mae,28,girl,0,28,8.398471478190969e-5
roberta,28,girl,0,28,8.398471478190969e-5
sally,28,girl,8,36,1.0798034757674104e-4
seraphina,28,girl,0,28,8.398471478190969e-5
shayla,28,girl,0,28,8.398471478190969e-5
siyana,28,girl,0,28,8.398471478190969e-5
star,28,girl,1,29,8.698416888126361e-5
umaiza,28,girl,0,28,8.398471478190969e-5
aadya,27,girl,2,29,8.698416888126361e-5
aariya,27,girl,0,27,8.098526068255578e-5
adelyn,27,girl,6,33,9.898198527867928e-5
aleah,27,girl,5,32,9.598253117932537e-5
amarachi,27,girl,1,28,8.398471478190969e-5
anabel,27,girl,2,29,8.698416888126361e-5
aryana,27,girl,6,33,9.898198527867928e-5
bea,27,girl,0,27,8.098526068255578e-5
dominika,27,girl,2,29,8.698416888126361e-5
dora,27,girl,2,29,8.698416888126361e-5
ella-grace,27,girl,3,30,8.998362298061753e-5
ellena,27,girl,1,28,8.398471478190969e-5
evelynn,27,girl,1,28,8.398471478190969e-5
faatimah,27,girl,0,27,8.098526068255578e-5
gwendolyn,27,girl,1,28,8.398471478190969e-5
julie,27,girl,2,29,8.698416888126361e-5
keeley,27,girl,1,28,8.398471478190969e-5
khadeeja,27,girl,1,28,8.398471478190969e-5
khadeejah,27,girl,0,27,8.098526068255578e-5
khushi,27,girl,1,28,8.398471478190969e-5
kylie,27,girl,4,31,9.298307707997145e-5
larisa,27,girl,0,27,8.098526068255578e-5
lexi-may,27,girl,1,28,8.398471478190969e-5
lily-ann,27,girl,0,27,8.098526068255578e-5
lola-mae,27,girl,0,27,8.098526068255578e-5
maleeha,27,girl,1,28,8.398471478190969e-5
mathilde,27,girl,2,29,8.698416888126361e-5
mehreen,27,girl,0,27,8.098526068255578e-5
rachael,27,girl,7,34,1.019814393780332e-4
rhia,27,girl,4,31,9.298307707997145e-5
ruhi,27,girl,0,27,8.098526068255578e-5
sahar,27,girl,0,27,8.098526068255578e-5
sama,27,girl,1,28,8.398471478190969e-5
sierra,27,girl,1,28,8.398471478190969e-5
sinead,27,girl,1,28,8.398471478190969e-5
tayla,27,girl,1,28,8.398471478190969e-5
willa,27,girl,2,29,8.698416888126361e-5
alison,26,girl,4,30,8.998362298061753e-5
ameena,26,girl,0,26,7.798580658320186e-5
anum,26,girl,0,26,7.798580658320186e-5
areeba,26,girl,0,26,7.798580658320186e-5
ariel,26,girl,0,26,7.798580658320186e-5
aylin,26,girl,1,27,8.098526068255578e-5
cassia,26,girl,0,26,7.798580658320186e-5
christabel,26,girl,1,27,8.098526068255578e-5
cindy,26,girl,1,27,8.098526068255578e-5
darcie-rose,26,girl,0,26,7.798580658320186e-5
daya,26,girl,0,26,7.798580658320186e-5
delilah-rose,26,girl,0,26,7.798580658320186e-5
demi-leigh,26,girl,1,27,8.098526068255578e-5
eleonora,26,girl,1,27,8.098526068255578e-5
elissia,26,girl,0,26,7.798580658320186e-5
ella-rae,26,girl,2,28,8.398471478190969e-5
ettie,26,girl,0,26,7.798580658320186e-5
faryal,26,girl,0,26,7.798580658320186e-5
frieda,26,girl,6,32,9.598253117932537e-5
haadiya,26,girl,1,27,8.098526068255578e-5
hajar,26,girl,0,26,7.798580658320186e-5
hanan,26,girl,0,26,7.798580658320186e-5
isla-may,26,girl,1,27,8.098526068255578e-5
jenny,26,girl,3,29,8.698416888126361e-5
johanna,26,girl,2,28,8.398471478190969e-5
kaitlin,26,girl,5,31,9.298307707997145e-5
lailah,26,girl,4,30,8.998362298061753e-5
lilly-anne,26,girl,3,29,8.698416888126361e-5
lily-mai,26,girl,0,26,7.798580658320186e-5
linda,26,girl,4,30,8.998362298061753e-5
lucinda,26,girl,0,26,7.798580658320186e-5
luiza,26,girl,1,27,8.098526068255578e-5
madina,26,girl,0,26,7.798580658320186e-5
marianna,26,girl,2,28,8.398471478190969e-5
marianne,26,girl,4,30,8.998362298061753e-5
milla,26,girl,5,31,9.298307707997145e-5
mylah,26,girl,5,31,9.298307707997145e-5
nana,26,girl,1,27,8.098526068255578e-5
neha,26,girl,1,27,8.098526068255578e-5
paulina,26,girl,3,29,8.698416888126361e-5
rayah,26,girl,3,29,8.698416888126361e-5
sarina,26,girl,0,26,7.798580658320186e-5
scarlette,26,girl,2,28,8.398471478190969e-5
seher,26,girl,0,26,7.798580658320186e-5
suki,26,girl,0,26,7.798580658320186e-5
sumaiya,26,girl,0,26,7.798580658320186e-5
umme,26,girl,0,26,7.798580658320186e-5
valeria,26,girl,2,28,8.398471478190969e-5
ziva,26,girl,1,27,8.098526068255578e-5
afiyah,25,girl,2,27,8.098526068255578e-5
aiva,25,girl,2,27,8.098526068255578e-5
amanah,25,girl,0,25,7.498635248384794e-5
amari,25,girl,1,26,7.798580658320186e-5
amelia-lily,25,girl,2,27,8.098526068255578e-5
amelia-mae,25,girl,1,26,7.798580658320186e-5
anita,25,girl,3,28,8.398471478190969e-5
anjali,25,girl,0,25,7.498635248384794e-5
anouk,25,girl,2,27,8.098526068255578e-5
arina,25,girl,1,26,7.798580658320186e-5
austeja,25,girl,0,25,7.498635248384794e-5
avaani,25,girl,0,25,7.498635248384794e-5
bow,25,girl,0,25,7.498635248384794e-5
cadence,25,girl,2,27,8.098526068255578e-5
divine,25,girl,1,26,7.798580658320186e-5
elizah,25,girl,0,25,7.498635248384794e-5
elliana,25,girl,2,27,8.098526068255578e-5
estella,25,girl,1,26,7.798580658320186e-5
favour,25,girl,0,25,7.498635248384794e-5
haaniya,25,girl,0,25,7.498635248384794e-5
hadia,25,girl,0,25,7.498635248384794e-5
jessica-rose,25,girl,4,29,8.698416888126361e-5
kaci,25,girl,9,34,1.019814393780332e-4
kiki,25,girl,0,25,7.498635248384794e-5
kylah,25,girl,4,29,8.698416888126361e-5
layla-may,25,girl,0,25,7.498635248384794e-5
leilah,25,girl,1,26,7.798580658320186e-5
leni,25,girl,1,26,7.798580658320186e-5
lulu,25,girl,1,26,7.798580658320186e-5
maisha,25,girl,0,25,7.498635248384794e-5
maliyah,25,girl,1,26,7.798580658320186e-5
noura,25,girl,1,26,7.798580658320186e-5
oluwadarasimi,25,girl,1,26,7.798580658320186e-5
porsha,25,girl,0,25,7.498635248384794e-5
rhiannon,25,girl,8,33,9.898198527867928e-5
sadia,25,girl,0,25,7.498635248384794e-5
sakina,25,girl,1,26,7.798580658320186e-5
skylah,25,girl,3,28,8.398471478190969e-5
sumayah,25,girl,0,25,7.498635248384794e-5
tala,25,girl,1,26,7.798580658320186e-5
tilly-rose,25,girl,0,25,7.498635248384794e-5
willow-grace,25,girl,0,25,7.498635248384794e-5
zelda,25,girl,2,27,8.098526068255578e-5
aasiya,24,girl,0,24,7.198689838449402e-5
abeeha,24,girl,2,26,7.798580658320186e-5
adalyn,24,girl,2,26,7.798580658320186e-5
alise,24,girl,2,26,7.798580658320186e-5
anabella,24,girl,0,24,7.198689838449402e-5
aneira,24,girl,0,24,7.198689838449402e-5
aniela,24,girl,4,28,8.398471478190969e-5
araya,24,girl,0,24,7.198689838449402e-5
avianna,24,girl,2,26,7.798580658320186e-5
betsie,24,girl,0,24,7.198689838449402e-5
bibi,24,girl,2,26,7.798580658320186e-5
catalina,24,girl,0,24,7.198689838449402e-5
cece,24,girl,0,24,7.198689838449402e-5
clodagh,24,girl,3,27,8.098526068255578e-5
eiliyah,24,girl,2,26,7.798580658320186e-5
eliza-rose,24,girl,0,24,7.198689838449402e-5
eloisa,24,girl,0,24,7.198689838449402e-5
elsie-mai,24,girl,0,24,7.198689838449402e-5
emelie,24,girl,2,26,7.798580658320186e-5
fatma,24,girl,0,24,7.198689838449402e-5
gurleen,24,girl,0,24,7.198689838449402e-5
haniyah,24,girl,0,24,7.198689838449402e-5
harlyn,24,girl,3,27,8.098526068255578e-5
ilaria,24,girl,1,25,7.498635248384794e-5
indianna,24,girl,1,25,7.498635248384794e-5
indy,24,girl,3,27,8.098526068255578e-5
irene,24,girl,1,25,7.498635248384794e-5
jane,24,girl,2,26,7.798580658320186e-5
jasmina,24,girl,1,25,7.498635248384794e-5
jersey,24,girl,0,24,7.198689838449402e-5
kali,24,girl,10,34,1.019814393780332e-4
krisha,24,girl,1,25,7.498635248384794e-5
livvy,24,girl,2,26,7.798580658320186e-5
luciana,24,girl,2,26,7.798580658320186e-5
maha,24,girl,1,25,7.498635248384794e-5
maham,24,girl,0,24,7.198689838449402e-5
mariyah,24,girl,0,24,7.198689838449402e-5
mikaela,24,girl,1,25,7.498635248384794e-5
naima,24,girl,0,24,7.198689838449402e-5
nansi,24,girl,0,24,7.198689838449402e-5
navya,24,girl,3,27,8.098526068255578e-5
rabia,24,girl,3,27,8.098526068255578e-5
rebeka,24,girl,3,27,8.098526068255578e-5
riva,24,girl,0,24,7.198689838449402e-5
shyla,24,girl,1,25,7.498635248384794e-5
sumayya,24,girl,1,25,7.498635248384794e-5
abbey,23,girl,15,38,1.1397925577544886e-4
ailsa,23,girl,45,68,2.039628787560664e-4
aisling,23,girl,4,27,8.098526068255578e-5
aiyana,23,girl,1,24,7.198689838449402e-5
alarna,23,girl,0,23,6.89874442851401e-5
aleesa,23,girl,0,23,6.89874442851401e-5
alex,23,girl,14,37,1.1097980167609496e-4
allana,23,girl,0,23,6.89874442851401e-5
anni,23,girl,1,24,7.198689838449402e-5
aura,23,girl,1,24,7.198689838449402e-5
ayaat,23,girl,3,26,7.798580658320186e-5
cariad,23,girl,0,23,6.89874442851401e-5
daisy-rae,23,girl,0,23,6.89874442851401e-5
davina,23,girl,1,24,7.198689838449402e-5
duaa,23,girl,2,25,7.498635248384794e-5
eila,23,girl,4,27,8.098526068255578e-5
elana,23,girl,2,25,7.498635248384794e-5
emi,23,girl,1,24,7.198689838449402e-5
essie,23,girl,1,24,7.198689838449402e-5
eunice,23,girl,0,23,6.89874442851401e-5
evie-mai,23,girl,0,23,6.89874442851401e-5
gabriele,23,girl,1,24,7.198689838449402e-5
gianna,23,girl,6,29,8.698416888126361e-5
hadley,23,girl,3,26,7.798580658320186e-5
harper-rae,23,girl,0,23,6.89874442851401e-5
hibba,23,girl,2,25,7.498635248384794e-5
iliana,23,girl,0,23,6.89874442851401e-5
irina,23,girl,0,23,6.89874442851401e-5
isabell,23,girl,0,23,6.89874442851401e-5
jada,23,girl,3,26,7.798580658320186e-5
juliana,23,girl,0,23,6.89874442851401e-5
kendra,23,girl,0,23,6.89874442851401e-5
lacey-may,23,girl,5,28,8.398471478190969e-5
leonor,23,girl,0,23,6.89874442851401e-5
liv,23,girl,4,27,8.098526068255578e-5
mabli,23,girl,0,23,6.89874442851401e-5
makayla,23,girl,2,25,7.498635248384794e-5
mannat,23,girl,0,23,6.89874442851401e-5
minha,23,girl,1,24,7.198689838449402e-5
miray,23,girl,1,24,7.198689838449402e-5
nawal,23,girl,0,23,6.89874442851401e-5
niya,23,girl,1,24,7.198689838449402e-5
olivia-may,23,girl,2,25,7.498635248384794e-5
rosie-mae,23,girl,1,24,7.198689838449402e-5
roxie,23,girl,1,24,7.198689838449402e-5
saba,23,girl,0,23,6.89874442851401e-5
samanta,23,girl,2,25,7.498635248384794e-5
sameeha,23,girl,0,23,6.89874442851401e-5
sheikh,23,girl,0,23,6.89874442851401e-5
sidra,23,girl,3,26,7.798580658320186e-5
taliah,23,girl,1,24,7.198689838449402e-5
tanvi,23,girl,0,23,6.89874442851401e-5
tatiana,23,girl,2,25,7.498635248384794e-5
trixie,23,girl,0,23,6.89874442851401e-5
veronika,23,girl,2,25,7.498635248384794e-5
yasmeen,23,girl,1,24,7.198689838449402e-5
aaradhya,22,girl,1,23,6.89874442851401e-5
amarah,22,girl,0,22,6.598799018578619e-5
amrit,22,girl,0,22,6.598799018578619e-5
arfa,22,girl,0,22,6.598799018578619e-5
avia,22,girl,2,24,7.198689838449402e-5
brodie,22,girl,8,30,8.998362298061753e-5
coralie,22,girl,0,22,6.598799018578619e-5
elsi,22,girl,0,22,6.598799018578619e-5
ezmai,22,girl,1,23,6.89874442851401e-5
giorgia,22,girl,3,25,7.498635248384794e-5
giselle,22,girl,1,23,6.89874442851401e-5
hollie-mae,22,girl,0,22,6.598799018578619e-5
ivy-grace,22,girl,0,22,6.598799018578619e-5
judy,22,girl,1,23,6.89874442851401e-5
kaiya,22,girl,3,25,7.498635248384794e-5
kourtney,22,girl,4,26,7.798580658320186e-5
laurel,22,girl,2,24,7.198689838449402e-5
leanne,22,girl,0,22,6.598799018578619e-5
lilly-grace,22,girl,1,23,6.89874442851401e-5
lyla-rose,22,girl,0,22,6.598799018578619e-5
maariyah,22,girl,0,22,6.598799018578619e-5
maryama,22,girl,0,22,6.598799018578619e-5
momina,22,girl,0,22,6.598799018578619e-5
monroe,22,girl,2,24,7.198689838449402e-5
naila,22,girl,2,24,7.198689838449402e-5
naina,22,girl,0,22,6.598799018578619e-5
nuha,22,girl,0,22,6.598799018578619e-5
olympia,22,girl,0,22,6.598799018578619e-5
paislee,22,girl,0,22,6.598799018578619e-5
patrycja,22,girl,2,24,7.198689838449402e-5
priscilla,22,girl,1,23,6.89874442851401e-5
rayan,22,girl,0,22,6.598799018578619e-5
rivka,22,girl,1,23,6.89874442851401e-5
roxana,22,girl,4,26,7.798580658320186e-5
roya,22,girl,0,22,6.598799018578619e-5
ruby-may,22,girl,1,23,6.89874442851401e-5
ruqayya,22,girl,0,22,6.598799018578619e-5
safiyya,22,girl,0,22,6.598799018578619e-5
scout,22,girl,3,25,7.498635248384794e-5
selma,22,girl,0,22,6.598799018578619e-5
shae,22,girl,1,23,6.89874442851401e-5
sumaiyah,22,girl,0,22,6.598799018578619e-5
talitha,22,girl,0,22,6.598799018578619e-5
taliyah,22,girl,1,23,6.89874442851401e-5
tamsin,22,girl,5,27,8.098526068255578e-5
teja,22,girl,1,23,6.89874442851401e-5
tina,22,girl,3,25,7.498635248384794e-5
uma,22,girl,1,23,6.89874442851401e-5
vogue,22,girl,1,23,6.89874442851401e-5
yasmina,22,girl,0,22,6.598799018578619e-5
zaara,22,girl,0,22,6.598799018578619e-5
ziya,22,girl,0,22,6.598799018578619e-5
zosia,22,girl,3,25,7.498635248384794e-5
aalia,21,girl,3,24,7.198689838449402e-5
aiya,21,girl,0,21,6.298853608643227e-5
alizah,21,girl,1,22,6.598799018578619e-5
anam,21,girl,0,21,6.298853608643227e-5
autumn-rose,21,girl,0,21,6.298853608643227e-5
avah,21,girl,5,26,7.798580658320186e-5
ayanna,21,girl,0,21,6.298853608643227e-5
aylah,21,girl,2,23,6.89874442851401e-5
azalea,21,girl,0,21,6.298853608643227e-5
bluebelle,21,girl,0,21,6.298853608643227e-5
bridie,21,girl,0,21,6.298853608643227e-5
carina,21,girl,1,22,6.598799018578619e-5
chanelle,21,girl,1,22,6.598799018578619e-5
cherry,21,girl,2,23,6.89874442851401e-5
drew,21,girl,2,23,6.89874442851401e-5
ebonie,21,girl,2,23,6.89874442851401e-5
ellora,21,girl,0,21,6.298853608643227e-5
eman,21,girl,2,23,6.89874442851401e-5
evelin,21,girl,0,21,6.298853608643227e-5
fallon,21,girl,4,25,7.498635248384794e-5
gabija,21,girl,3,24,7.198689838449402e-5
goda,21,girl,0,21,6.298853608643227e-5
hamna,21,girl,0,21,6.298853608643227e-5
harriette,21,girl,0,21,6.298853608643227e-5
jayla,21,girl,1,22,6.598799018578619e-5
kamile,21,girl,0,21,6.298853608643227e-5
katrina,21,girl,2,23,6.89874442851401e-5
kaycee,21,girl,3,24,7.198689838449402e-5
kiran,21,girl,1,22,6.598799018578619e-5
lacey-mai,21,girl,0,21,6.298853608643227e-5
leticia,21,girl,1,22,6.598799018578619e-5
leya,21,girl,1,22,6.598799018578619e-5
lowenna,21,girl,0,21,6.298853608643227e-5
mariyam,21,girl,1,22,6.598799018578619e-5
medina,21,girl,1,22,6.598799018578619e-5
menaal,21,girl,2,23,6.89874442851401e-5
miruna,21,girl,1,22,6.598799018578619e-5
raeya,21,girl,0,21,6.298853608643227e-5
ramona,21,girl,0,21,6.298853608643227e-5
rhian,21,girl,3,24,7.198689838449402e-5
susan,21,girl,2,23,6.89874442851401e-5
susanna,21,girl,2,23,6.89874442851401e-5
tasnim,21,girl,1,22,6.598799018578619e-5
teegan,21,girl,2,23,6.89874442851401e-5
thea-rose,21,girl,1,22,6.598799018578619e-5
yana,21,girl,1,22,6.598799018578619e-5
amaiyah,20,girl,1,21,6.298853608643227e-5
amelia-may,20,girl,2,22,6.598799018578619e-5
ania,20,girl,0,20,5.998908198707835e-5
aroush,20,girl,3,23,6.89874442851401e-5
asmaa,20,girl,0,20,5.998908198707835e-5
aubrie,20,girl,0,20,5.998908198707835e-5
ava-rae,20,girl,0,20,5.998908198707835e-5
ayse,20,girl,3,23,6.89874442851401e-5
beaux,20,girl,1,21,6.298853608643227e-5
bethel,20,girl,2,22,6.598799018578619e-5
bronwyn,20,girl,0,20,5.998908198707835e-5
calista,20,girl,0,20,5.998908198707835e-5
celina,20,girl,0,20,5.998908198707835e-5
cleopatra,20,girl,1,21,6.298853608643227e-5
daisy-mai,20,girl,0,20,5.998908198707835e-5
darcie-rae,20,girl,0,20,5.998908198707835e-5
defne,20,girl,0,20,5.998908198707835e-5
ebony-rose,20,girl,0,20,5.998908198707835e-5
eden-rose,20,girl,1,21,6.298853608643227e-5
emilia-rose,20,girl,0,20,5.998908198707835e-5
esmeralda,20,girl,0,20,5.998908198707835e-5
fareeha,20,girl,0,20,5.998908198707835e-5
hala,20,girl,1,21,6.298853608643227e-5
haneen,20,girl,0,20,5.998908198707835e-5
harlee,20,girl,1,21,6.298853608643227e-5
heavenly,20,girl,0,20,5.998908198707835e-5
ieva,20,girl,3,23,6.89874442851401e-5
iyla-rose,20,girl,0,20,5.998908198707835e-5
jaime,20,girl,9,29,8.698416888126361e-5
japji,20,girl,0,20,5.998908198707835e-5
joanne,20,girl,4,24,7.198689838449402e-5
jodie,20,girl,4,24,7.198689838449402e-5
jolie,20,girl,0,20,5.998908198707835e-5
june,20,girl,0,20,5.998908198707835e-5
kinza,20,girl,1,21,6.298853608643227e-5
kya,20,girl,1,21,6.298853608643227e-5
lennox,20,girl,3,23,6.89874442851401e-5
leonora,20,girl,1,21,6.298853608643227e-5
lily-rae,20,girl,0,20,5.998908198707835e-5
lori,20,girl,12,32,9.598253117932537e-5
malka,20,girl,0,20,5.998908198707835e-5
marcia,20,girl,1,21,6.298853608643227e-5
mayar,20,girl,1,21,6.298853608643227e-5
millie-rae,20,girl,2,22,6.598799018578619e-5
mimi,20,girl,0,20,5.998908198707835e-5
miranda,20,girl,1,21,6.298853608643227e-5
muntaha,20,girl,2,22,6.598799018578619e-5
nabeeha,20,girl,0,20,5.998908198707835e-5
nada,20,girl,1,21,6.298853608643227e-5
nafisa,20,girl,0,20,5.998908198707835e-5
nancy-may,20,girl,0,20,5.998908198707835e-5
nimrat,20,girl,1,21,6.298853608643227e-5
nirvana,20,girl,0,20,5.998908198707835e-5
raiya,20,girl,0,20,5.998908198707835e-5
reyah,20,girl,1,21,6.298853608643227e-5
rio,20,girl,2,22,6.598799018578619e-5
saffiyah,20,girl,0,20,5.998908198707835e-5
shanice,20,girl,1,21,6.298853608643227e-5
shivani,20,girl,0,20,5.998908198707835e-5
siana,20,girl,0,20,5.998908198707835e-5
sienna-mae,20,girl,0,20,5.998908198707835e-5
tilda,20,girl,0,20,5.998908198707835e-5
umaymah,20,girl,0,20,5.998908198707835e-5
zehra,20,girl,1,21,6.298853608643227e-5
aaisha,19,girl,1,20,5.998908198707835e-5
aaria,19,girl,2,21,6.298853608643227e-5
abrish,19,girl,0,19,5.698962788772443e-5
aicha,19,girl,2,21,6.298853608643227e-5
alisia,19,girl,2,21,6.298853608643227e-5
amrita,19,girl,0,19,5.698962788772443e-5
anaiah,19,girl,0,19,5.698962788772443e-5
anneliese,19,girl,0,19,5.698962788772443e-5
areej,19,girl,1,20,5.998908198707835e-5
ariela,19,girl,0,19,5.698962788772443e-5
azaria,19,girl,1,20,5.998908198707835e-5
blythe,19,girl,3,22,6.598799018578619e-5
bree,19,girl,6,25,7.498635248384794e-5
brogan,19,girl,6,25,7.498635248384794e-5
charis,19,girl,1,20,5.998908198707835e-5
dorothea,19,girl,0,19,5.698962788772443e-5
falak,19,girl,0,19,5.698962788772443e-5
freya-rose,19,girl,0,19,5.698962788772443e-5
hanaa,19,girl,0,19,5.698962788772443e-5
hanifa,19,girl,0,19,5.698962788772443e-5
ivanna,19,girl,1,20,5.998908198707835e-5
kezia,19,girl,0,19,5.698962788772443e-5
larna,19,girl,0,19,5.698962788772443e-5
laya,19,girl,2,21,6.298853608643227e-5
libbie,19,girl,0,19,5.698962788772443e-5
liepa,19,girl,0,19,5.698962788772443e-5
luna-rose,19,girl,0,19,5.698962788772443e-5
maahi,19,girl,0,19,5.698962788772443e-5
maariya,19,girl,0,19,5.698962788772443e-5
maheen,19,girl,1,20,5.998908198707835e-5
milah,19,girl,1,20,5.998908198707835e-5
milania,19,girl,2,21,6.298853608643227e-5
mya-rose,19,girl,3,22,6.598799018578619e-5
nur,19,girl,4,23,6.89874442851401e-5
patsy,19,girl,0,19,5.698962788772443e-5
rahmah,19,girl,0,19,5.698962788772443e-5
reagan,19,girl,7,26,7.798580658320186e-5
rosabella,19,girl,0,19,5.698962788772443e-5
rosina,19,girl,2,21,6.298853608643227e-5
rosy,19,girl,1,20,5.998908198707835e-5
rozalia,19,girl,1,20,5.998908198707835e-5
rumaysah,19,girl,1,20,5.998908198707835e-5
sabina,19,girl,0,19,5.698962788772443e-5
samiya,19,girl,0,19,5.698962788772443e-5
sehaj,19,girl,1,20,5.998908198707835e-5
shakira,19,girl,2,21,6.298853608643227e-5
shalom,19,girl,2,21,6.298853608643227e-5
skyla-mae,19,girl,0,19,5.698962788772443e-5
suhana,19,girl,1,20,5.998908198707835e-5
sybil,19,girl,0,19,5.698962788772443e-5
talya,19,girl,0,19,5.698962788772443e-5
theresa,19,girl,2,21,6.298853608643227e-5
umaimah,19,girl,1,20,5.998908198707835e-5
viktorija,19,girl,2,21,6.298853608643227e-5
afsa,18,girl,0,18,5.399017378837052e-5
aleen,18,girl,2,20,5.998908198707835e-5
allie,18,girl,11,29,8.698416888126361e-5
amelia-lilly,18,girl,2,20,5.998908198707835e-5
amelia-rae,18,girl,0,18,5.399017378837052e-5
annie-rose,18,girl,2,20,5.998908198707835e-5
ava-lily,18,girl,0,18,5.399017378837052e-5
ava-louise,18,girl,2,20,5.998908198707835e-5
bay,18,girl,0,18,5.399017378837052e-5
breanna,18,girl,0,18,5.399017378837052e-5
darla,18,girl,2,20,5.998908198707835e-5
dylan,18,girl,2,20,5.998908198707835e-5
eda,18,girl,0,18,5.399017378837052e-5
elaine,18,girl,0,18,5.399017378837052e-5
ellouise,18,girl,0,18,5.399017378837052e-5
emilly,18,girl,1,19,5.698962788772443e-5
ester,18,girl,0,18,5.399017378837052e-5
everlyn,18,girl,0,18,5.399017378837052e-5
ezra,18,girl,0,18,5.399017378837052e-5
hidayah,18,girl,0,18,5.399017378837052e-5
ilyana,18,girl,0,18,5.399017378837052e-5
isla-mai,18,girl,0,18,5.399017378837052e-5
ivy-rae,18,girl,1,19,5.698962788772443e-5
joanie,18,girl,0,18,5.399017378837052e-5
kaliyah,18,girl,1,19,5.698962788772443e-5
kallie,18,girl,6,24,7.198689838449402e-5
karen,18,girl,2,20,5.998908198707835e-5
kasey,18,girl,11,29,8.698416888126361e-5
kavya,18,girl,0,18,5.399017378837052e-5
kenzie,18,girl,8,26,7.798580658320186e-5
kirsten,18,girl,4,22,6.598799018578619e-5
laurie,18,girl,2,20,5.998908198707835e-5
lexa,18,girl,1,19,5.698962788772443e-5
lillie-mai,18,girl,0,18,5.399017378837052e-5
liza,18,girl,1,19,5.698962788772443e-5
lottie-mae,18,girl,0,18,5.399017378837052e-5
madinah,18,girl,0,18,5.399017378837052e-5
manahal,18,girl,1,19,5.698962788772443e-5
mariama,18,girl,2,20,5.998908198707835e-5
mei,18,girl,2,20,5.998908198707835e-5
minsa,18,girl,0,18,5.399017378837052e-5
mirabelle,18,girl,0,18,5.399017378837052e-5
miracle,18,girl,0,18,5.399017378837052e-5
mireya,18,girl,0,18,5.399017378837052e-5
munira,18,girl,0,18,5.399017378837052e-5
myla-rose,18,girl,1,19,5.698962788772443e-5
natalya,18,girl,1,19,5.698962788772443e-5
noemi,18,girl,4,22,6.598799018578619e-5
nya,18,girl,2,20,5.998908198707835e-5
oona,18,girl,2,20,5.998908198707835e-5
peaches,18,girl,0,18,5.399017378837052e-5
polina,18,girl,2,20,5.998908198707835e-5
raegan,18,girl,2,20,5.998908198707835e-5
suraya,18,girl,0,18,5.399017378837052e-5
tania,18,girl,0,18,5.399017378837052e-5
tiarna,18,girl,0,18,5.399017378837052e-5
ursula,18,girl,3,21,6.298853608643227e-5
urwa,18,girl,0,18,5.399017378837052e-5
violet-rose,18,girl,0,18,5.399017378837052e-5
yashvi,18,girl,0,18,5.399017378837052e-5
aaishah,17,girl,1,18,5.399017378837052e-5
acacia,17,girl,1,18,5.399017378837052e-5
afnan,17,girl,0,17,5.09907196890166e-5
afreen,17,girl,0,17,5.09907196890166e-5
akshara,17,girl,2,19,5.698962788772443e-5
alexi,17,girl,1,18,5.399017378837052e-5
althea,17,girl,2,19,5.698962788772443e-5
amilia,17,girl,1,18,5.399017378837052e-5
annabell,17,girl,2,19,5.698962788772443e-5
anushka,17,girl,0,17,5.09907196890166e-5
ayrah,17,girl,0,17,5.09907196890166e-5
azariah,17,girl,0,17,5.09907196890166e-5
briana,17,girl,0,17,5.09907196890166e-5
celyn,17,girl,0,17,5.09907196890166e-5
delphine,17,girl,1,18,5.399017378837052e-5
dotty,17,girl,0,17,5.09907196890166e-5
eleanora,17,girl,1,18,5.399017378837052e-5
elyse,17,girl,4,21,6.298853608643227e-5
elyssa,17,girl,1,18,5.399017378837052e-5
esmie,17,girl,2,19,5.698962788772443e-5
evelyn-rose,17,girl,0,17,5.09907196890166e-5
evie-leigh,17,girl,0,17,5.09907196890166e-5
evie-rae,17,girl,0,17,5.09907196890166e-5
ezmay,17,girl,0,17,5.09907196890166e-5
fatiha,17,girl,1,18,5.399017378837052e-5
gwenllian,17,girl,0,17,5.09907196890166e-5
hadiyah,17,girl,3,20,5.998908198707835e-5
haleemah,17,girl,1,18,5.399017378837052e-5
harper-leigh,17,girl,0,17,5.09907196890166e-5
hayat,17,girl,0,17,5.09907196890166e-5
hazal,17,girl,0,17,5.09907196890166e-5
hester,17,girl,0,17,5.09907196890166e-5
hooriya,17,girl,0,17,5.09907196890166e-5
izabel,17,girl,1,18,5.399017378837052e-5
jude,17,girl,1,18,5.399017378837052e-5
kamilla,17,girl,2,19,5.698962788772443e-5
karis,17,girl,12,29,8.698416888126361e-5
karla,17,girl,1,18,5.399017378837052e-5
laibah,17,girl,1,18,5.399017378837052e-5
lavin,17,girl,0,17,5.09907196890166e-5
leandra,17,girl,0,17,5.09907196890166e-5
leanna,17,girl,1,18,5.399017378837052e-5
lexi-mai,17,girl,1,18,5.399017378837052e-5
lotte,17,girl,2,19,5.698962788772443e-5
lucille,17,girl,1,18,5.399017378837052e-5
lujain,17,girl,0,17,5.09907196890166e-5
mayah,17,girl,1,18,5.399017378837052e-5
mehar,17,girl,1,18,5.399017378837052e-5
meher,17,girl,1,18,5.399017378837052e-5
melania,17,girl,0,17,5.09907196890166e-5
minnah,17,girl,2,19,5.698962788772443e-5
mona,17,girl,2,19,5.698962788772443e-5
muna,17,girl,0,17,5.09907196890166e-5
mysha,17,girl,0,17,5.09907196890166e-5
nadine,17,girl,2,19,5.698962788772443e-5
neveah,17,girl,0,17,5.09907196890166e-5
nika,17,girl,0,17,5.09907196890166e-5
parker,17,girl,6,23,6.89874442851401e-5
philomena,17,girl,0,17,5.09907196890166e-5
portia,17,girl,1,18,5.399017378837052e-5
rafaela,17,girl,0,17,5.09907196890166e-5
raphaella,17,girl,2,19,5.698962788772443e-5
rayne,17,girl,5,22,6.598799018578619e-5
rey,17,girl,3,20,5.998908198707835e-5
riana,17,girl,1,18,5.399017378837052e-5
romaisa,17,girl,0,17,5.09907196890166e-5
rosie-leigh,17,girl,0,17,5.09907196890166e-5
rubi,17,girl,3,20,5.998908198707835e-5
ruqaya,17,girl,0,17,5.09907196890166e-5
rylie,17,girl,2,19,5.698962788772443e-5
safah,17,girl,1,18,5.399017378837052e-5
saliha,17,girl,0,17,5.09907196890166e-5
sanaa,17,girl,0,17,5.09907196890166e-5
shanzay,17,girl,0,17,5.09907196890166e-5
simra,17,girl,0,17,5.09907196890166e-5
susie,17,girl,1,18,5.399017378837052e-5
tiara,17,girl,1,18,5.399017378837052e-5
tilly-may,17,girl,0,17,5.09907196890166e-5
vilte,17,girl,1,18,5.399017378837052e-5
vivien,17,girl,5,22,6.598799018578619e-5
wania,17,girl,1,18,5.399017378837052e-5
yazmin,17,girl,0,17,5.09907196890166e-5
yu,17,girl,2,19,5.698962788772443e-5
zi,17,girl,1,18,5.399017378837052e-5
zia,17,girl,0,17,5.09907196890166e-5
aaila,16,girl,1,17,5.09907196890166e-5
aamira,16,girl,1,17,5.09907196890166e-5
aarna,16,girl,0,16,4.7991265589662684e-5
aarohi,16,girl,0,16,4.7991265589662684e-5
abiha,16,girl,2,18,5.399017378837052e-5
afia,16,girl,0,16,4.7991265589662684e-5
alaw,16,girl,0,16,4.7991265589662684e-5
aleesha,16,girl,1,17,5.09907196890166e-5
alessa,16,girl,3,19,5.698962788772443e-5
aleyna,16,girl,0,16,4.7991265589662684e-5
alysha,16,girl,4,20,5.998908198707835e-5
amaal,16,girl,0,16,4.7991265589662684e-5
amelle,16,girl,1,17,5.09907196890166e-5
amiah,16,girl,3,19,5.698962788772443e-5
avayah,16,girl,0,16,4.7991265589662684e-5
bessie,16,girl,1,17,5.09907196890166e-5
charlee,16,girl,0,16,4.7991265589662684e-5
charleigh,16,girl,4,20,5.998908198707835e-5
cheyenne,16,girl,0,16,4.7991265589662684e-5
chimamanda,16,girl,1,17,5.09907196890166e-5
chisom,16,girl,2,18,5.399017378837052e-5
christiana,16,girl,1,17,5.09907196890166e-5
dilara,16,girl,1,17,5.09907196890166e-5
elianna,16,girl,1,17,5.09907196890166e-5
elicia,16,girl,0,16,4.7991265589662684e-5
eliora,16,girl,0,16,4.7991265589662684e-5
eliz,16,girl,0,16,4.7991265589662684e-5
emie,16,girl,2,18,5.399017378837052e-5
ethel,16,girl,0,16,4.7991265589662684e-5
eva-mae,16,girl,1,17,5.09907196890166e-5
ewa,16,girl,3,19,5.698962788772443e-5
fay,16,girl,3,19,5.698962788772443e-5
freda,16,girl,1,17,5.09907196890166e-5
gitty,16,girl,0,16,4.7991265589662684e-5
hallie-mae,16,girl,1,17,5.09907196890166e-5
hooria,16,girl,2,18,5.399017378837052e-5
humayra,16,girl,0,16,4.7991265589662684e-5
jacqueline,16,girl,4,20,5.998908198707835e-5
jess,16,girl,14,30,8.998362298061753e-5
joan,16,girl,0,16,4.7991265589662684e-5
joelle,16,girl,0,16,4.7991265589662684e-5
kenzi,16,girl,0,16,4.7991265589662684e-5
kyara,16,girl,0,16,4.7991265589662684e-5
laaibah,16,girl,0,16,4.7991265589662684e-5
layla-grace,16,girl,1,17,5.09907196890166e-5
lennie,16,girl,0,16,4.7991265589662684e-5
lilah-rose,16,girl,1,17,5.09907196890166e-5
lilla,16,girl,0,16,4.7991265589662684e-5
lily-anne,16,girl,3,19,5.698962788772443e-5
lucja,16,girl,2,18,5.399017378837052e-5
mackenzie,16,girl,5,21,6.298853608643227e-5
mahreen,16,girl,0,16,4.7991265589662684e-5
maisie-rose,16,girl,1,17,5.09907196890166e-5
manon,16,girl,1,17,5.09907196890166e-5
marcy,16,girl,4,20,5.998908198707835e-5
mary-jane,16,girl,1,17,5.09907196890166e-5
mehak,16,girl,0,16,4.7991265589662684e-5
meriem,16,girl,0,16,4.7991265589662684e-5
nabiha,16,girl,0,16,4.7991265589662684e-5
nayla,16,girl,1,17,5.09907196890166e-5
neeve,16,girl,1,17,5.09907196890166e-5
nevaeh-rose,16,girl,0,16,4.7991265589662684e-5
nila,16,girl,0,16,4.7991265589662684e-5
ola,16,girl,0,16,4.7991265589662684e-5
prudence,16,girl,1,17,5.09907196890166e-5
raine,16,girl,0,16,4.7991265589662684e-5
rawan,16,girl,0,16,4.7991265589662684e-5
reet,16,girl,1,17,5.09907196890166e-5
reign,16,girl,0,16,4.7991265589662684e-5
romany,16,girl,0,16,4.7991265589662684e-5
roxanna,16,girl,0,16,4.7991265589662684e-5
ruby-mai,16,girl,0,16,4.7991265589662684e-5
rylee,16,girl,6,22,6.598799018578619e-5
samia,16,girl,1,17,5.09907196890166e-5
selin,16,girl,2,18,5.399017378837052e-5
shay,16,girl,1,17,5.09907196890166e-5
shifa,16,girl,0,16,4.7991265589662684e-5
summaya,16,girl,0,16,4.7991265589662684e-5
suraiya,16,girl,0,16,4.7991265589662684e-5
suzanne,16,girl,1,17,5.09907196890166e-5
suzie,16,girl,1,17,5.09907196890166e-5
teddie,16,girl,0,16,4.7991265589662684e-5
trisha,16,girl,0,16,4.7991265589662684e-5
wendy,16,girl,3,19,5.698962788772443e-5
zahara,16,girl,0,16,4.7991265589662684e-5
zahrah,16,girl,2,18,5.399017378837052e-5
aafiya,15,girl,0,15,4.4991811490308764e-5
aaima,15,girl,2,17,5.09907196890166e-5
abeera,15,girl,2,17,5.09907196890166e-5
adeena,15,girl,0,15,4.4991811490308764e-5
aira,15,girl,1,16,4.7991265589662684e-5
alanah,15,girl,0,15,4.4991811490308764e-5
alethea,15,girl,2,17,5.09907196890166e-5
amaara,15,girl,0,15,4.4991811490308764e-5
ammarah,15,girl,1,16,4.7991265589662684e-5
ana-maria,15,girl,0,15,4.4991811490308764e-5
anaiyah,15,girl,0,15,4.4991811490308764e-5
andra,15,girl,0,15,4.4991811490308764e-5
arianne,15,girl,1,16,4.7991265589662684e-5
armani,15,girl,0,15,4.4991811490308764e-5
ashlyn,15,girl,4,19,5.698962788772443e-5
asra,15,girl,1,16,4.7991265589662684e-5
asya,15,girl,0,15,4.4991811490308764e-5
averie,15,girl,1,16,4.7991265589662684e-5
baby,15,girl,0,15,4.4991811490308764e-5
bailee,15,girl,1,16,4.7991265589662684e-5
bisma,15,girl,0,15,4.4991811490308764e-5
camila,15,girl,0,15,4.4991811490308764e-5
chana,15,girl,0,15,4.4991811490308764e-5
clemence,15,girl,1,16,4.7991265589662684e-5
clover,15,girl,1,16,4.7991265589662684e-5
cressida,15,girl,0,15,4.4991811490308764e-5
danni,15,girl,3,18,5.399017378837052e-5
effy,15,girl,5,20,5.998908198707835e-5
elisia,15,girl,0,15,4.4991811490308764e-5
ella-marie,15,girl,3,18,5.399017378837052e-5
elowyn,15,girl,0,15,4.4991811490308764e-5
elsie-rae,15,girl,0,15,4.4991811490308764e-5
elvie,15,girl,2,17,5.09907196890166e-5
emerson,15,girl,1,16,4.7991265589662684e-5
emili,15,girl,0,15,4.4991811490308764e-5
emily-mae,15,girl,0,15,4.4991811490308764e-5
eva-grace,15,girl,2,17,5.09907196890166e-5
evana,15,girl,0,15,4.4991811490308764e-5
fajr,15,girl,1,16,4.7991265589662684e-5
fia,15,girl,2,17,5.09907196890166e-5
fraya,15,girl,1,16,4.7991265589662684e-5
gwenno,15,girl,0,15,4.4991811490308764e-5
hallie-rose,15,girl,1,16,4.7991265589662684e-5
havin,15,girl,0,15,4.4991811490308764e-5
ila,15,girl,0,15,4.4991811490308764e-5
imaani,15,girl,0,15,4.4991811490308764e-5
irha,15,girl,0,15,4.4991811490308764e-5
ivy-may,15,girl,0,15,4.4991811490308764e-5
jamie-leigh,15,girl,1,16,4.7991265589662684e-5
janae,15,girl,0,15,4.4991811490308764e-5
kairi,15,girl,1,16,4.7991265589662684e-5
kayley,15,girl,3,18,5.399017378837052e-5
lacie-mae,15,girl,2,17,5.09907196890166e-5
letty,15,girl,4,19,5.698962788772443e-5
lexi-rose,15,girl,0,15,4.4991811490308764e-5
logan,15,girl,0,15,4.4991811490308764e-5
lottie-rose,15,girl,0,15,4.4991811490308764e-5
luka,15,girl,0,15,4.4991811490308764e-5
malky,15,girl,0,15,4.4991811490308764e-5
marnie-rae,15,girl,0,15,4.4991811490308764e-5
matilda-rose,15,girl,0,15,4.4991811490308764e-5
mila-rose,15,girl,3,18,5.399017378837052e-5
mishal,15,girl,0,15,4.4991811490308764e-5
molly-rose,15,girl,0,15,4.4991811490308764e-5
mylee,15,girl,2,17,5.09907196890166e-5
naba,15,girl,0,15,4.4991811490308764e-5
naia,15,girl,2,17,5.09907196890166e-5
naiya,15,girl,0,15,4.4991811490308764e-5
nura,15,girl,0,15,4.4991811490308764e-5
nusayba,15,girl,0,15,4.4991811490308764e-5
nyra,15,girl,0,15,4.4991811490308764e-5
parisa,15,girl,0,15,4.4991811490308764e-5
roksana,15,girl,0,15,4.4991811490308764e-5
rosalyn,15,girl,2,17,5.09907196890166e-5
ruby-rae,15,girl,0,15,4.4991811490308764e-5
sabiha,15,girl,0,15,4.4991811490308764e-5
sahara,15,girl,0,15,4.4991811490308764e-5
sena,15,girl,0,15,4.4991811490308764e-5
shaniya,15,girl,0,15,4.4991811490308764e-5
tilly-mae,15,girl,0,15,4.4991811490308764e-5
toby,15,girl,0,15,4.4991811490308764e-5
whitney,15,girl,0,15,4.4991811490308764e-5
zaria,15,girl,0,15,4.4991811490308764e-5
zariah,15,girl,2,17,5.09907196890166e-5
zarina,15,girl,0,15,4.4991811490308764e-5
zeenat,15,girl,1,16,4.7991265589662684e-5
zena,15,girl,1,16,4.7991265589662684e-5
zimal,15,girl,3,18,5.399017378837052e-5
aaleyah,14,girl,2,16,4.7991265589662684e-5
aaliyah-rose,14,girl,0,14,4.1992357390954844e-5
aamna,14,girl,1,15,4.4991811490308764e-5
aavya,14,girl,0,14,4.1992357390954844e-5
adalynn,14,girl,1,15,4.4991811490308764e-5
aleeya,14,girl,0,14,4.1992357390954844e-5
alysia,14,girl,0,14,4.1992357390954844e-5
amaani,14,girl,0,14,4.1992357390954844e-5
amaira,14,girl,0,14,4.1992357390954844e-5
amberley,14,girl,0,14,4.1992357390954844e-5
amyra,14,girl,1,15,4.4991811490308764e-5
anabiya,14,girl,0,14,4.1992357390954844e-5
anays,14,girl,0,14,4.1992357390954844e-5
ann,14,girl,1,15,4.4991811490308764e-5
anne-marie,14,girl,1,15,4.4991811490308764e-5
areen,14,girl,3,17,5.09907196890166e-5
ariyana,14,girl,1,15,4.4991811490308764e-5
arrietty,14,girl,0,14,4.1992357390954844e-5
aurora-rose,14,girl,0,14,4.1992357390954844e-5
aveline,14,girl,0,14,4.1992357390954844e-5
ayomide,14,girl,2,16,4.7991265589662684e-5
bella-rae,14,girl,0,14,4.1992357390954844e-5
bernadette,14,girl,0,14,4.1992357390954844e-5
bethanie,14,girl,0,14,4.1992357390954844e-5
bodhi,14,girl,2,16,4.7991265589662684e-5
carlotta,14,girl,0,14,4.1992357390954844e-5
cosima,14,girl,0,14,4.1992357390954844e-5
cristina,14,girl,3,17,5.09907196890166e-5
deanna,14,girl,0,14,4.1992357390954844e-5
dhiya,14,girl,1,15,4.4991811490308764e-5
elayna,14,girl,1,15,4.4991811490308764e-5
electra,14,girl,0,14,4.1992357390954844e-5
elyza,14,girl,0,14,4.1992357390954844e-5
emmie-rose,14,girl,0,14,4.1992357390954844e-5
esmae-rose,14,girl,1,15,4.4991811490308764e-5
eva-may,14,girl,3,17,5.09907196890166e-5
everleigh,14,girl,1,15,4.4991811490308764e-5
ezme,14,girl,2,16,4.7991265589662684e-5
fatoumata,14,girl,1,15,4.4991811490308764e-5
fiza,14,girl,1,15,4.4991811490308764e-5
franki,14,girl,2,16,4.7991265589662684e-5
frankie-mae,14,girl,0,14,4.1992357390954844e-5
gigi,14,girl,0,14,4.1992357390954844e-5
hamnah,14,girl,0,14,4.1992357390954844e-5
hayaa,14,girl,0,14,4.1992357390954844e-5
hayah,14,girl,0,14,4.1992357390954844e-5
hibbah,14,girl,0,14,4.1992357390954844e-5
hirah,14,girl,0,14,4.1992357390954844e-5
hollie-may,14,girl,0,14,4.1992357390954844e-5
ilinca,14,girl,1,15,4.4991811490308764e-5
iola,14,girl,0,14,4.1992357390954844e-5
isabella-grace,14,girl,0,14,4.1992357390954844e-5
izzabella,14,girl,1,15,4.4991811490308764e-5
jaida,14,girl,1,15,4.4991811490308764e-5
jesse,14,girl,1,15,4.4991811490308764e-5
jorgia,14,girl,7,21,6.298853608643227e-5
kaylah,14,girl,3,17,5.09907196890166e-5
kendal,14,girl,8,22,6.598799018578619e-5
kensi,14,girl,0,14,4.1992357390954844e-5
kianna,14,girl,4,18,5.399017378837052e-5
klea,14,girl,0,14,4.1992357390954844e-5
lacey-rose,14,girl,1,15,4.4991811490308764e-5
lamaisah,14,girl,0,14,4.1992357390954844e-5
lani,14,girl,0,14,4.1992357390954844e-5
layla-rae,14,girl,0,14,4.1992357390954844e-5
liara,14,girl,0,14,4.1992357390954844e-5
lillianna,14,girl,2,16,4.7991265589662684e-5
lillie-may,14,girl,2,16,4.7991265589662684e-5
lola-may,14,girl,0,14,4.1992357390954844e-5
lotti,14,girl,1,15,4.4991811490308764e-5
madeeha,14,girl,1,15,4.4991811490308764e-5
mahdiya,14,girl,0,14,4.1992357390954844e-5
maheera,14,girl,0,14,4.1992357390954844e-5
maida,14,girl,0,14,4.1992357390954844e-5
manaal,14,girl,1,15,4.4991811490308764e-5
manreet,14,girl,1,15,4.4991811490308764e-5
marcella,14,girl,0,14,4.1992357390954844e-5
margarita,14,girl,1,15,4.4991811490308764e-5
marlee,14,girl,1,15,4.4991811490308764e-5
milita,14,girl,0,14,4.1992357390954844e-5
mirha,14,girl,0,14,4.1992357390954844e-5
missy,14,girl,0,14,4.1992357390954844e-5
nancy-rose,14,girl,0,14,4.1992357390954844e-5
naz,14,girl,1,15,4.4991811490308764e-5
neeva,14,girl,1,15,4.4991811490308764e-5
noora,14,girl,0,14,4.1992357390954844e-5
olivia-rae,14,girl,0,14,4.1992357390954844e-5
paighton,14,girl,1,15,4.4991811490308764e-5
phillipa,14,girl,1,15,4.4991811490308764e-5
phoebie,14,girl,0,14,4.1992357390954844e-5
poppy-may,14,girl,1,15,4.4991811490308764e-5
ravneet,14,girl,0,14,4.1992357390954844e-5
regan,14,girl,1,15,4.4991811490308764e-5
rosaleigh,14,girl,0,14,4.1992357390954844e-5
roux,14,girl,0,14,4.1992357390954844e-5
ruya,14,girl,1,15,4.4991811490308764e-5
sairah,14,girl,0,14,4.1992357390954844e-5
samar,14,girl,0,14,4.1992357390954844e-5
sanjana,14,girl,0,14,4.1992357390954844e-5
sarrinah,14,girl,0,14,4.1992357390954844e-5
savannah-rose,14,girl,0,14,4.1992357390954844e-5
sawdah,14,girl,0,14,4.1992357390954844e-5
saya,14,girl,0,14,4.1992357390954844e-5
skyla-rae,14,girl,0,14,4.1992357390954844e-5
suzanna,14,girl,0,14,4.1992357390954844e-5
teddy,14,girl,2,16,4.7991265589662684e-5
thora,14,girl,2,16,4.7991265589662684e-5
valencia,14,girl,1,15,4.4991811490308764e-5
vesper,14,girl,0,14,4.1992357390954844e-5
vida,14,girl,0,14,4.1992357390954844e-5
yumna,14,girl,0,14,4.1992357390954844e-5
zohra,14,girl,0,14,4.1992357390954844e-5
aarushi,13,girl,0,13,3.899290329160093e-5
aayah,13,girl,2,15,4.4991811490308764e-5
adira,13,girl,0,13,3.899290329160093e-5
advika,13,girl,0,13,3.899290329160093e-5
ajooni,13,girl,0,13,3.899290329160093e-5
alaska,13,girl,0,13,3.899290329160093e-5
alexus,13,girl,0,13,3.899290329160093e-5
alice-rose,13,girl,0,13,3.899290329160093e-5
amaanah,13,girl,0,13,3.899290329160093e-5
amana,13,girl,0,13,3.899290329160093e-5
amariah,13,girl,0,13,3.899290329160093e-5
amima,13,girl,0,13,3.899290329160093e-5
anaaya,13,girl,1,14,4.1992357390954844e-5
anfal,13,girl,1,14,4.1992357390954844e-5
angharad,13,girl,0,13,3.899290329160093e-5
annaliese,13,girl,2,15,4.4991811490308764e-5
arabelle,13,girl,0,13,3.899290329160093e-5
arin,13,girl,1,14,4.1992357390954844e-5
atarah,13,girl,0,13,3.899290329160093e-5
ayla-rose,13,girl,0,13,3.899290329160093e-5
beca,13,girl,1,14,4.1992357390954844e-5
bernice,13,girl,0,13,3.899290329160093e-5
betsi,13,girl,0,13,3.899290329160093e-5
bronwen,13,girl,1,14,4.1992357390954844e-5
cally,13,girl,1,14,4.1992357390954844e-5
carmel,13,girl,0,13,3.899290329160093e-5
cici,13,girl,0,13,3.899290329160093e-5
clio,13,girl,0,13,3.899290329160093e-5
daisy-grace,13,girl,0,13,3.899290329160093e-5
daniele,13,girl,1,14,4.1992357390954844e-5
danika,13,girl,1,14,4.1992357390954844e-5
dayana,13,girl,0,13,3.899290329160093e-5
demelza,13,girl,1,14,4.1992357390954844e-5
deniz,13,girl,0,13,3.899290329160093e-5
diamond,13,girl,0,13,3.899290329160093e-5
elen,13,girl,0,13,3.899290329160093e-5
elly,13,girl,2,15,4.4991811490308764e-5
emanuela,13,girl,1,14,4.1992357390954844e-5
emelia-rose,13,girl,1,14,4.1992357390954844e-5
emily-may,13,girl,0,13,3.899290329160093e-5
erina,13,girl,0,13,3.899290329160093e-5
eris,13,girl,0,13,3.899290329160093e-5
esmerelda,13,girl,0,13,3.899290329160093e-5
flavia,13,girl,0,13,3.899290329160093e-5
florentina,13,girl,0,13,3.899290329160093e-5
freyah,13,girl,1,14,4.1992357390954844e-5
hargun,13,girl,0,13,3.899290329160093e-5
harnoor,13,girl,0,13,3.899290329160093e-5
harper-mae,13,girl,0,13,3.899290329160093e-5
hosanna,13,girl,0,13,3.899290329160093e-5
humairah,13,girl,0,13,3.899290329160093e-5
ilana,13,girl,1,14,4.1992357390954844e-5
indira,13,girl,1,14,4.1992357390954844e-5
inez,13,girl,0,13,3.899290329160093e-5
ivy-leigh,13,girl,0,13,3.899290329160093e-5
javeria,13,girl,1,14,4.1992357390954844e-5
jean,13,girl,1,14,4.1992357390954844e-5
joana,13,girl,1,14,4.1992357390954844e-5
jood,13,girl,0,13,3.899290329160093e-5
julianna,13,girl,0,13,3.899290329160093e-5
kadi,13,girl,0,13,3.899290329160093e-5
keerat,13,girl,0,13,3.899290329160093e-5
laci,13,girl,5,18,5.399017378837052e-5
layla-mai,13,girl,0,13,3.899290329160093e-5
lilli,13,girl,1,14,4.1992357390954844e-5
lilyanna,13,girl,0,13,3.899290329160093e-5
lola-mai,13,girl,0,13,3.899290329160093e-5
maimuna,13,girl,0,13,3.899290329160093e-5
maisie-rae,13,girl,0,13,3.899290329160093e-5
malaikah,13,girl,1,14,4.1992357390954844e-5
malaya,13,girl,0,13,3.899290329160093e-5
malin,13,girl,3,16,4.7991265589662684e-5
maxine,13,girl,0,13,3.899290329160093e-5
mayra,13,girl,0,13,3.899290329160093e-5
montana,13,girl,0,13,3.899290329160093e-5
myrah,13,girl,1,14,4.1992357390954844e-5
najma,13,girl,0,13,3.899290329160093e-5
nelle,13,girl,1,14,4.1992357390954844e-5
olivia-mai,13,girl,0,13,3.899290329160093e-5
phoebe-rose,13,girl,0,13,3.899290329160093e-5
poppi,13,girl,0,13,3.899290329160093e-5
poppy-rae,13,girl,0,13,3.899290329160093e-5
porsche,13,girl,0,13,3.899290329160093e-5
rahaf,13,girl,1,14,4.1992357390954844e-5
rahela,13,girl,1,14,4.1992357390954844e-5
razan,13,girl,0,13,3.899290329160093e-5
rogue,13,girl,1,14,4.1992357390954844e-5
roseanne,13,girl,0,13,3.899290329160093e-5
rowen,13,girl,1,14,4.1992357390954844e-5
rue,13,girl,0,13,3.899290329160093e-5
ruwayda,13,girl,0,13,3.899290329160093e-5
salwa,13,girl,0,13,3.899290329160093e-5
sarai,13,girl,0,13,3.899290329160093e-5
senna,13,girl,0,13,3.899290329160093e-5
skyla-may,13,girl,0,13,3.899290329160093e-5
sofiya,13,girl,1,14,4.1992357390954844e-5
soha,13,girl,0,13,3.899290329160093e-5
sophia-grace,13,girl,1,14,4.1992357390954844e-5
stacey,13,girl,1,14,4.1992357390954844e-5
swara,13,girl,1,14,4.1992357390954844e-5
tayyibah,13,girl,0,13,3.899290329160093e-5
ugne,13,girl,2,15,4.4991811490308764e-5
umayyah,13,girl,1,14,4.1992357390954844e-5
unaisah,13,girl,0,13,3.899290329160093e-5
venus,13,girl,0,13,3.899290329160093e-5
waniya,13,girl,1,14,4.1992357390954844e-5
xenia,13,girl,0,13,3.899290329160093e-5
yael,13,girl,0,13,3.899290329160093e-5
yasemin,13,girl,2,15,4.4991811490308764e-5
yocheved,13,girl,0,13,3.899290329160093e-5
yuna,13,girl,3,16,4.7991265589662684e-5
yusrah,13,girl,0,13,3.899290329160093e-5
zendaya,13,girl,0,13,3.899290329160093e-5
aashvi,12,girl,1,13,3.899290329160093e-5
abi,12,girl,14,26,7.798580658320186e-5
adan,12,girl,0,12,3.599344919224701e-5
alaiya,12,girl,0,12,3.599344919224701e-5
aliana,12,girl,2,14,4.1992357390954844e-5
alis,12,girl,0,12,3.599344919224701e-5
aluna,12,girl,1,13,3.899290329160093e-5
alveena,12,girl,0,12,3.599344919224701e-5
alycia,12,girl,0,12,3.599344919224701e-5
ameya,12,girl,0,12,3.599344919224701e-5
aminata,12,girl,0,12,3.599344919224701e-5
anja,12,girl,1,13,3.899290329160093e-5
anmol,12,girl,0,12,3.599344919224701e-5
arabella-rose,12,girl,1,13,3.899290329160093e-5
ashanti,12,girl,1,13,3.899290329160093e-5
atlanta,12,girl,0,12,3.599344919224701e-5
avie,12,girl,0,12,3.599344919224701e-5
bani,12,girl,0,12,3.599344919224701e-5
bareerah,12,girl,0,12,3.599344919224701e-5
basma,12,girl,0,12,3.599344919224701e-5
betsan,12,girl,0,12,3.599344919224701e-5
betsy-rose,12,girl,0,12,3.599344919224701e-5
bonnie-rose,12,girl,0,12,3.599344919224701e-5
brea,12,girl,2,14,4.1992357390954844e-5
briony,12,girl,1,13,3.899290329160093e-5
calliope,12,girl,0,12,3.599344919224701e-5
candice,12,girl,1,13,3.899290329160093e-5
caris,12,girl,0,12,3.599344919224701e-5
cherish,12,girl,1,13,3.899290329160093e-5
chioma,12,girl,1,13,3.899290329160093e-5
connie-mae,12,girl,0,12,3.599344919224701e-5
daisy-rose,12,girl,0,12,3.599344919224701e-5
darcie-mai,12,girl,0,12,3.599344919224701e-5
dea,12,girl,0,12,3.599344919224701e-5
delyth,12,girl,0,12,3.599344919224701e-5
eevee,12,girl,1,13,3.899290329160093e-5
eevie,12,girl,2,14,4.1992357390954844e-5
elisabeta,12,girl,1,13,3.899290329160093e-5
eliza-mae,12,girl,0,12,3.599344919224701e-5
elli,12,girl,2,14,4.1992357390954844e-5
ellie-louise,12,girl,2,14,4.1992357390954844e-5
emily-grace,12,girl,1,13,3.899290329160093e-5
ena,12,girl,2,14,4.1992357390954844e-5
evalynn,12,girl,0,12,3.599344919224701e-5
evelyne,12,girl,0,12,3.599344919224701e-5
eviee,12,girl,0,12,3.599344919224701e-5
faizah,12,girl,0,12,3.599344919224701e-5
fariha,12,girl,0,12,3.599344919224701e-5
fatema,12,girl,0,12,3.599344919224701e-5
flo,12,girl,0,12,3.599344919224701e-5
georgia-mae,12,girl,0,12,3.599344919224701e-5
gurnoor,12,girl,0,12,3.599344919224701e-5
gwennan,12,girl,0,12,3.599344919224701e-5
hatice,12,girl,0,12,3.599344919224701e-5
heaven,12,girl,0,12,3.599344919224701e-5
heer,12,girl,0,12,3.599344919224701e-5
helin,12,girl,1,13,3.899290329160093e-5
iasmina,12,girl,0,12,3.599344919224701e-5
inioluwa,12,girl,2,14,4.1992357390954844e-5
ishaal,12,girl,1,13,3.899290329160093e-5
isma,12,girl,0,12,3.599344919224701e-5
iulia,12,girl,0,12,3.599344919224701e-5
iva,12,girl,1,13,3.899290329160093e-5
jaspreet,12,girl,0,12,3.599344919224701e-5
jennah,12,girl,1,13,3.899290329160093e-5
judith,12,girl,2,14,4.1992357390954844e-5
lacy,12,girl,5,17,5.09907196890166e-5
lake,12,girl,1,13,3.899290329160093e-5
lilien,12,girl,0,12,3.599344919224701e-5
lilou,12,girl,0,12,3.599344919224701e-5
maame,12,girl,1,13,3.899290329160093e-5
macie-leigh,12,girl,0,12,3.599344919224701e-5
mai,12,girl,1,13,3.899290329160093e-5
manar,12,girl,0,12,3.599344919224701e-5
manuela,12,girl,0,12,3.599344919224701e-5
marika,12,girl,1,13,3.899290329160093e-5
marlena,12,girl,4,16,4.7991265589662684e-5
meabh,12,girl,0,12,3.599344919224701e-5
melek,12,girl,0,12,3.599344919224701e-5
melia,12,girl,0,12,3.599344919224701e-5
menna,12,girl,0,12,3.599344919224701e-5
merve,12,girl,0,12,3.599344919224701e-5
millie-may,12,girl,1,13,3.899290329160093e-5
minerva,12,girl,0,12,3.599344919224701e-5
muskaan,12,girl,0,12,3.599344919224701e-5
nefeli,12,girl,0,12,3.599344919224701e-5
nico,12,girl,1,13,3.899290329160093e-5
novah,12,girl,5,17,5.09907196890166e-5
oakley,12,girl,1,13,3.899290329160093e-5
oluwatamilore,12,girl,1,13,3.899290329160093e-5
opal,12,girl,1,13,3.899290329160093e-5
orla-rose,12,girl,2,14,4.1992357390954844e-5
patricija,12,girl,0,12,3.599344919224701e-5
phebe,12,girl,0,12,3.599344919224701e-5
poppy-louise,12,girl,0,12,3.599344919224701e-5
posy,12,girl,0,12,3.599344919224701e-5
queenie,12,girl,1,13,3.899290329160093e-5
rana,12,girl,3,15,4.4991811490308764e-5
ranya,12,girl,0,12,3.599344919224701e-5
rayyan,12,girl,0,12,3.599344919224701e-5
reenie,12,girl,0,12,3.599344919224701e-5
renesmai,12,girl,0,12,3.599344919224701e-5
rhema,12,girl,1,13,3.899290329160093e-5
rheya,12,girl,0,12,3.599344919224701e-5
rhianna,12,girl,3,15,4.4991811490308764e-5
ripley,12,girl,1,13,3.899290329160093e-5
ronni,12,girl,4,16,4.7991265589662684e-5
ruby-grace,12,girl,0,12,3.599344919224701e-5
ruqaiyah,12,girl,0,12,3.599344919224701e-5
ruweyda,12,girl,0,12,3.599344919224701e-5
saaliha,12,girl,0,12,3.599344919224701e-5
sahana,12,girl,1,13,3.899290329160093e-5
salome,12,girl,0,12,3.599344919224701e-5
samah,12,girl,1,13,3.899290329160093e-5
sargun,12,girl,0,12,3.599344919224701e-5
senara,12,girl,0,12,3.599344919224701e-5
shirley,12,girl,1,13,3.899290329160093e-5
simone,12,girl,1,13,3.899290329160093e-5
siobhan,12,girl,1,13,3.899290329160093e-5
skylar-rose,12,girl,0,12,3.599344919224701e-5
soraiya,12,girl,0,12,3.599344919224701e-5
summer-rae,12,girl,0,12,3.599344919224701e-5
susannah,12,girl,1,13,3.899290329160093e-5
taiba,12,girl,0,12,3.599344919224701e-5
taryn,12,girl,3,15,4.4991811490308764e-5
taylah,12,girl,0,12,3.599344919224701e-5
umamah,12,girl,1,13,3.899290329160093e-5
vaishnavi,12,girl,1,13,3.899290329160093e-5
veera,12,girl,1,13,3.899290329160093e-5
winter-rose,12,girl,1,13,3.899290329160093e-5
yaren,12,girl,0,12,3.599344919224701e-5
zaira,12,girl,0,12,3.599344919224701e-5
zikra,12,girl,0,12,3.599344919224701e-5
zuzana,12,girl,1,13,3.899290329160093e-5
aafiyah,11,girl,0,11,3.2993995092893096e-5
aamilah,11,girl,0,11,3.2993995092893096e-5
aarvi,11,girl,1,12,3.599344919224701e-5
aditi,11,girl,2,13,3.899290329160093e-5
aeryn,11,girl,1,12,3.599344919224701e-5
aileen,11,girl,0,11,3.2993995092893096e-5
ailla,11,girl,1,12,3.599344919224701e-5
aisla,11,girl,1,12,3.599344919224701e-5
alba-rose,11,girl,1,12,3.599344919224701e-5
alexie,11,girl,0,11,3.2993995092893096e-5
alora,11,girl,0,11,3.2993995092893096e-5
alyvia,11,girl,3,14,4.1992357390954844e-5
alyza,11,girl,0,11,3.2993995092893096e-5
amba,11,girl,0,11,3.2993995092893096e-5
amelie-rose,11,girl,1,12,3.599344919224701e-5
ameliya,11,girl,1,12,3.599344919224701e-5
aneesa,11,girl,0,11,3.2993995092893096e-5
aoibhinn,11,girl,1,12,3.599344919224701e-5
araminta,11,girl,1,12,3.599344919224701e-5
ariele,11,girl,0,11,3.2993995092893096e-5
arsema,11,girl,0,11,3.2993995092893096e-5
athina,11,girl,0,11,3.2993995092893096e-5
aurelie,11,girl,0,11,3.2993995092893096e-5
ayleen,11,girl,0,11,3.2993995092893096e-5
ayza,11,girl,0,11,3.2993995092893096e-5
azka,11,girl,0,11,3.2993995092893096e-5
baylee,11,girl,2,13,3.899290329160093e-5
benita,11,girl,1,12,3.599344919224701e-5
bess,11,girl,1,12,3.599344919224701e-5
blair,11,girl,15,26,7.798580658320186e-5
brie,11,girl,2,13,3.899290329160093e-5
britney,11,girl,0,11,3.2993995092893096e-5
brooklynn,11,girl,0,11,3.2993995092893096e-5
caia,11,girl,0,11,3.2993995092893096e-5
cameron,11,girl,5,16,4.7991265589662684e-5
cari,11,girl,0,11,3.2993995092893096e-5
carrie,11,girl,6,17,5.09907196890166e-5
celestine,11,girl,0,11,3.2993995092893096e-5
charlene,11,girl,1,12,3.599344919224701e-5
chidera,11,girl,0,11,3.2993995092893096e-5
chizara,11,girl,2,13,3.899290329160093e-5
clarke,11,girl,0,11,3.2993995092893096e-5
colette,11,girl,4,15,4.4991811490308764e-5
daisie-mae,11,girl,0,11,3.2993995092893096e-5
darya,11,girl,0,11,3.2993995092893096e-5
della,11,girl,2,13,3.899290329160093e-5
dia,11,girl,1,12,3.599344919224701e-5
dorcas,11,girl,0,11,3.2993995092893096e-5
eldana,11,girl,0,11,3.2993995092893096e-5
eleanor-rose,11,girl,0,11,3.2993995092893096e-5
elva,11,girl,1,12,3.599344919224701e-5
elyssia,11,girl,0,11,3.2993995092893096e-5
emma-rose,11,girl,0,11,3.2993995092893096e-5
evin,11,girl,1,12,3.599344919224701e-5
farhana,11,girl,0,11,3.2993995092893096e-5
francine,11,girl,0,11,3.2993995092893096e-5
freya-mae,11,girl,0,11,3.2993995092893096e-5
georgia-may,11,girl,2,13,3.899290329160093e-5
ginny,11,girl,0,11,3.2993995092893096e-5
glory,11,girl,0,11,3.2993995092893096e-5
harlo,11,girl,2,13,3.899290329160093e-5
harmony-rose,11,girl,0,11,3.2993995092893096e-5
harper-grace,11,girl,1,12,3.599344919224701e-5
hayden,11,girl,3,14,4.1992357390954844e-5
heidi-rose,11,girl,0,11,3.2993995092893096e-5
hillary,11,girl,0,11,3.2993995092893096e-5
ifrah,11,girl,0,11,3.2993995092893096e-5
ikhlas,11,girl,0,11,3.2993995092893096e-5
imogen-rose,11,girl,1,12,3.599344919224701e-5
india-rose,11,girl,0,11,3.2993995092893096e-5
islay,11,girl,12,23,6.89874442851401e-5
izzah,11,girl,0,11,3.2993995092893096e-5
jameela,11,girl,0,11,3.2993995092893096e-5
janiyah,11,girl,0,11,3.2993995092893096e-5
kaila,11,girl,1,12,3.599344919224701e-5
kainaat,11,girl,0,11,3.2993995092893096e-5
katarina,11,girl,0,11,3.2993995092893096e-5
katarzyna,11,girl,0,11,3.2993995092893096e-5
katelynn,11,girl,0,11,3.2993995092893096e-5
kaydee,11,girl,2,13,3.899290329160093e-5
kayra,11,girl,0,11,3.2993995092893096e-5
kenza,11,girl,0,11,3.2993995092893096e-5
kiya,11,girl,1,12,3.599344919224701e-5
kristen,11,girl,1,12,3.599344919224701e-5
kyrah,11,girl,0,11,3.2993995092893096e-5
lamar,11,girl,0,11,3.2993995092893096e-5
lamees,11,girl,0,11,3.2993995092893096e-5
leah-rose,11,girl,0,11,3.2993995092893096e-5
leigha,11,girl,10,21,6.298853608643227e-5
leila-rose,11,girl,1,12,3.599344919224701e-5
lexie-may,11,girl,0,11,3.2993995092893096e-5
lillie-grace,11,girl,1,12,3.599344919224701e-5
lillie-rae,11,girl,0,11,3.2993995092893096e-5
lola-grace,11,girl,0,11,3.2993995092893096e-5
lunar,11,girl,0,11,3.2993995092893096e-5
lyla-rae,11,girl,0,11,3.2993995092893096e-5
maggie-may,11,girl,0,11,3.2993995092893096e-5
magi,11,girl,0,11,3.2993995092893096e-5
mairead,11,girl,6,17,5.09907196890166e-5
mallory,11,girl,1,12,3.599344919224701e-5
malwina,11,girl,0,11,3.2993995092893096e-5
marilyn,11,girl,1,12,3.599344919224701e-5
marisa,11,girl,1,12,3.599344919224701e-5
marli,11,girl,1,12,3.599344919224701e-5
marnie-rose,11,girl,0,11,3.2993995092893096e-5
mavis,11,girl,0,11,3.2993995092893096e-5
maysie,11,girl,0,11,3.2993995092893096e-5
mazie,11,girl,0,11,3.2993995092893096e-5
meda,11,girl,1,12,3.599344919224701e-5
meila,11,girl,1,12,3.599344919224701e-5
milani,11,girl,0,11,3.2993995092893096e-5
minaal,11,girl,0,11,3.2993995092893096e-5
minna,11,girl,0,11,3.2993995092893096e-5
mishaal,11,girl,0,11,3.2993995092893096e-5
mollie-rose,11,girl,0,11,3.2993995092893096e-5
monae,11,girl,0,11,3.2993995092893096e-5
nabila,11,girl,0,11,3.2993995092893096e-5
nairah,11,girl,0,11,3.2993995092893096e-5
nevayah,11,girl,0,11,3.2993995092893096e-5
nida,11,girl,0,11,3.2993995092893096e-5
nikol,11,girl,1,12,3.599344919224701e-5
nikole,11,girl,0,11,3.2993995092893096e-5
nimra,11,girl,0,11,3.2993995092893096e-5
nimrah,11,girl,0,11,3.2993995092893096e-5
nimrit,11,girl,1,12,3.599344919224701e-5
nissi,11,girl,0,11,3.2993995092893096e-5
noelia,11,girl,2,13,3.899290329160093e-5
nyla-rose,11,girl,0,11,3.2993995092893096e-5
olga,11,girl,3,14,4.1992357390954844e-5
oluwanifemi,11,girl,0,11,3.2993995092893096e-5
olwen,11,girl,0,11,3.2993995092893096e-5
paisleigh,11,girl,2,13,3.899290329160093e-5
peighton,11,girl,2,13,3.899290329160093e-5
phoebe-grace,11,girl,0,11,3.2993995092893096e-5
poppy-mai,11,girl,0,11,3.2993995092893096e-5
praise,11,girl,0,11,3.2993995092893096e-5
pria,11,girl,0,11,3.2993995092893096e-5
pyper,11,girl,5,16,4.7991265589662684e-5
rayaan,11,girl,0,11,3.2993995092893096e-5
ritika,11,girl,1,12,3.599344919224701e-5
rivky,11,girl,0,11,3.2993995092893096e-5
rochelle,11,girl,0,11,3.2993995092893096e-5
rosalee,11,girl,2,13,3.899290329160093e-5
rosalia,11,girl,2,13,3.899290329160093e-5
rosemarie,11,girl,1,12,3.599344919224701e-5
rosetta,11,girl,0,11,3.2993995092893096e-5
rowena,11,girl,0,11,3.2993995092893096e-5
runa,11,girl,3,14,4.1992357390954844e-5
sage,11,girl,2,13,3.899290329160093e-5
sahra,11,girl,1,12,3.599344919224701e-5
sakinah,11,girl,0,11,3.2993995092893096e-5
samaira,11,girl,0,11,3.2993995092893096e-5
sania,11,girl,0,11,3.2993995092893096e-5
shaniyah,11,girl,0,11,3.2993995092893096e-5
shona,11,girl,0,11,3.2993995092893096e-5
shoshana,11,girl,0,11,3.2993995092893096e-5
silvia,11,girl,2,13,3.899290329160093e-5
simar,11,girl,1,12,3.599344919224701e-5
simrah,11,girl,0,11,3.2993995092893096e-5
simrat,11,girl,0,11,3.2993995092893096e-5
tahira,11,girl,0,11,3.2993995092893096e-5
talula,11,girl,1,12,3.599344919224701e-5
tamar,11,girl,1,12,3.599344919224701e-5
tamzin,11,girl,0,11,3.2993995092893096e-5
tasmia,11,girl,1,12,3.599344919224701e-5
temperance,11,girl,0,11,3.2993995092893096e-5
tia-rose,11,girl,1,12,3.599344919224701e-5
tigerlily,11,girl,0,11,3.2993995092893096e-5
tova,11,girl,0,11,3.2993995092893096e-5
umaira,11,girl,0,11,3.2993995092893096e-5
venice,11,girl,0,11,3.2993995092893096e-5
viviana,11,girl,2,13,3.899290329160093e-5
wafa,11,girl,1,12,3.599344919224701e-5
xena,11,girl,1,12,3.599344919224701e-5
yaminah,11,girl,0,11,3.2993995092893096e-5
zadie,11,girl,0,11,3.2993995092893096e-5
zareen,11,girl,0,11,3.2993995092893096e-5
zola,11,girl,1,12,3.599344919224701e-5
zoyah,11,girl,2,13,3.899290329160093e-5
zulaikha,11,girl,0,11,3.2993995092893096e-5
aahana,10,girl,0,10,2.9994540993539176e-5
aaniyah,10,girl,0,10,2.9994540993539176e-5
aayla,10,girl,2,12,3.599344919224701e-5
adaeze,10,girl,0,10,2.9994540993539176e-5
adel,10,girl,0,10,2.9994540993539176e-5
ahana,10,girl,0,10,2.9994540993539176e-5
ahlam,10,girl,1,11,3.2993995092893096e-5
ainhoa,10,girl,0,10,2.9994540993539176e-5
airah,10,girl,0,10,2.9994540993539176e-5
aivah,10,girl,1,11,3.2993995092893096e-5
aiylah,10,girl,1,11,3.2993995092893096e-5
alani,10,girl,0,10,2.9994540993539176e-5
alanis,10,girl,0,10,2.9994540993539176e-5
alberta,10,girl,0,10,2.9994540993539176e-5
alea,10,girl,2,12,3.599344919224701e-5
almira,10,girl,1,11,3.2993995092893096e-5
alvina,10,girl,0,10,2.9994540993539176e-5
ama,10,girl,0,10,2.9994540993539176e-5
amberly,10,girl,0,10,2.9994540993539176e-5
amel,10,girl,1,11,3.2993995092893096e-5
amelia-jane,10,girl,1,11,3.2993995092893096e-5
amia,10,girl,1,11,3.2993995092893096e-5
amora,10,girl,2,12,3.599344919224701e-5
andreja,10,girl,0,10,2.9994540993539176e-5
angelika,10,girl,0,10,2.9994540993539176e-5
anna-rose,10,girl,2,12,3.599344919224701e-5
annaya,10,girl,1,11,3.2993995092893096e-5
annie-may,10,girl,0,10,2.9994540993539176e-5
anniyah,10,girl,0,10,2.9994540993539176e-5
arianwen,10,girl,1,11,3.2993995092893096e-5
ariba,10,girl,0,10,2.9994540993539176e-5
asees,10,girl,0,10,2.9994540993539176e-5
ashlee,10,girl,0,10,2.9994540993539176e-5
aster,10,girl,0,10,2.9994540993539176e-5
athea,10,girl,0,10,2.9994540993539176e-5
bareera,10,girl,0,10,2.9994540993539176e-5
bela,10,girl,0,10,2.9994540993539176e-5
bella-mae,10,girl,0,10,2.9994540993539176e-5
berry,10,girl,0,10,2.9994540993539176e-5
bonnie-mae,10,girl,0,10,2.9994540993539176e-5
brianne,10,girl,0,10,2.9994540993539176e-5
briar-rose,10,girl,0,10,2.9994540993539176e-5
casi,10,girl,0,10,2.9994540993539176e-5
charlotte-rose,10,girl,0,10,2.9994540993539176e-5
chiamaka,10,girl,0,10,2.9994540993539176e-5
christy,10,girl,0,10,2.9994540993539176e-5
clemency,10,girl,0,10,2.9994540993539176e-5
cody,10,girl,1,11,3.2993995092893096e-5
cynthia,10,girl,0,10,2.9994540993539176e-5
daanya,10,girl,0,10,2.9994540993539176e-5
danae,10,girl,0,10,2.9994540993539176e-5
danica,10,girl,0,10,2.9994540993539176e-5
darcie-leigh,10,girl,1,11,3.2993995092893096e-5
delphi,10,girl,0,10,2.9994540993539176e-5
devorah,10,girl,0,10,2.9994540993539176e-5
dolores,10,girl,0,10,2.9994540993539176e-5
dominique,10,girl,0,10,2.9994540993539176e-5
doris,10,girl,0,10,2.9994540993539176e-5
dunya,10,girl,0,10,2.9994540993539176e-5
edee,10,girl,0,10,2.9994540993539176e-5
eiva,10,girl,3,13,3.899290329160093e-5
ekaterina,10,girl,1,11,3.2993995092893096e-5
elektra,10,girl,0,10,2.9994540993539176e-5
elis,10,girl,0,10,2.9994540993539176e-5
emel,10,girl,0,10,2.9994540993539176e-5
emerald,10,girl,0,10,2.9994540993539176e-5
emillie,10,girl,2,12,3.599344919224701e-5
eniola,10,girl,0,10,2.9994540993539176e-5
esra,10,girl,0,10,2.9994540993539176e-5
eugenie,10,girl,0,10,2.9994540993539176e-5
eva-marie,10,girl,1,11,3.2993995092893096e-5
evee,10,girl,1,11,3.2993995092893096e-5
falaq,10,girl,0,10,2.9994540993539176e-5
fenella,10,girl,0,10,2.9994540993539176e-5
frankie-rose,10,girl,1,11,3.2993995092893096e-5
freya-louise,10,girl,0,10,2.9994540993539176e-5
genesis,10,girl,0,10,2.9994540993539176e-5
georgia-rose,10,girl,2,12,3.599344919224701e-5
georgie-mae,10,girl,0,10,2.9994540993539176e-5
gina,10,girl,1,11,3.2993995092893096e-5
ginevra,10,girl,0,10,2.9994540993539176e-5
gracie-lou,10,girl,0,10,2.9994540993539176e-5
gracie-rae,10,girl,0,10,2.9994540993539176e-5
gurbani,10,girl,0,10,2.9994540993539176e-5
guste,10,girl,1,11,3.2993995092893096e-5
hailie,10,girl,3,13,3.899290329160093e-5
harley-rose,10,girl,0,10,2.9994540993539176e-5
heba,10,girl,0,10,2.9994540993539176e-5
heloise,10,girl,0,10,2.9994540993539176e-5
hidaya,10,girl,0,10,2.9994540993539176e-5
hooriyah,10,girl,0,10,2.9994540993539176e-5
imelda,10,girl,1,11,3.2993995092893096e-5
inga,10,girl,3,13,3.899290329160093e-5
irena,10,girl,3,13,3.899290329160093e-5
ishani,10,girl,0,10,2.9994540993539176e-5
ismah,10,girl,0,10,2.9994540993539176e-5
ivory,10,girl,0,10,2.9994540993539176e-5
jacey,10,girl,0,10,2.9994540993539176e-5
janet,10,girl,0,10,2.9994540993539176e-5
jasmyn,10,girl,0,10,2.9994540993539176e-5
jasneet,10,girl,0,10,2.9994540993539176e-5
jayde,10,girl,3,13,3.899290329160093e-5
jenelle,10,girl,0,10,2.9994540993539176e-5
jewel,10,girl,1,11,3.2993995092893096e-5
jovie,10,girl,0,10,2.9994540993539176e-5
kareena,10,girl,0,10,2.9994540993539176e-5
kaycie,10,girl,0,10,2.9994540993539176e-5
keisha,10,girl,1,11,3.2993995092893096e-5
khaira,10,girl,2,12,3.599344919224701e-5
kirat,10,girl,0,10,2.9994540993539176e-5
kirsty,10,girl,17,27,8.098526068255578e-5
kiyara,10,girl,0,10,2.9994540993539176e-5
lacey-leigh,10,girl,0,10,2.9994540993539176e-5
lacie-mai,10,girl,2,12,3.599344919224701e-5
laney,10,girl,0,10,2.9994540993539176e-5
layaan,10,girl,1,11,3.2993995092893096e-5
lenka,10,girl,0,10,2.9994540993539176e-5
lexy,10,girl,2,12,3.599344919224701e-5
lian,10,girl,0,10,2.9994540993539176e-5
lianna,10,girl,2,12,3.599344919224701e-5
lila-rose,10,girl,0,10,2.9994540993539176e-5
lilley,10,girl,0,10,2.9994540993539176e-5
lilly-rae,10,girl,1,11,3.2993995092893096e-5
lillyanna,10,girl,1,11,3.2993995092893096e-5
liwia,10,girl,1,11,3.2993995092893096e-5
lizzie,10,girl,0,10,2.9994540993539176e-5
london,10,girl,0,10,2.9994540993539176e-5
lorin,10,girl,1,11,3.2993995092893096e-5
lyla-mae,10,girl,0,10,2.9994540993539176e-5
maidah,10,girl,0,10,2.9994540993539176e-5
maisie-leigh,10,girl,0,10,2.9994540993539176e-5
maliah,10,girl,0,10,2.9994540993539176e-5
marcela,10,girl,0,10,2.9994540993539176e-5
marceline,10,girl,2,12,3.599344919224701e-5
merida,10,girl,4,14,4.1992357390954844e-5
mia-louise,10,girl,1,11,3.2993995092893096e-5
mia-mae,10,girl,0,10,2.9994540993539176e-5
micah,10,girl,1,11,3.2993995092893096e-5
migle,10,girl,0,10,2.9994540993539176e-5
minnie-mae,10,girl,0,10,2.9994540993539176e-5
miral,10,girl,0,10,2.9994540993539176e-5
miraya,10,girl,0,10,2.9994540993539176e-5
miri,10,girl,0,10,2.9994540993539176e-5
mischa,10,girl,1,11,3.2993995092893096e-5
mollie-mae,10,girl,1,11,3.2993995092893096e-5
muskan,10,girl,0,10,2.9994540993539176e-5
myiesha,10,girl,0,10,2.9994540993539176e-5
nathalie,10,girl,0,10,2.9994540993539176e-5
neli,10,girl,0,10,2.9994540993539176e-5
nessa,10,girl,0,10,2.9994540993539176e-5
noemie,10,girl,1,11,3.2993995092893096e-5
nusaiba,10,girl,0,10,2.9994540993539176e-5
odette,10,girl,2,12,3.599344919224701e-5
ohemaa,10,girl,0,10,2.9994540993539176e-5
oreoluwa,10,girl,1,11,3.2993995092893096e-5
orlah,10,girl,7,17,5.09907196890166e-5
paisley-rae,10,girl,0,10,2.9994540993539176e-5
patience,10,girl,0,10,2.9994540993539176e-5
pepper,10,girl,0,10,2.9994540993539176e-5
porscha,10,girl,0,10,2.9994540993539176e-5
raghad,10,girl,1,11,3.2993995092893096e-5
raima,10,girl,0,10,2.9994540993539176e-5
rameen,10,girl,2,12,3.599344919224701e-5
rani,10,girl,0,10,2.9994540993539176e-5
reena,10,girl,0,10,2.9994540993539176e-5
ren,10,girl,1,11,3.2993995092893096e-5
rima,10,girl,1,11,3.2993995092893096e-5
romie,10,girl,0,10,2.9994540993539176e-5
rosey,10,girl,0,10,2.9994540993539176e-5
roshni,10,girl,0,10,2.9994540993539176e-5
sadaf,10,girl,0,10,2.9994540993539176e-5
saima,10,girl,1,11,3.2993995092893096e-5
saleha,10,girl,1,11,3.2993995092893096e-5
samaa,10,girl,0,10,2.9994540993539176e-5
sehrish,10,girl,0,10,2.9994540993539176e-5
serafina,10,girl,0,10,2.9994540993539176e-5
serayah,10,girl,0,10,2.9994540993539176e-5
serenna,10,girl,1,11,3.2993995092893096e-5
shaan,10,girl,0,10,2.9994540993539176e-5
shaina,10,girl,0,10,2.9994540993539176e-5
shauna,10,girl,1,11,3.2993995092893096e-5
shaya,10,girl,0,10,2.9994540993539176e-5
sheila,10,girl,0,10,2.9994540993539176e-5
shriya,10,girl,0,10,2.9994540993539176e-5
sidney,10,girl,0,10,2.9994540993539176e-5
sienna-may,10,girl,1,11,3.2993995092893096e-5
sloane,10,girl,1,11,3.2993995092893096e-5
sofia-rose,10,girl,1,11,3.2993995092893096e-5
starr,10,girl,2,12,3.599344919224701e-5
sundus,10,girl,2,12,3.599344919224701e-5
sunny,10,girl,3,13,3.899290329160093e-5
suri,10,girl,1,11,3.2993995092893096e-5
tabatha,10,girl,0,10,2.9994540993539176e-5
tabita,10,girl,0,10,2.9994540993539176e-5
tallula,10,girl,0,10,2.9994540993539176e-5
tanaya,10,girl,0,10,2.9994540993539176e-5
tanzila,10,girl,0,10,2.9994540993539176e-5
temiloluwa,10,girl,1,11,3.2993995092893096e-5
thiya,10,girl,0,10,2.9994540993539176e-5
timeea,10,girl,0,10,2.9994540993539176e-5
tiya,10,girl,0,10,2.9994540993539176e-5
tola,10,girl,2,12,3.599344919224701e-5
tyra,10,girl,0,10,2.9994540993539176e-5
vasiliki,10,girl,0,10,2.9994540993539176e-5
veda,10,girl,0,10,2.9994540993539176e-5
yoana,10,girl,1,11,3.2993995092893096e-5
zaya,10,girl,0,10,2.9994540993539176e-5
zayah,10,girl,0,10,2.9994540993539176e-5
zion,10,girl,1,11,3.2993995092893096e-5
zlata,10,girl,1,11,3.2993995092893096e-5
a'isha,9,girl,0,9,2.699508689418526e-5
aanaya,9,girl,0,9,2.699508689418526e-5
abisha,9,girl,0,9,2.699508689418526e-5
adanna,9,girl,1,10,2.9994540993539176e-5
adeola,9,girl,0,9,2.699508689418526e-5
adora,9,girl,2,11,3.2993995092893096e-5
adrija,9,girl,2,11,3.2993995092893096e-5
afifa,9,girl,0,9,2.699508689418526e-5
aidah,9,girl,0,9,2.699508689418526e-5
ailah,9,girl,2,11,3.2993995092893096e-5
aiman,9,girl,2,11,3.2993995092893096e-5
alexis-rose,9,girl,2,11,3.2993995092893096e-5
alima,9,girl,0,9,2.699508689418526e-5
alix,9,girl,10,19,5.698962788772443e-5
allanah,9,girl,1,10,2.9994540993539176e-5
allison,9,girl,2,11,3.2993995092893096e-5
amelia-louise,9,girl,0,9,2.699508689418526e-5
amila,9,girl,1,10,2.9994540993539176e-5
amreen,9,girl,0,9,2.699508689418526e-5
anaisa,9,girl,0,9,2.699508689418526e-5
analise,9,girl,0,9,2.699508689418526e-5
anastacia,9,girl,1,10,2.9994540993539176e-5
anastasija,9,girl,0,9,2.699508689418526e-5
andi,9,girl,6,15,4.4991811490308764e-5
andrada,9,girl,0,9,2.699508689418526e-5
angeline,9,girl,0,9,2.699508689418526e-5
anisah,9,girl,0,9,2.699508689418526e-5
annabeth,9,girl,1,10,2.9994540993539176e-5
annalisa,9,girl,0,9,2.699508689418526e-5
annie-mae,9,girl,1,10,2.9994540993539176e-5
aradhya,9,girl,1,10,2.9994540993539176e-5
arayah,9,girl,0,9,2.699508689418526e-5
areebah,9,girl,1,10,2.9994540993539176e-5
aribah,9,girl,0,9,2.699508689418526e-5
arlia,9,girl,0,9,2.699508689418526e-5
asmin,9,girl,0,9,2.699508689418526e-5
auguste,9,girl,0,9,2.699508689418526e-5
ayan,9,girl,0,9,2.699508689418526e-5
aziza,9,girl,0,9,2.699508689418526e-5
batool,9,girl,0,9,2.699508689418526e-5
batsheva,9,girl,0,9,2.699508689418526e-5
billie-jo,9,girl,0,9,2.699508689418526e-5
binky,9,girl,0,9,2.699508689418526e-5
bleu,9,girl,1,10,2.9994540993539176e-5
blu,9,girl,0,9,2.699508689418526e-5
branwen,9,girl,0,9,2.699508689418526e-5
briar,9,girl,3,12,3.599344919224701e-5
camelia,9,girl,2,11,3.2993995092893096e-5
cami,9,girl,0,9,2.699508689418526e-5
carissa,9,girl,0,9,2.699508689418526e-5
caterina,9,girl,0,9,2.699508689418526e-5
cattleya,9,girl,0,9,2.699508689418526e-5
cayla,9,girl,2,11,3.2993995092893096e-5
chani,9,girl,0,9,2.699508689418526e-5
cheryl,9,girl,1,10,2.9994540993539176e-5
codie,9,girl,0,9,2.699508689418526e-5
coraline,9,girl,0,9,2.699508689418526e-5
cornelia,9,girl,0,9,2.699508689418526e-5
daisy-leigh,9,girl,0,9,2.699508689418526e-5
damaris,9,girl,0,9,2.699508689418526e-5
darcey-rose,9,girl,0,9,2.699508689418526e-5
darcie-may,9,girl,0,9,2.699508689418526e-5
darina,9,girl,1,10,2.9994540993539176e-5
dayna,9,girl,0,9,2.699508689418526e-5
debora,9,girl,1,10,2.9994540993539176e-5
delina,9,girl,0,9,2.699508689418526e-5
dior,9,girl,1,10,2.9994540993539176e-5
disha,9,girl,0,9,2.699508689418526e-5
dolce,9,girl,0,9,2.699508689418526e-5
eleonore,9,girl,0,9,2.699508689418526e-5
eliska,9,girl,0,9,2.699508689418526e-5
elizabeth-rose,9,girl,0,9,2.699508689418526e-5
elliot,9,girl,0,9,2.699508689418526e-5
elsbeth,9,girl,0,9,2.699508689418526e-5
elze,9,girl,1,10,2.9994540993539176e-5
emile,9,girl,0,9,2.699508689418526e-5
esila,9,girl,0,9,2.699508689418526e-5
evelynne,9,girl,1,10,2.9994540993539176e-5
evie-louise,9,girl,1,10,2.9994540993539176e-5
faria,9,girl,0,9,2.699508689418526e-5
farida,9,girl,0,9,2.699508689418526e-5
fatou,9,girl,1,10,2.9994540993539176e-5
fenna,9,girl,0,9,2.699508689418526e-5
fiadh,9,girl,1,10,2.9994540993539176e-5
francisca,9,girl,0,9,2.699508689418526e-5
frankie-leigh,9,girl,0,9,2.699508689418526e-5
freida,9,girl,1,10,2.9994540993539176e-5
gwyneth,9,girl,0,9,2.699508689418526e-5
habibah,9,girl,0,9,2.699508689418526e-5
hajirah,9,girl,0,9,2.699508689418526e-5
hamda,9,girl,0,9,2.699508689418526e-5
harper-lily,9,girl,0,9,2.699508689418526e-5
henna,9,girl,0,9,2.699508689418526e-5
hera,9,girl,0,9,2.699508689418526e-5
honey-rose,9,girl,0,9,2.699508689418526e-5
ina,9,girl,0,9,2.699508689418526e-5
inaara,9,girl,0,9,2.699508689418526e-5
inka,9,girl,2,11,3.2993995092893096e-5
iremide,9,girl,0,9,2.699508689418526e-5
jaycee,9,girl,0,9,2.699508689418526e-5
jayna,9,girl,0,9,2.699508689418526e-5
jessika,9,girl,0,9,2.699508689418526e-5
juwayriya,9,girl,0,9,2.699508689418526e-5
kadija,9,girl,0,9,2.699508689418526e-5
kalani,9,girl,0,9,2.699508689418526e-5
kayla-mae,9,girl,0,9,2.699508689418526e-5
kia,9,girl,0,9,2.699508689418526e-5
kiyah,9,girl,0,9,2.699508689418526e-5
kodie,9,girl,0,9,2.699508689418526e-5
ksenia,9,girl,1,10,2.9994540993539176e-5
layah,9,girl,1,10,2.9994540993539176e-5
layana,9,girl,0,9,2.699508689418526e-5
leeya,9,girl,0,9,2.699508689418526e-5
lennon,9,girl,3,12,3.599344919224701e-5
lexi-lou,9,girl,0,9,2.699508689418526e-5
liliane,9,girl,0,9,2.699508689418526e-5
lilly-jane,9,girl,0,9,2.699508689418526e-5
lola-rae,9,girl,1,10,2.9994540993539176e-5
lora,9,girl,0,9,2.699508689418526e-5
lucy-mae,9,girl,1,10,2.9994540993539176e-5
luena,9,girl,0,9,2.699508689418526e-5
luna-mae,9,girl,0,9,2.699508689418526e-5
luna-rae,9,girl,0,9,2.699508689418526e-5
lux,9,girl,1,10,2.9994540993539176e-5
maaria,9,girl,0,9,2.699508689418526e-5
maddison-rose,9,girl,1,10,2.9994540993539176e-5
madison-rose,9,girl,0,9,2.699508689418526e-5
mahsa,9,girl,0,9,2.699508689418526e-5
mahum,9,girl,1,10,2.9994540993539176e-5
maryum,9,girl,0,9,2.699508689418526e-5
maya-rose,9,girl,2,11,3.2993995092893096e-5
maymunah,9,girl,0,9,2.699508689418526e-5
mehnoor,9,girl,1,10,2.9994540993539176e-5
melis,9,girl,0,9,2.699508689418526e-5
melita,9,girl,0,9,2.699508689418526e-5
melody-rose,9,girl,1,10,2.9994540993539176e-5
mena,9,girl,0,9,2.699508689418526e-5
mia-rae,9,girl,0,9,2.699508689418526e-5
miley-rose,9,girl,0,9,2.699508689418526e-5
mirabel,9,girl,2,11,3.2993995092893096e-5
misbah,9,girl,0,9,2.699508689418526e-5
nara,9,girl,0,9,2.699508689418526e-5
nataly,9,girl,0,9,2.699508689418526e-5
neala,9,girl,2,11,3.2993995092893096e-5
nectaria,9,girl,0,9,2.699508689418526e-5
nicol,9,girl,0,9,2.699508689418526e-5
nikki,9,girl,1,10,2.9994540993539176e-5
nolah,9,girl,1,10,2.9994540993539176e-5
noreen,9,girl,1,10,2.9994540993539176e-5
nusaibah,9,girl,0,9,2.699508689418526e-5
ona,9,girl,1,10,2.9994540993539176e-5
ora,9,girl,0,9,2.699508689418526e-5
pari,9,girl,0,9,2.699508689418526e-5
pavan,9,girl,0,9,2.699508689418526e-5
peri,9,girl,0,9,2.699508689418526e-5
presley,9,girl,0,9,2.699508689418526e-5
rabiya,9,girl,0,9,2.699508689418526e-5
raffaella,9,girl,0,9,2.699508689418526e-5
raia,9,girl,1,10,2.9994540993539176e-5
raluca,9,girl,0,9,2.699508689418526e-5
raphaela,9,girl,0,9,2.699508689418526e-5
reema,9,girl,0,9,2.699508689418526e-5
reese,9,girl,1,10,2.9994540993539176e-5
renata,9,girl,1,10,2.9994540993539176e-5
reva,9,girl,1,10,2.9994540993539176e-5
riona,9,girl,1,10,2.9994540993539176e-5
romana,9,girl,0,9,2.699508689418526e-5
romeesa,9,girl,0,9,2.699508689418526e-5
roselyn,9,girl,1,10,2.9994540993539176e-5
rosie-mai,9,girl,0,9,2.699508689418526e-5
ruqayah,9,girl,0,9,2.699508689418526e-5
sabah,9,girl,0,9,2.699508689418526e-5
sabrin,9,girl,1,10,2.9994540993539176e-5
saffa,9,girl,1,10,2.9994540993539176e-5
saffiya,9,girl,0,9,2.699508689418526e-5
sakura,9,girl,0,9,2.699508689418526e-5
samarah,9,girl,0,9,2.699508689418526e-5
samreen,9,girl,0,9,2.699508689418526e-5
saniya,9,girl,0,9,2.699508689418526e-5
saphia,9,girl,0,9,2.699508689418526e-5
saphira,9,girl,0,9,2.699508689418526e-5
saraya,9,girl,0,9,2.699508689418526e-5
scarlett-louise,9,girl,0,9,2.699508689418526e-5
sehajpreet,9,girl,1,10,2.9994540993539176e-5
seryn,9,girl,2,11,3.2993995092893096e-5
sham,9,girl,2,11,3.2993995092893096e-5
shekinah,9,girl,0,9,2.699508689418526e-5
shira,9,girl,0,9,2.699508689418526e-5
shylah,9,girl,0,9,2.699508689418526e-5
silver,9,girl,0,9,2.699508689418526e-5
skyla-mai,9,girl,0,9,2.699508689418526e-5
skyler-rose,9,girl,0,9,2.699508689418526e-5
smilte,9,girl,0,9,2.699508689418526e-5
sri,9,girl,0,9,2.699508689418526e-5
starla,9,girl,1,10,2.9994540993539176e-5
talulah,9,girl,1,10,2.9994540993539176e-5
tamsyn,9,girl,0,9,2.699508689418526e-5
taybah,9,girl,0,9,2.699508689418526e-5
tiah,9,girl,0,9,2.699508689418526e-5
timea,9,girl,0,9,2.699508689418526e-5
urte,9,girl,0,9,2.699508689418526e-5
wajiha,9,girl,0,9,2.699508689418526e-5
yasna,9,girl,0,9,2.699508689418526e-5
ysabella,9,girl,0,9,2.699508689418526e-5
ysella,9,girl,0,9,2.699508689418526e-5
yvie,9,girl,0,9,2.699508689418526e-5
zinnia,9,girl,0,9,2.699508689418526e-5
zulekha,9,girl,0,9,2.699508689418526e-5
zyana,9,girl,0,9,2.699508689418526e-5
aashi,8,girl,1,9,2.699508689418526e-5
abida,8,girl,0,8,2.3995632794831342e-5
addilyn,8,girl,0,8,2.3995632794831342e-5
afsheen,8,girl,0,8,2.3995632794831342e-5
ailish,8,girl,6,14,4.1992357390954844e-5
aimee-leigh,8,girl,3,11,3.2993995092893096e-5
alanya,8,girl,0,8,2.3995632794831342e-5
aleigha,8,girl,3,11,3.2993995092893096e-5
aleya,8,girl,0,8,2.3995632794831342e-5
aleyah,8,girl,1,9,2.699508689418526e-5
amarni,8,girl,0,8,2.3995632794831342e-5
anah,8,girl,1,9,2.699508689418526e-5
anashe,8,girl,0,8,2.3995632794831342e-5
angel-rose,8,girl,0,8,2.3995632794831342e-5
anna-maria,8,girl,0,8,2.3995632794831342e-5
annayah,8,girl,0,8,2.3995632794831342e-5
annelise,8,girl,4,12,3.599344919224701e-5
anvika,8,girl,0,8,2.3995632794831342e-5
ariadna,8,girl,0,8,2.3995632794831342e-5
arna,8,girl,0,8,2.3995632794831342e-5
arveen,8,girl,0,8,2.3995632794831342e-5
aryanna,8,girl,0,8,2.3995632794831342e-5
asmara,8,girl,0,8,2.3995632794831342e-5
avalyn,8,girl,0,8,2.3995632794831342e-5
aveen,8,girl,0,8,2.3995632794831342e-5
avnoor,8,girl,0,8,2.3995632794831342e-5
awa,8,girl,0,8,2.3995632794831342e-5
ayla-mae,8,girl,0,8,2.3995632794831342e-5
bahar,8,girl,0,8,2.3995632794831342e-5
barbora,8,girl,0,8,2.3995632794831342e-5
bebe,8,girl,0,8,2.3995632794831342e-5
bettie,8,girl,0,8,2.3995632794831342e-5
billie-mae,8,girl,0,8,2.3995632794831342e-5
bonny,8,girl,1,9,2.699508689418526e-5
calla,8,girl,7,15,4.4991811490308764e-5
calli,8,girl,2,10,2.9994540993539176e-5
caprice,8,girl,1,9,2.699508689418526e-5
carlie,8,girl,2,10,2.9994540993539176e-5
carlota,8,girl,0,8,2.3995632794831342e-5
catarina,8,girl,0,8,2.3995632794831342e-5
catriona,8,girl,11,19,5.698962788772443e-5
chava,8,girl,0,8,2.3995632794831342e-5
chyna,8,girl,0,8,2.3995632794831342e-5
cianna,8,girl,0,8,2.3995632794831342e-5
connie-rose,8,girl,0,8,2.3995632794831342e-5
cooper,8,girl,0,8,2.3995632794831342e-5
cydney,8,girl,0,8,2.3995632794831342e-5
damilola,8,girl,0,8,2.3995632794831342e-5
danaya,8,girl,0,8,2.3995632794831342e-5
dara,8,girl,4,12,3.599344919224701e-5
darcee,8,girl,0,8,2.3995632794831342e-5
darcy-mae,8,girl,0,8,2.3995632794831342e-5
darcy-rose,8,girl,1,9,2.699508689418526e-5
delaney,8,girl,0,8,2.3995632794831342e-5
demi-rose,8,girl,0,8,2.3995632794831342e-5
dhanvi,8,girl,0,8,2.3995632794831342e-5
divya,8,girl,0,8,2.3995632794831342e-5
dollie-mae,8,girl,0,8,2.3995632794831342e-5
dolly-rose,8,girl,0,8,2.3995632794831342e-5
dominica,8,girl,0,8,2.3995632794831342e-5
donna,8,girl,0,8,2.3995632794831342e-5
ebba,8,girl,0,8,2.3995632794831342e-5
elan,8,girl,0,8,2.3995632794831342e-5
elisheva,8,girl,0,8,2.3995632794831342e-5
elivia,8,girl,0,8,2.3995632794831342e-5
eliyana,8,girl,0,8,2.3995632794831342e-5
ellie-grace,8,girl,0,8,2.3995632794831342e-5
ellie-jane,8,girl,1,9,2.699508689418526e-5
emeline,8,girl,0,8,2.3995632794831342e-5
emery,8,girl,0,8,2.3995632794831342e-5
emilia-grace,8,girl,0,8,2.3995632794831342e-5
emiliana,8,girl,1,9,2.699508689418526e-5
emily-jayne,8,girl,0,8,2.3995632794831342e-5
enfys,8,girl,0,8,2.3995632794831342e-5
eva-mai,8,girl,0,8,2.3995632794831342e-5
eva-maria,8,girl,0,8,2.3995632794831342e-5
evangelina,8,girl,0,8,2.3995632794831342e-5
evie-marie,8,girl,0,8,2.3995632794831342e-5
fabiana,8,girl,0,8,2.3995632794831342e-5
fabiola,8,girl,0,8,2.3995632794831342e-5
flossie,8,girl,0,8,2.3995632794831342e-5
freidy,8,girl,0,8,2.3995632794831342e-5
giuliana,8,girl,1,9,2.699508689418526e-5
gretel,8,girl,0,8,2.3995632794831342e-5
haadiyah,8,girl,0,8,2.3995632794831342e-5
haneefa,8,girl,0,8,2.3995632794831342e-5
hanya,8,girl,0,8,2.3995632794831342e-5
harli,8,girl,1,9,2.699508689418526e-5
harper-louise,8,girl,0,8,2.3995632794831342e-5
hartley,8,girl,0,8,2.3995632794831342e-5
harveen,8,girl,0,8,2.3995632794831342e-5
hayleigh,8,girl,2,10,2.9994540993539176e-5
hero,8,girl,0,8,2.3995632794831342e-5
hindy,8,girl,0,8,2.3995632794831342e-5
honour,8,girl,0,8,2.3995632794831342e-5
humayrah,8,girl,0,8,2.3995632794831342e-5
humna,8,girl,2,10,2.9994540993539176e-5
hunter,8,girl,0,8,2.3995632794831342e-5
ikra,8,girl,0,8,2.3995632794831342e-5
ilayda,8,girl,0,8,2.3995632794831342e-5
imarni,8,girl,0,8,2.3995632794831342e-5
iram,8,girl,0,8,2.3995632794831342e-5
isabella-mae,8,girl,0,8,2.3995632794831342e-5
isla-louise,8,girl,0,8,2.3995632794831342e-5
italia,8,girl,0,8,2.3995632794831342e-5
jaiya,8,girl,0,8,2.3995632794831342e-5
jamelia,8,girl,0,8,2.3995632794831342e-5
janice,8,girl,1,9,2.699508689418526e-5
jasmeet,8,girl,0,8,2.3995632794831342e-5
jemma,8,girl,4,12,3.599344919224701e-5
jessy,8,girl,0,8,2.3995632794831342e-5
joud,8,girl,0,8,2.3995632794831342e-5
junainah,8,girl,0,8,2.3995632794831342e-5
juwairiyah,8,girl,0,8,2.3995632794831342e-5
kacey-leigh,8,girl,1,9,2.699508689418526e-5
kamilah,8,girl,0,8,2.3995632794831342e-5
karmen,8,girl,3,11,3.2993995092893096e-5
kashvi,8,girl,0,8,2.3995632794831342e-5
kassia,8,girl,0,8,2.3995632794831342e-5
keavy,8,girl,2,10,2.9994540993539176e-5
keira-leigh,8,girl,0,8,2.3995632794831342e-5
kenya,8,girl,0,8,2.3995632794831342e-5
kiarah,8,girl,0,8,2.3995632794831342e-5
kiyana,8,girl,0,8,2.3995632794831342e-5
kleo,8,girl,3,11,3.2993995092893096e-5
lacey-louise,8,girl,0,8,2.3995632794831342e-5
lakshmi,8,girl,1,9,2.699508689418526e-5
laraib,8,girl,0,8,2.3995632794831342e-5
laycee,8,girl,1,9,2.699508689418526e-5
laynie,8,girl,0,8,2.3995632794831342e-5
leana,8,girl,0,8,2.3995632794831342e-5
leelah,8,girl,0,8,2.3995632794831342e-5
leora,8,girl,0,8,2.3995632794831342e-5
letti,8,girl,0,8,2.3995632794831342e-5
lexi-louise,8,girl,0,8,2.3995632794831342e-5
lexi-rae,8,girl,0,8,2.3995632794831342e-5
lexie-rose,8,girl,0,8,2.3995632794831342e-5
lillie-ann,8,girl,0,8,2.3995632794831342e-5
lillie-anne,8,girl,0,8,2.3995632794831342e-5
lily-ella,8,girl,0,8,2.3995632794831342e-5
liyaana,8,girl,0,8,2.3995632794831342e-5
liyanah,8,girl,0,8,2.3995632794831342e-5
lleucu,8,girl,0,8,2.3995632794831342e-5
lola-louise,8,girl,1,9,2.699508689418526e-5
loretta,8,girl,0,8,2.3995632794831342e-5
lorraine,8,girl,0,8,2.3995632794831342e-5
lottie-rae,8,girl,0,8,2.3995632794831342e-5
lotus,8,girl,2,10,2.9994540993539176e-5
louisiana,8,girl,0,8,2.3995632794831342e-5
luci,8,girl,4,12,3.599344919224701e-5
lukne,8,girl,0,8,2.3995632794831342e-5
lumi,8,girl,0,8,2.3995632794831342e-5
lyna,8,girl,1,9,2.699508689418526e-5
maarya,8,girl,0,8,2.3995632794831342e-5
madilyn,8,girl,0,8,2.3995632794831342e-5
maiyah,8,girl,1,9,2.699508689418526e-5
mansirat,8,girl,0,8,2.3995632794831342e-5
maram,8,girl,0,8,2.3995632794831342e-5
mary-kate,8,girl,2,10,2.9994540993539176e-5
maude,8,girl,0,8,2.3995632794831342e-5
maymuna,8,girl,0,8,2.3995632794831342e-5
maysoon,8,girl,0,8,2.3995632794831342e-5
mckenzie,8,girl,1,9,2.699508689418526e-5
mea,8,girl,0,8,2.3995632794831342e-5
meg,8,girl,1,9,2.699508689418526e-5
milli,8,girl,2,10,2.9994540993539176e-5
mirabella,8,girl,0,8,2.3995632794831342e-5
mirren,8,girl,43,51,1.5297215906704979e-4
monet,8,girl,0,8,2.3995632794831342e-5
morayo,8,girl,0,8,2.3995632794831342e-5
murphy,8,girl,0,8,2.3995632794831342e-5
mylie,8,girl,4,12,3.599344919224701e-5
narin,8,girl,0,8,2.3995632794831342e-5
narla,8,girl,0,8,2.3995632794831342e-5
nechama,8,girl,0,8,2.3995632794831342e-5
nicoleta,8,girl,0,8,2.3995632794831342e-5
nishka,8,girl,0,8,2.3995632794831342e-5
noella,8,girl,0,8,2.3995632794831342e-5
noor-fatima,8,girl,1,9,2.699508689418526e-5
noorulain,8,girl,0,8,2.3995632794831342e-5
oceana,8,girl,0,8,2.3995632794831342e-5
oonagh,8,girl,1,9,2.699508689418526e-5
parneet,8,girl,1,9,2.699508689418526e-5
peace,8,girl,0,8,2.3995632794831342e-5
penelope-rose,8,girl,1,9,2.699508689418526e-5
perri,8,girl,3,11,3.2993995092893096e-5
petal,8,girl,0,8,2.3995632794831342e-5
piper-rose,8,girl,2,10,2.9994540993539176e-5
qirat,8,girl,0,8,2.3995632794831342e-5
raeesa,8,girl,0,8,2.3995632794831342e-5
rafaella,8,girl,0,8,2.3995632794831342e-5
ravleen,8,girl,0,8,2.3995632794831342e-5
rayya,8,girl,0,8,2.3995632794831342e-5
rea,8,girl,0,8,2.3995632794831342e-5
reeya,8,girl,1,9,2.699508689418526e-5
regina,8,girl,0,8,2.3995632794831342e-5
rehana,8,girl,0,8,2.3995632794831342e-5
remie,8,girl,0,8,2.3995632794831342e-5
renaye,8,girl,0,8,2.3995632794831342e-5
rene,8,girl,0,8,2.3995632794831342e-5
retaj,8,girl,1,9,2.699508689418526e-5
rina,8,girl,0,8,2.3995632794831342e-5
rose-marie,8,girl,0,8,2.3995632794831342e-5
ruby-ann,8,girl,0,8,2.3995632794831342e-5
rumaisah,8,girl,0,8,2.3995632794831342e-5
saachi,8,girl,0,8,2.3995632794831342e-5
sabeeka,8,girl,0,8,2.3995632794831342e-5
sabreen,8,girl,0,8,2.3995632794831342e-5
sadiyah,8,girl,0,8,2.3995632794831342e-5
saina,8,girl,0,8,2.3995632794831342e-5
samaya,8,girl,0,8,2.3995632794831342e-5
sameera,8,girl,0,8,2.3995632794831342e-5
samiha,8,girl,0,8,2.3995632794831342e-5
samirah,8,girl,0,8,2.3995632794831342e-5
sanayah,8,girl,0,8,2.3995632794831342e-5
saria,8,girl,1,9,2.699508689418526e-5
savanah,8,girl,1,9,2.699508689418526e-5
serene,8,girl,1,9,2.699508689418526e-5
shanvi,8,girl,0,8,2.3995632794831342e-5
skylar-mae,8,girl,0,8,2.3995632794831342e-5
snow,8,girl,0,8,2.3995632794831342e-5
sonya,8,girl,0,8,2.3995632794831342e-5
sophia-mae,8,girl,0,8,2.3995632794831342e-5
sukayna,8,girl,0,8,2.3995632794831342e-5
sumeyye,8,girl,0,8,2.3995632794831342e-5
summayah,8,girl,0,8,2.3995632794831342e-5
suzannah,8,girl,1,9,2.699508689418526e-5
taaliah,8,girl,0,8,2.3995632794831342e-5
taiwo,8,girl,0,8,2.3995632794831342e-5
taiya,8,girl,0,8,2.3995632794831342e-5
taraoluwa,8,girl,1,9,2.699508689418526e-5
tereza,8,girl,0,8,2.3995632794831342e-5
trudy,8,girl,0,8,2.3995632794831342e-5
unaysah,8,girl,0,8,2.3995632794831342e-5
vaani,8,girl,0,8,2.3995632794831342e-5
vasilisa,8,girl,2,10,2.9994540993539176e-5
vicky,8,girl,2,10,2.9994540993539176e-5
vittoria,8,girl,0,8,2.3995632794831342e-5
viya,8,girl,0,8,2.3995632794831342e-5
wednesday,8,girl,0,8,2.3995632794831342e-5
yashfa,8,girl,0,8,2.3995632794831342e-5
yolanda,8,girl,1,9,2.699508689418526e-5
zahira,8,girl,0,8,2.3995632794831342e-5
zakia,8,girl,0,8,2.3995632794831342e-5
zamzam,8,girl,0,8,2.3995632794831342e-5
zeinab,8,girl,0,8,2.3995632794831342e-5
zoja,8,girl,1,9,2.699508689418526e-5
zumra,8,girl,0,8,2.3995632794831342e-5
aakifah,7,girl,0,7,2.0996178695477422e-5
aana,7,girl,0,7,2.0996178695477422e-5
aaniya,7,girl,0,7,2.0996178695477422e-5
abbi,7,girl,5,12,3.599344919224701e-5
abbigail,7,girl,1,8,2.3995632794831342e-5
abrar,7,girl,0,7,2.0996178695477422e-5
adah,7,girl,3,10,2.9994540993539176e-5
adalind,7,girl,0,7,2.0996178695477422e-5
adea,7,girl,0,7,2.0996178695477422e-5
adeeba,7,girl,0,7,2.0996178695477422e-5
adria,7,girl,0,7,2.0996178695477422e-5
adrielle,7,girl,0,7,2.0996178695477422e-5
aerin,7,girl,1,8,2.3995632794831342e-5
afiya,7,girl,0,7,2.0996178695477422e-5
agamjot,7,girl,0,7,2.0996178695477422e-5
al,7,girl,0,7,2.0996178695477422e-5
alaiyah,7,girl,0,7,2.0996178695477422e-5
alana-rose,7,girl,0,7,2.0996178695477422e-5
alannah-rose,7,girl,0,7,2.0996178695477422e-5
aleeyah,7,girl,0,7,2.0996178695477422e-5
aleisha,7,girl,0,7,2.0996178695477422e-5
alexa-rose,7,girl,0,7,2.0996178695477422e-5
ally,7,girl,2,9,2.699508689418526e-5
alva,7,girl,3,10,2.9994540993539176e-5
amali,7,girl,0,7,2.0996178695477422e-5
ameira,7,girl,2,9,2.699508689418526e-5
amelia-jade,7,girl,0,7,2.0996178695477422e-5
amely,7,girl,0,7,2.0996178695477422e-5
amen,7,girl,0,7,2.0996178695477422e-5
amiee,7,girl,0,7,2.0996178695477422e-5
amity,7,girl,0,7,2.0996178695477422e-5
amreet,7,girl,0,7,2.0996178695477422e-5
anaelle,7,girl,0,7,2.0996178695477422e-5
anamika,7,girl,0,7,2.0996178695477422e-5
andie,7,girl,8,15,4.4991811490308764e-5
andriana,7,girl,1,8,2.3995632794831342e-5
angelique,7,girl,1,8,2.3995632794831342e-5
ani,7,girl,0,7,2.0996178695477422e-5
aniah,7,girl,0,7,2.0996178695477422e-5
anishka,7,girl,0,7,2.0996178695477422e-5
anisia,7,girl,0,7,2.0996178695477422e-5
anshika,7,girl,1,8,2.3995632794831342e-5
antigone,7,girl,0,7,2.0996178695477422e-5
antonella,7,girl,0,7,2.0996178695477422e-5
apolline,7,girl,0,7,2.0996178695477422e-5
apolonia,7,girl,0,7,2.0996178695477422e-5
apryl,7,girl,1,8,2.3995632794831342e-5
arafah,7,girl,1,8,2.3995632794831342e-5
aria-mae,7,girl,0,7,2.0996178695477422e-5
ariarna,7,girl,0,7,2.0996178695477422e-5
armina,7,girl,0,7,2.0996178695477422e-5
arwyn,7,girl,2,9,2.699508689418526e-5
ashleen,7,girl,1,8,2.3995632794831342e-5
aspen,7,girl,1,8,2.3995632794831342e-5
aukse,7,girl,1,8,2.3995632794831342e-5
ava-jane,7,girl,0,7,2.0996178695477422e-5
ava-lilly,7,girl,0,7,2.0996178695477422e-5
avalon,7,girl,0,7,2.0996178695477422e-5
avana,7,girl,0,7,2.0996178695477422e-5
avril,7,girl,0,7,2.0996178695477422e-5
awen,7,girl,0,7,2.0996178695477422e-5
ayisha,7,girl,0,7,2.0996178695477422e-5
aysel,7,girl,0,7,2.0996178695477422e-5
ayvah,7,girl,0,7,2.0996178695477422e-5
baani,7,girl,1,8,2.3995632794831342e-5
bassy,7,girl,0,7,2.0996178695477422e-5
bayan,7,girl,0,7,2.0996178695477422e-5
bayleigh,7,girl,2,9,2.699508689418526e-5
beatris,7,girl,0,7,2.0996178695477422e-5
becky,7,girl,3,10,2.9994540993539176e-5
bella-louise,7,girl,0,7,2.0996178695477422e-5
beren,7,girl,0,7,2.0996178695477422e-5
betty-may,7,girl,0,7,2.0996178695477422e-5
billie-rose,7,girl,2,9,2.699508689418526e-5
bliss,7,girl,0,7,2.0996178695477422e-5
blue,7,girl,0,7,2.0996178695477422e-5
bonnie-rae,7,girl,0,7,2.0996178695477422e-5
bowie,7,girl,0,7,2.0996178695477422e-5
briella,7,girl,1,8,2.3995632794831342e-5
bruna,7,girl,0,7,2.0996178695477422e-5
bryher,7,girl,0,7,2.0996178695477422e-5
cailyn,7,girl,2,9,2.699508689418526e-5
callie-rose,7,girl,1,8,2.3995632794831342e-5
camellia,7,girl,0,7,2.0996178695477422e-5
candace,7,girl,0,7,2.0996178695477422e-5
charli,7,girl,2,9,2.699508689418526e-5
chloe-mai,7,girl,0,7,2.0996178695477422e-5
clarice,7,girl,1,8,2.3995632794831342e-5
cloe,7,girl,1,8,2.3995632794831342e-5
connie-rae,7,girl,0,7,2.0996178695477422e-5
crystal-rose,7,girl,0,7,2.0996178695477422e-5
cyra,7,girl,0,7,2.0996178695477422e-5
dagmara,7,girl,0,7,2.0996178695477422e-5
daisy-lou,7,girl,0,7,2.0996178695477422e-5
darby,7,girl,2,9,2.699508689418526e-5
deema,7,girl,1,8,2.3995632794831342e-5
derin,7,girl,0,7,2.0996178695477422e-5
desire,7,girl,0,7,2.0996178695477422e-5
desiree,7,girl,0,7,2.0996178695477422e-5
deya,7,girl,0,7,2.0996178695477422e-5
dila,7,girl,0,7,2.0996178695477422e-5
dima,7,girl,0,7,2.0996178695477422e-5
diyana,7,girl,0,7,2.0996178695477422e-5
dolly-may,7,girl,0,7,2.0996178695477422e-5
dolly-rae,7,girl,0,7,2.0996178695477422e-5
donya,7,girl,0,7,2.0996178695477422e-5
dorina,7,girl,0,7,2.0996178695477422e-5
dorsa,7,girl,1,8,2.3995632794831342e-5
edie-rose,7,girl,0,7,2.0996178695477422e-5
efrata,7,girl,0,7,2.0996178695477422e-5
eibhlin,7,girl,0,7,2.0996178695477422e-5
eimear,7,girl,5,12,3.599344919224701e-5
eirlys,7,girl,0,7,2.0996178695477422e-5
ekampreet,7,girl,0,7,2.0996178695477422e-5
eknoor,7,girl,0,7,2.0996178695477422e-5
elea,7,girl,0,7,2.0996178695477422e-5
eliya,7,girl,0,7,2.0996178695477422e-5
eliyah,7,girl,1,8,2.3995632794831342e-5
elkie,7,girl,1,8,2.3995632794831342e-5
elliemae,7,girl,0,7,2.0996178695477422e-5
elliw,7,girl,0,7,2.0996178695477422e-5
elmira,7,girl,0,7,2.0996178695477422e-5
elvi,7,girl,0,7,2.0996178695477422e-5
elyana,7,girl,1,8,2.3995632794831342e-5
emeli,7,girl,9,16,4.7991265589662684e-5
emily-jane,7,girl,1,8,2.3995632794831342e-5
erin-rose,7,girl,1,8,2.3995632794831342e-5
erva,7,girl,1,8,2.3995632794831342e-5
esmae-grace,7,girl,0,7,2.0996178695477422e-5
esraa,7,girl,0,7,2.0996178695477422e-5
esta,7,girl,0,7,2.0996178695477422e-5
everlynn,7,girl,0,7,2.0996178695477422e-5
eylul,7,girl,0,7,2.0996178695477422e-5
faatima,7,girl,0,7,2.0996178695477422e-5
fae,7,girl,0,7,2.0996178695477422e-5
fareedah,7,girl,0,7,2.0996178695477422e-5
fatimah-zahra,7,girl,0,7,2.0996178695477422e-5
fifi,7,girl,1,8,2.3995632794831342e-5
firdaus,7,girl,0,7,2.0996178695477422e-5
florie,7,girl,0,7,2.0996178695477422e-5
franchesca,7,girl,0,7,2.0996178695477422e-5
francis,7,girl,0,7,2.0996178695477422e-5
frankie-rae,7,girl,0,7,2.0996178695477422e-5
gergana,7,girl,0,7,2.0996178695477422e-5
goldie,7,girl,1,8,2.3995632794831342e-5
gracie-rose,7,girl,2,9,2.699508689418526e-5
gwendoline,7,girl,0,7,2.0996178695477422e-5
hallie-may,7,girl,0,7,2.0996178695477422e-5
hallie-rae,7,girl,1,8,2.3995632794831342e-5
hamidah,7,girl,1,8,2.3995632794831342e-5
hani,7,girl,0,7,2.0996178695477422e-5
harlowe,7,girl,0,7,2.0996178695477422e-5
harneet,7,girl,0,7,2.0996178695477422e-5
harper-lee,7,girl,0,7,2.0996178695477422e-5
harper-lilly,7,girl,1,8,2.3995632794831342e-5
hasna,7,girl,0,7,2.0996178695477422e-5
hawaa,7,girl,0,7,2.0996178695477422e-5
hebe,7,girl,0,7,2.0996178695477422e-5
hetti,7,girl,0,7,2.0996178695477422e-5
hollie-rose,7,girl,0,7,2.0996178695477422e-5
holly-mae,7,girl,0,7,2.0996178695477422e-5
idman,7,girl,0,7,2.0996178695477422e-5
ifeoluwa,7,girl,0,7,2.0996178695477422e-5
ifza,7,girl,0,7,2.0996178695477422e-5
ilham,7,girl,0,7,2.0996178695477422e-5
ilona,7,girl,1,8,2.3995632794831342e-5
indie-mae,7,girl,0,7,2.0996178695477422e-5
indiya,7,girl,0,7,2.0996178695477422e-5
ioanna,7,girl,0,7,2.0996178695477422e-5
ira,7,girl,0,7,2.0996178695477422e-5
ishana,7,girl,0,7,2.0996178695477422e-5
ishika,7,girl,0,7,2.0996178695477422e-5
isolde,7,girl,0,7,2.0996178695477422e-5
ivey,7,girl,0,7,2.0996178695477422e-5
ivy-mai,7,girl,0,7,2.0996178695477422e-5
iyana,7,girl,1,8,2.3995632794831342e-5
iyla-mae,7,girl,0,7,2.0996178695477422e-5
izabele,7,girl,1,8,2.3995632794831342e-5
izzabelle,7,girl,0,7,2.0996178695477422e-5
janessa,7,girl,0,7,2.0996178695477422e-5
jannatul,7,girl,0,7,2.0996178695477422e-5
janvi,7,girl,0,7,2.0996178695477422e-5
japleen,7,girl,0,7,2.0996178695477422e-5
jazlyn,7,girl,0,7,2.0996178695477422e-5
jazmyn,7,girl,0,7,2.0996178695477422e-5
jenika,7,girl,0,7,2.0996178695477422e-5
jennie,7,girl,0,7,2.0996178695477422e-5
joella,7,girl,0,7,2.0996178695477422e-5
jolene,7,girl,0,7,2.0996178695477422e-5
jorgie-mae,7,girl,0,7,2.0996178695477422e-5
joycelyn,7,girl,0,7,2.0996178695477422e-5
julieta,7,girl,0,7,2.0996178695477422e-5
julietta,7,girl,0,7,2.0996178695477422e-5
julita,7,girl,0,7,2.0996178695477422e-5
jumana,7,girl,1,8,2.3995632794831342e-5
kadey,7,girl,0,7,2.0996178695477422e-5
kai,7,girl,2,9,2.699508689418526e-5
kaitlynn,7,girl,2,9,2.699508689418526e-5
kaiyah,7,girl,0,7,2.0996178695477422e-5
kaleesi,7,girl,0,7,2.0996178695477422e-5
kamiah,7,girl,0,7,2.0996178695477422e-5
kassandra,7,girl,0,7,2.0996178695477422e-5
kassidy,7,girl,6,13,3.899290329160093e-5
kataleya,7,girl,1,8,2.3995632794831342e-5
katalina,7,girl,0,7,2.0996178695477422e-5
katharine,7,girl,1,8,2.3995632794831342e-5
katia,7,girl,0,7,2.0996178695477422e-5
keevah,7,girl,1,8,2.3995632794831342e-5
keila,7,girl,0,7,2.0996178695477422e-5
kelis,7,girl,2,9,2.699508689418526e-5
khadiza,7,girl,0,7,2.0996178695477422e-5
kiarna,7,girl,0,7,2.0996178695477422e-5
kimaya,7,girl,0,7,2.0996178695477422e-5
kloe,7,girl,3,10,2.9994540993539176e-5
kotryna,7,girl,0,7,2.0996178695477422e-5
kritika,7,girl,1,8,2.3995632794831342e-5
kyah,7,girl,2,9,2.699508689418526e-5
labibah,7,girl,0,7,2.0996178695477422e-5
lacey-rae,7,girl,0,7,2.0996178695477422e-5
lacie-may,7,girl,0,7,2.0996178695477422e-5
lamisa,7,girl,0,7,2.0996178695477422e-5
lamisah,7,girl,0,7,2.0996178695477422e-5
latifa,7,girl,0,7,2.0996178695477422e-5
lauryn,7,girl,4,11,3.2993995092893096e-5
laycie,7,girl,1,8,2.3995632794831342e-5
layna,7,girl,0,7,2.0996178695477422e-5
lexi-grace,7,girl,0,7,2.0996178695477422e-5
lexi-leigh,7,girl,1,8,2.3995632794831342e-5
lexie-mae,7,girl,0,7,2.0996178695477422e-5
liarna,7,girl,0,7,2.0996178695477422e-5
liberty-rose,7,girl,0,7,2.0996178695477422e-5
lilibeth,7,girl,0,7,2.0996178695477422e-5
liliwen,7,girl,0,7,2.0996178695477422e-5
lillie-marie,7,girl,1,8,2.3995632794831342e-5
lilyana,7,girl,0,7,2.0996178695477422e-5
liora,7,girl,0,7,2.0996178695477422e-5
livvie,7,girl,0,7,2.0996178695477422e-5
loren,7,girl,0,7,2.0996178695477422e-5
lottie-may,7,girl,0,7,2.0996178695477422e-5
loula,7,girl,0,7,2.0996178695477422e-5
lourdes,7,girl,0,7,2.0996178695477422e-5
lua,7,girl,1,8,2.3995632794831342e-5
lucy-rose,7,girl,2,9,2.699508689418526e-5
lydia-rose,7,girl,0,7,2.0996178695477422e-5
lynn,7,girl,1,8,2.3995632794831342e-5
lyric,7,girl,0,7,2.0996178695477422e-5
macie-rose,7,girl,0,7,2.0996178695477422e-5
madi,7,girl,1,8,2.3995632794831342e-5
maeva,7,girl,0,7,2.0996178695477422e-5
maggie-rose,7,girl,0,7,2.0996178695477422e-5
mahek,7,girl,0,7,2.0996178695477422e-5
mahirah,7,girl,0,7,2.0996178695477422e-5
mahrosh,7,girl,0,7,2.0996178695477422e-5
mahveen,7,girl,0,7,2.0996178695477422e-5
mair,7,girl,0,7,2.0996178695477422e-5
maisie-grace,7,girl,0,7,2.0996178695477422e-5
maisie-mae,7,girl,0,7,2.0996178695477422e-5
maisie-may,7,girl,0,7,2.0996178695477422e-5
mansa,7,girl,0,7,2.0996178695477422e-5
manuella,7,girl,0,7,2.0996178695477422e-5
maple,7,girl,0,7,2.0996178695477422e-5
marci,7,girl,1,8,2.3995632794831342e-5
mared,7,girl,0,7,2.0996178695477422e-5
marion,7,girl,1,8,2.3995632794831342e-5
masie,7,girl,0,7,2.0996178695477422e-5
mayla,7,girl,0,7,2.0996178695477422e-5
meena,7,girl,2,9,2.699508689418526e-5
meira,7,girl,0,7,2.0996178695477422e-5
melani,7,girl,0,7,2.0996178695477422e-5
melodie,7,girl,1,8,2.3995632794831342e-5
mia-may,7,girl,0,7,2.0996178695477422e-5
miami,7,girl,0,7,2.0996178695477422e-5
micaela,7,girl,0,7,2.0996178695477422e-5
mila-mae,7,girl,0,7,2.0996178695477422e-5
millie-grace,7,girl,1,8,2.3995632794831342e-5
misty,7,girl,1,8,2.3995632794831342e-5
mollie-may,7,girl,0,7,2.0996178695477422e-5
molly-mae,7,girl,0,7,2.0996178695477422e-5
molly-may,7,girl,0,7,2.0996178695477422e-5
mumtaz,7,girl,0,7,2.0996178695477422e-5
muqadas,7,girl,0,7,2.0996178695477422e-5
muska,7,girl,0,7,2.0996178695477422e-5
myia,7,girl,0,7,2.0996178695477422e-5
nafeesa,7,girl,0,7,2.0996178695477422e-5
naisha,7,girl,0,7,2.0996178695477422e-5
naomie,7,girl,0,7,2.0996178695477422e-5
nayab,7,girl,0,7,2.0996178695477422e-5
naylaa,7,girl,1,8,2.3995632794831342e-5
nazifa,7,girl,0,7,2.0996178695477422e-5
neda,7,girl,0,7,2.0996178695477422e-5
neva,7,girl,2,9,2.699508689418526e-5
nevaeh-mai,7,girl,0,7,2.0996178695477422e-5
neya,7,girl,0,7,2.0996178695477422e-5
nicolle,7,girl,0,7,2.0996178695477422e-5
nisa,7,girl,2,9,2.699508689418526e-5
nisha,7,girl,0,7,2.0996178695477422e-5
noorah,7,girl,0,7,2.0996178695477422e-5
nusrat,7,girl,0,7,2.0996178695477422e-5
olivia-leigh,7,girl,0,7,2.0996178695477422e-5
olivija,7,girl,1,8,2.3995632794831342e-5
oluchi,7,girl,1,8,2.3995632794831342e-5
oluwatomisin,7,girl,0,7,2.0996178695477422e-5
orelia,7,girl,0,7,2.0996178695477422e-5
oviya,7,girl,0,7,2.0996178695477422e-5
paisley-rose,7,girl,0,7,2.0996178695477422e-5
pauline,7,girl,0,7,2.0996178695477422e-5
pebbles,7,girl,0,7,2.0996178695477422e-5
pennie,7,girl,2,9,2.699508689418526e-5
perla,7,girl,2,9,2.699508689418526e-5
persia,7,girl,0,7,2.0996178695477422e-5
phaedra,7,girl,1,8,2.3995632794831342e-5
phoebe-mae,7,girl,0,7,2.0996178695477422e-5
prabhleen,7,girl,0,7,2.0996178695477422e-5
raheema,7,girl,0,7,2.0996178695477422e-5
raihana,7,girl,0,7,2.0996178695477422e-5
raissa,7,girl,0,7,2.0996178695477422e-5
rajveer,7,girl,1,8,2.3995632794831342e-5
raphaelle,7,girl,0,7,2.0996178695477422e-5
rei,7,girl,0,7,2.0996178695477422e-5
renaya,7,girl,0,7,2.0996178695477422e-5
renesmay,7,girl,0,7,2.0996178695477422e-5
renezmae,7,girl,0,7,2.0996178695477422e-5
retal,7,girl,0,7,2.0996178695477422e-5
rhona,7,girl,4,11,3.2993995092893096e-5
rianna,7,girl,0,7,2.0996178695477422e-5
rinoa,7,girl,1,8,2.3995632794831342e-5
roaa,7,girl,0,7,2.0996178695477422e-5
romey,7,girl,1,8,2.3995632794831342e-5
roni,7,girl,2,9,2.699508689418526e-5
roop,7,girl,0,7,2.0996178695477422e-5
ruby-anne,7,girl,0,7,2.0996178695477422e-5
rugile,7,girl,0,7,2.0996178695477422e-5
sai,7,girl,0,7,2.0996178695477422e-5
saibah,7,girl,0,7,2.0996178695477422e-5
salomea,7,girl,0,7,2.0996178695477422e-5
samiyah,7,girl,0,7,2.0996178695477422e-5
santana,7,girl,0,7,2.0996178695477422e-5
saule,7,girl,0,7,2.0996178695477422e-5
savreen,7,girl,0,7,2.0996178695477422e-5
scarlet-rose,7,girl,0,7,2.0996178695477422e-5
selah,7,girl,0,7,2.0996178695477422e-5
shahad,7,girl,0,7,2.0996178695477422e-5
shana,7,girl,0,7,2.0996178695477422e-5
shanae,7,girl,0,7,2.0996178695477422e-5
shanelle,7,girl,0,7,2.0996178695477422e-5
sheza,7,girl,0,7,2.0996178695477422e-5
shi,7,girl,0,7,2.0996178695477422e-5
shiza,7,girl,0,7,2.0996178695477422e-5
shreeya,7,girl,1,8,2.3995632794831342e-5
shukri,7,girl,0,7,2.0996178695477422e-5
siara,7,girl,0,7,2.0996178695477422e-5
sidrah,7,girl,0,7,2.0996178695477422e-5
sienna-rae,7,girl,0,7,2.0996178695477422e-5
sila,7,girl,0,7,2.0996178695477422e-5
sirat,7,girl,0,7,2.0996178695477422e-5
skylar-rae,7,girl,0,7,2.0996178695477422e-5
somaya,7,girl,1,8,2.3995632794831342e-5
sonam,7,girl,2,9,2.699508689418526e-5
sophia-louise,7,girl,0,7,2.0996178695477422e-5
sophie-ann,7,girl,2,9,2.699508689418526e-5
stefanie,7,girl,0,7,2.0996178695477422e-5
suhani,7,girl,0,7,2.0996178695477422e-5
suhayla,7,girl,0,7,2.0996178695477422e-5
tahreem,7,girl,0,7,2.0996178695477422e-5
taleah,7,girl,0,7,2.0996178695477422e-5
taleen,7,girl,1,8,2.3995632794831342e-5
talia-rose,7,girl,2,9,2.699508689418526e-5
taqwa,7,girl,0,7,2.0996178695477422e-5
tasmiyah,7,girl,0,7,2.0996178695477422e-5
temitope,7,girl,0,7,2.0996178695477422e-5
thia,7,girl,0,7,2.0996178695477422e-5
tiggy,7,girl,0,7,2.0996178695477422e-5
tilli,7,girl,0,7,2.0996178695477422e-5
tillie-mae,7,girl,0,7,2.0996178695477422e-5
tilly-grace,7,girl,0,7,2.0996178695477422e-5
toni,7,girl,4,11,3.2993995092893096e-5
tula,7,girl,0,7,2.0996178695477422e-5
tulsi,7,girl,0,7,2.0996178695477422e-5
tyla,7,girl,0,7,2.0996178695477422e-5
uzma,7,girl,0,7,2.0996178695477422e-5
viha,7,girl,0,7,2.0996178695477422e-5
violeta,7,girl,0,7,2.0996178695477422e-5
violette,7,girl,1,8,2.3995632794831342e-5
virginia,7,girl,0,7,2.0996178695477422e-5
wareesha,7,girl,0,7,2.0996178695477422e-5
winona,7,girl,0,7,2.0996178695477422e-5
xin,7,girl,1,8,2.3995632794831342e-5
xyla,7,girl,0,7,2.0996178695477422e-5
yaran,7,girl,0,7,2.0996178695477422e-5
yohanna,7,girl,0,7,2.0996178695477422e-5
zana,7,girl,0,7,2.0996178695477422e-5
zariyah,7,girl,0,7,2.0996178695477422e-5
zipporah,7,girl,0,7,2.0996178695477422e-5
zirwa,7,girl,0,7,2.0996178695477422e-5
zulaykha,7,girl,0,7,2.0996178695477422e-5
aafia,6,girl,0,6,1.7996724596123505e-5
aaiza,6,girl,1,7,2.0996178695477422e-5
aaliyah-mae,6,girl,0,6,1.7996724596123505e-5
ada-rose,6,girl,0,6,1.7996724596123505e-5
adaora,6,girl,0,6,1.7996724596123505e-5
adhya,6,girl,0,6,1.7996724596123505e-5
adley,6,girl,2,8,2.3995632794831342e-5
aela,6,girl,9,15,4.4991811490308764e-5
aeris,6,girl,0,6,1.7996724596123505e-5
afizah,6,girl,0,6,1.7996724596123505e-5
aiko,6,girl,0,6,1.7996724596123505e-5
aissatou,6,girl,0,6,1.7996724596123505e-5
alana-mae,6,girl,0,6,1.7996724596123505e-5
albany,6,girl,0,6,1.7996724596123505e-5
alecia,6,girl,2,8,2.3995632794831342e-5
aleha,6,girl,0,6,1.7996724596123505e-5
alexys,6,girl,0,6,1.7996724596123505e-5
alijah,6,girl,1,7,2.0996178695477422e-5
aline,6,girl,0,6,1.7996724596123505e-5
alyaanah,6,girl,2,8,2.3995632794831342e-5
alyssa-rose,6,girl,0,6,1.7996724596123505e-5
amatullah,6,girl,0,6,1.7996724596123505e-5
amber-louise,6,girl,0,6,1.7996724596123505e-5
ambra,6,girl,1,7,2.0996178695477422e-5
ameenah,6,girl,0,6,1.7996724596123505e-5
amelia-lillie,6,girl,0,6,1.7996724596123505e-5
amelia-mai,6,girl,0,6,1.7996724596123505e-5
amelia-marie,6,girl,0,6,1.7996724596123505e-5
ameliah,6,girl,1,7,2.0996178695477422e-5
amera,6,girl,0,6,1.7996724596123505e-5
ami,6,girl,2,8,2.3995632794831342e-5
amilah,6,girl,0,6,1.7996724596123505e-5
amine,6,girl,0,6,1.7996724596123505e-5
amisha,6,girl,0,6,1.7996724596123505e-5
amyrah,6,girl,0,6,1.7996724596123505e-5
an,6,girl,0,6,1.7996724596123505e-5
anabell,6,girl,0,6,1.7996724596123505e-5
anaisha,6,girl,0,6,1.7996724596123505e-5
anamaria,6,girl,0,6,1.7996724596123505e-5
andreia,6,girl,0,6,1.7996724596123505e-5
aneya,6,girl,0,6,1.7996724596123505e-5
anh,6,girl,0,6,1.7996724596123505e-5
anila,6,girl,0,6,1.7996724596123505e-5
anissa,6,girl,1,7,2.0996178695477422e-5
anjolaoluwa,6,girl,0,6,1.7996724596123505e-5
annalee,6,girl,0,6,1.7996724596123505e-5
annette,6,girl,0,6,1.7996724596123505e-5
anusha,6,girl,0,6,1.7996724596123505e-5
anvi,6,girl,1,7,2.0996178695477422e-5
ari,6,girl,0,6,1.7996724596123505e-5
ariane,6,girl,1,7,2.0996178695477422e-5
arifa,6,girl,0,6,1.7996724596123505e-5
arrabella,6,girl,1,7,2.0996178695477422e-5
arwaa,6,girl,0,6,1.7996724596123505e-5
aryia,6,girl,4,10,2.9994540993539176e-5
asal,6,girl,0,6,1.7996724596123505e-5
asli,6,girl,0,6,1.7996724596123505e-5
atiya,6,girl,0,6,1.7996724596123505e-5
augusta,6,girl,0,6,1.7996724596123505e-5
aviella,6,girl,0,6,1.7996724596123505e-5
avreet,6,girl,1,7,2.0996178695477422e-5
ayanah,6,girl,0,6,1.7996724596123505e-5
aymen,6,girl,0,6,1.7996724596123505e-5
azura,6,girl,0,6,1.7996724596123505e-5
bailey-rae,6,girl,0,6,1.7996724596123505e-5
baneen,6,girl,1,7,2.0996178695477422e-5
basya,6,girl,0,6,1.7996724596123505e-5
belinay,6,girl,0,6,1.7996724596123505e-5
bella-mai,6,girl,0,6,1.7996724596123505e-5
bella-may,6,girl,0,6,1.7996724596123505e-5
bellatrix,6,girl,0,6,1.7996724596123505e-5
beryl,6,girl,0,6,1.7996724596123505e-5
binta,6,girl,0,6,1.7996724596123505e-5
boluwatife,6,girl,0,6,1.7996724596123505e-5
bracha,6,girl,0,6,1.7996724596123505e-5
breeze,6,girl,0,6,1.7996724596123505e-5
brenda,6,girl,0,6,1.7996724596123505e-5
bria,6,girl,1,7,2.0996178695477422e-5
brook,6,girl,1,7,2.0996178695477422e-5
caelyn,6,girl,2,8,2.3995632794831342e-5
callie-rae,6,girl,0,6,1.7996724596123505e-5
carmela,6,girl,1,7,2.0996178695477422e-5
ceira,6,girl,0,6,1.7996724596123505e-5
charlize,6,girl,0,6,1.7996724596123505e-5
chenai,6,girl,0,6,1.7996724596123505e-5
chloe-may,6,girl,0,6,1.7996724596123505e-5
cicely,6,girl,0,6,1.7996724596123505e-5
colbie,6,girl,0,6,1.7996724596123505e-5
collette,6,girl,0,6,1.7996724596123505e-5
corinne,6,girl,1,7,2.0996178695477422e-5
d'arcy,6,girl,1,7,2.0996178695477422e-5
daisy-louise,6,girl,0,6,1.7996724596123505e-5
dalal,6,girl,0,6,1.7996724596123505e-5
dallas,6,girl,0,6,1.7996724596123505e-5
danya,6,girl,0,6,1.7996724596123505e-5
darcie-lea,6,girl,0,6,1.7996724596123505e-5
darcy-leigh,6,girl,1,7,2.0996178695477422e-5
darcy-rae,6,girl,0,6,1.7996724596123505e-5
darija,6,girl,0,6,1.7996724596123505e-5
dariya,6,girl,0,6,1.7996724596123505e-5
debbie,6,girl,0,6,1.7996724596123505e-5
deem,6,girl,1,7,2.0996178695477422e-5
deena,6,girl,0,6,1.7996724596123505e-5
delila,6,girl,0,6,1.7996724596123505e-5
delta,6,girl,0,6,1.7996724596123505e-5
demi-rae,6,girl,0,6,1.7996724596123505e-5
dhriti,6,girl,0,6,1.7996724596123505e-5
dhyani,6,girl,0,6,1.7996724596123505e-5
diane,6,girl,1,7,2.0996178695477422e-5
dinah,6,girl,0,6,1.7996724596123505e-5
diyanah,6,girl,0,6,1.7996724596123505e-5
dolly-mae,6,girl,0,6,1.7996724596123505e-5
dominyka,6,girl,0,6,1.7996724596123505e-5
eboni,6,girl,3,9,2.699508689418526e-5
echo,6,girl,0,6,1.7996724596123505e-5
ecrin,6,girl,0,6,1.7996724596123505e-5
edie-mae,6,girl,0,6,1.7996724596123505e-5
eiman,6,girl,0,6,1.7996724596123505e-5
elanur,6,girl,0,6,1.7996724596123505e-5
eleana,6,girl,0,6,1.7996724596123505e-5
eleena,6,girl,1,7,2.0996178695477422e-5
elexis,6,girl,0,6,1.7996724596123505e-5
elham,6,girl,0,6,1.7996724596123505e-5
eli,6,girl,0,6,1.7996724596123505e-5
eliona,6,girl,1,7,2.0996178695477422e-5
elisse,6,girl,0,6,1.7996724596123505e-5
eliyanah,6,girl,0,6,1.7996724596123505e-5
elizaveta,6,girl,1,7,2.0996178695477422e-5
elize,6,girl,1,7,2.0996178695477422e-5
ella-jane,6,girl,2,8,2.3995632794831342e-5
ellamae,6,girl,2,8,2.3995632794831342e-5
elleanor,6,girl,0,6,1.7996724596123505e-5
ellenor,6,girl,0,6,1.7996724596123505e-5
elliott,6,girl,1,7,2.0996178695477422e-5
ellisia,6,girl,0,6,1.7996724596123505e-5
elloise,6,girl,0,6,1.7996724596123505e-5
ellsie,6,girl,0,6,1.7996724596123505e-5
elma,6,girl,1,7,2.0996178695477422e-5
elsie-grace,6,girl,0,6,1.7996724596123505e-5
elsie-lou,6,girl,0,6,1.7996724596123505e-5
emmanuela,6,girl,0,6,1.7996724596123505e-5
emmanuelle,6,girl,0,6,1.7996724596123505e-5
emmylou,6,girl,0,6,1.7996724596123505e-5
emy,6,girl,1,7,2.0996178695477422e-5
enija,6,girl,0,6,1.7996724596123505e-5
erynn,6,girl,0,6,1.7996724596123505e-5
estela,6,girl,1,7,2.0996178695477422e-5
eva-leigh,6,girl,1,7,2.0996178695477422e-5
eva-louise,6,girl,0,6,1.7996724596123505e-5
evalina,6,girl,0,6,1.7996724596123505e-5
evanna,6,girl,0,6,1.7996724596123505e-5
everlie,6,girl,0,6,1.7996724596123505e-5
evita,6,girl,0,6,1.7996724596123505e-5
ezinne,6,girl,0,6,1.7996724596123505e-5
ezzah,6,girl,0,6,1.7996724596123505e-5
faigy,6,girl,0,6,1.7996724596123505e-5
faiha,6,girl,0,6,1.7996724596123505e-5
farren,6,girl,0,6,1.7996724596123505e-5
fatemah,6,girl,0,6,1.7996724596123505e-5
fathia,6,girl,0,6,1.7996724596123505e-5
fausta,6,girl,0,6,1.7996724596123505e-5
fizzah,6,girl,0,6,1.7996724596123505e-5
freya-grace,6,girl,1,7,2.0996178695477422e-5
gala,6,girl,1,7,2.0996178695477422e-5
giana,6,girl,1,7,2.0996178695477422e-5
gioia,6,girl,0,6,1.7996724596123505e-5
gracey,6,girl,2,8,2.3995632794831342e-5
gracie-jane,6,girl,0,6,1.7996724596123505e-5
gracie-marie,6,girl,0,6,1.7996724596123505e-5
gurneet,6,girl,0,6,1.7996724596123505e-5
gwendolen,6,girl,0,6,1.7996724596123505e-5
haania,6,girl,0,6,1.7996724596123505e-5
habeeba,6,girl,0,6,1.7996724596123505e-5
hadassa,6,girl,0,6,1.7996724596123505e-5
hafiza,6,girl,0,6,1.7996724596123505e-5
haifa,6,girl,0,6,1.7996724596123505e-5
hajira,6,girl,0,6,1.7996724596123505e-5
halina,6,girl,0,6,1.7996724596123505e-5
hanah,6,girl,0,6,1.7996724596123505e-5
hanifah,6,girl,0,6,1.7996724596123505e-5
harini,6,girl,1,7,2.0996178695477422e-5
hasti,6,girl,0,6,1.7996724596123505e-5
henley,6,girl,1,7,2.0996178695477422e-5
heti,6,girl,0,6,1.7996724596123505e-5
hilda,6,girl,0,6,1.7996724596123505e-5
hiranur,6,girl,0,6,1.7996724596123505e-5
hollie-mai,6,girl,0,6,1.7996724596123505e-5
humera,6,girl,0,6,1.7996724596123505e-5
husnaa,6,girl,0,6,1.7996724596123505e-5
ifra,6,girl,0,6,1.7996724596123505e-5
iliya,6,girl,0,6,1.7996724596123505e-5
illiana,6,girl,0,6,1.7996724596123505e-5
imaya,6,girl,0,6,1.7996724596123505e-5
insha,6,girl,0,6,1.7996724596123505e-5
ione,6,girl,0,6,1.7996724596123505e-5
ireoluwa,6,girl,1,7,2.0996178695477422e-5
irhaa,6,girl,1,7,2.0996178695477422e-5
irsa,6,girl,0,6,1.7996724596123505e-5
isabelle-rose,6,girl,0,6,1.7996724596123505e-5
ishaani,6,girl,0,6,1.7996724596123505e-5
ivy-marie,6,girl,0,6,1.7996724596123505e-5
jahzara,6,girl,0,6,1.7996724596123505e-5
jaime-leigh,6,girl,0,6,1.7996724596123505e-5
jaina,6,girl,1,7,2.0996178695477422e-5
janina,6,girl,0,6,1.7996724596123505e-5
jasmine-rose,6,girl,0,6,1.7996724596123505e-5
jessica-mae,6,girl,1,7,2.0996178695477422e-5
jhene,6,girl,0,6,1.7996724596123505e-5
joey,6,girl,0,6,1.7996724596123505e-5
joscelyn,6,girl,0,6,1.7996724596123505e-5
josephina,6,girl,0,6,1.7996724596123505e-5
jumanah,6,girl,0,6,1.7996724596123505e-5
jupiter,6,girl,1,7,2.0996178695477422e-5
justina,6,girl,1,7,2.0996178695477422e-5
justyna,6,girl,0,6,1.7996724596123505e-5
juwayriyah,6,girl,0,6,1.7996724596123505e-5
kadence,6,girl,1,7,2.0996178695477422e-5
kalise,6,girl,0,6,1.7996724596123505e-5
kareema,6,girl,0,6,1.7996724596123505e-5
karima,6,girl,0,6,1.7996724596123505e-5
kasia,6,girl,0,6,1.7996724596123505e-5
kathy,6,girl,0,6,1.7996724596123505e-5
katie-may,6,girl,0,6,1.7996724596123505e-5
kayal,6,girl,0,6,1.7996724596123505e-5
kaydence,6,girl,0,6,1.7996724596123505e-5
kaytlin,6,girl,0,6,1.7996724596123505e-5
kazi,6,girl,0,6,1.7996724596123505e-5
kehinde,6,girl,0,6,1.7996724596123505e-5
kelsea,6,girl,0,6,1.7996724596123505e-5
kenna,6,girl,3,9,2.699508689418526e-5
kensa,6,girl,0,6,1.7996724596123505e-5
keren,6,girl,0,6,1.7996724596123505e-5
kerensa,6,girl,0,6,1.7996724596123505e-5
kerry,6,girl,5,11,3.2993995092893096e-5
keya,6,girl,0,6,1.7996724596123505e-5
kiah,6,girl,0,6,1.7996724596123505e-5
kim,6,girl,0,6,1.7996724596123505e-5
kizzy,6,girl,0,6,1.7996724596123505e-5
konnie,6,girl,1,7,2.0996178695477422e-5
konstantina,6,girl,0,6,1.7996724596123505e-5
kora,6,girl,0,6,1.7996724596123505e-5
krishna,6,girl,0,6,1.7996724596123505e-5
kristiana,6,girl,0,6,1.7996724596123505e-5
ksenija,6,girl,0,6,1.7996724596123505e-5
kushi,6,girl,0,6,1.7996724596123505e-5
lacey-ann,6,girl,1,7,2.0996178695477422e-5
lady,6,girl,0,6,1.7996724596123505e-5
lael,6,girl,1,7,2.0996178695477422e-5
laina,6,girl,1,7,2.0996178695477422e-5
lamia,6,girl,2,8,2.3995632794831342e-5
lamis,6,girl,0,6,1.7996724596123505e-5
lamya,6,girl,0,6,1.7996724596123505e-5
larin,6,girl,0,6,1.7996724596123505e-5
latoya,6,girl,0,6,1.7996724596123505e-5
lavanya,6,girl,0,6,1.7996724596123505e-5
layal,6,girl,0,6,1.7996724596123505e-5
layla-jade,6,girl,1,7,2.0996178695477422e-5
leah-may,6,girl,0,6,1.7996724596123505e-5
leighla,6,girl,0,6,1.7996724596123505e-5
leoni,6,girl,0,6,1.7996724596123505e-5
lexi-ann,6,girl,0,6,1.7996724596123505e-5
lexie-mai,6,girl,0,6,1.7996724596123505e-5
lilija,6,girl,0,6,1.7996724596123505e-5
liliya,6,girl,0,6,1.7996724596123505e-5
lilja,6,girl,1,7,2.0996178695477422e-5
lillyann,6,girl,0,6,1.7996724596123505e-5
lillyrose,6,girl,0,6,1.7996724596123505e-5
lily-jane,6,girl,2,8,2.3995632794831342e-5
lily-marie,6,girl,0,6,1.7996724596123505e-5
lilya,6,girl,0,6,1.7996724596123505e-5
livy,6,girl,0,6,1.7996724596123505e-5
lolah,6,girl,0,6,1.7996724596123505e-5
lottie-lou,6,girl,0,6,1.7996724596123505e-5
louella,6,girl,0,6,1.7996724596123505e-5
luca,6,girl,0,6,1.7996724596123505e-5
lucianna,6,girl,1,7,2.0996178695477422e-5
lulah,6,girl,0,6,1.7996724596123505e-5
maab,6,girl,0,6,1.7996724596123505e-5
maaya,6,girl,0,6,1.7996724596123505e-5
macie-mae,6,girl,0,6,1.7996724596123505e-5
madalena,6,girl,1,7,2.0996178695477422e-5
madalina,6,girl,0,6,1.7996724596123505e-5
madalyn,6,girl,0,6,1.7996724596123505e-5
maddy,6,girl,1,7,2.0996178695477422e-5
magdalene,6,girl,1,7,2.0996178695477422e-5
maggie-mae,6,girl,0,6,1.7996724596123505e-5
maggie-mai,6,girl,0,6,1.7996724596123505e-5
mahima,6,girl,0,6,1.7996724596123505e-5
maimoona,6,girl,0,6,1.7996724596123505e-5
mairah,6,girl,0,6,1.7996724596123505e-5
maizah,6,girl,0,6,1.7996724596123505e-5
malaak,6,girl,0,6,1.7996724596123505e-5
malgorzata,6,girl,0,6,1.7996724596123505e-5
mana,6,girl,0,6,1.7996724596123505e-5
mantasha,6,girl,0,6,1.7996724596123505e-5
marian,6,girl,0,6,1.7996724596123505e-5
marija,6,girl,1,7,2.0996178695477422e-5
marleigh,6,girl,2,8,2.3995632794831342e-5
marlene,6,girl,0,6,1.7996724596123505e-5
marlo,6,girl,0,6,1.7996724596123505e-5
marlow,6,girl,3,9,2.699508689418526e-5
marly,6,girl,0,6,1.7996724596123505e-5
marnee,6,girl,0,6,1.7996724596123505e-5
mary-lou,6,girl,0,6,1.7996724596123505e-5
marya,6,girl,0,6,1.7996724596123505e-5
maryan,6,girl,0,6,1.7996724596123505e-5
maryann,6,girl,0,6,1.7996724596123505e-5
maud,6,girl,0,6,1.7996724596123505e-5
mawaddah,6,girl,0,6,1.7996724596123505e-5
mayeda,6,girl,1,7,2.0996178695477422e-5
mayumi,6,girl,0,6,1.7996724596123505e-5
mckenna,6,girl,1,7,2.0996178695477422e-5
medeea,6,girl,0,6,1.7996724596123505e-5
medi,6,girl,0,6,1.7996724596123505e-5
meela,6,girl,0,6,1.7996724596123505e-5
mehek,6,girl,0,6,1.7996724596123505e-5
meral,6,girl,0,6,1.7996724596123505e-5
meriam,6,girl,0,6,1.7996724596123505e-5
mihaela,6,girl,1,7,2.0996178695477422e-5
mindy,6,girl,0,6,1.7996724596123505e-5
mirella,6,girl,0,6,1.7996724596123505e-5
mishka,6,girl,1,7,2.0996178695477422e-5
misk,6,girl,0,6,1.7996724596123505e-5
moli,6,girl,0,6,1.7996724596123505e-5
morgana,6,girl,0,6,1.7996724596123505e-5
myah-rose,6,girl,0,6,1.7996724596123505e-5
myka,6,girl,2,8,2.3995632794831342e-5
myla-rae,6,girl,0,6,1.7996724596123505e-5
nameera,6,girl,0,6,1.7996724596123505e-5
nargis,6,girl,0,6,1.7996724596123505e-5
nariah,6,girl,0,6,1.7996724596123505e-5
nariyah,6,girl,0,6,1.7996724596123505e-5
natasza,6,girl,2,8,2.3995632794831342e-5
navleen,6,girl,0,6,1.7996724596123505e-5
navreet,6,girl,0,6,1.7996724596123505e-5
nawaal,6,girl,0,6,1.7996724596123505e-5
nayaab,6,girl,0,6,1.7996724596123505e-5
naylah,6,girl,0,6,1.7996724596123505e-5
nazia,6,girl,0,6,1.7996724596123505e-5
neela,6,girl,0,6,1.7996724596123505e-5
nehir,6,girl,1,7,2.0996178695477422e-5
nellie-mae,6,girl,0,6,1.7996724596123505e-5
nerys,6,girl,0,6,1.7996724596123505e-5
nevada,6,girl,1,7,2.0996178695477422e-5
nevaeh-leigh,6,girl,0,6,1.7996724596123505e-5
nevaeh-mae,6,girl,0,6,1.7996724596123505e-5
nidhi,6,girl,0,6,1.7996724596123505e-5
niki,6,girl,0,6,1.7996724596123505e-5
nikoleta,6,girl,0,6,1.7996724596123505e-5
nitya,6,girl,0,6,1.7996724596123505e-5
noor-ul-ain,6,girl,0,6,1.7996724596123505e-5
nuria,6,girl,1,7,2.0996178695477422e-5
nyla-rae,6,girl,0,6,1.7996724596123505e-5
nysha,6,girl,0,6,1.7996724596123505e-5
olena,6,girl,0,6,1.7996724596123505e-5
oluwadamilola,6,girl,0,6,1.7996724596123505e-5
oluwademilade,6,girl,1,7,2.0996178695477422e-5
oluwakemi,6,girl,0,6,1.7996724596123505e-5
olwyn,6,girl,0,6,1.7996724596123505e-5
orianna,6,girl,1,7,2.0996178695477422e-5
ornella,6,girl,0,6,1.7996724596123505e-5
otilia,6,girl,0,6,1.7996724596123505e-5
ottoline,6,girl,0,6,1.7996724596123505e-5
paityn,6,girl,3,9,2.699508689418526e-5
peony,6,girl,0,6,1.7996724596123505e-5
pippa-rose,6,girl,0,6,1.7996724596123505e-5
piya,6,girl,0,6,1.7996724596123505e-5
poppy-grace,6,girl,0,6,1.7996724596123505e-5
preet,6,girl,0,6,1.7996724596123505e-5
priyanka,6,girl,0,6,1.7996724596123505e-5
raeesah,6,girl,0,6,1.7996724596123505e-5
raha,6,girl,0,6,1.7996724596123505e-5
rayanne,6,girl,0,6,1.7996724596123505e-5
reanna,6,girl,0,6,1.7996724596123505e-5
reisy,6,girl,0,6,1.7996724596123505e-5
renad,6,girl,0,6,1.7996724596123505e-5
renayah,6,girl,0,6,1.7996724596123505e-5
reyhana,6,girl,0,6,1.7996724596123505e-5
reyna,6,girl,0,6,1.7996724596123505e-5
rhaya,6,girl,2,8,2.3995632794831342e-5
risha,6,girl,0,6,1.7996724596123505e-5
riven,6,girl,0,6,1.7996724596123505e-5
river-mae,6,girl,0,6,1.7996724596123505e-5
river-rose,6,girl,0,6,1.7996724596123505e-5
romola,6,girl,0,6,1.7996724596123505e-5
rosabelle,6,girl,0,6,1.7996724596123505e-5
rosamund,6,girl,2,8,2.3995632794831342e-5
ruby-louise,6,girl,0,6,1.7996724596123505e-5
rudi,6,girl,0,6,1.7996724596123505e-5
ruhani,6,girl,0,6,1.7996724596123505e-5
rut,6,girl,1,7,2.0996178695477422e-5
ruvarashe,6,girl,0,6,1.7996724596123505e-5
sabine,6,girl,1,7,2.0996178695477422e-5
sade,6,girl,0,6,1.7996724596123505e-5
sadiya,6,girl,0,6,1.7996724596123505e-5
safeeya,6,girl,0,6,1.7996724596123505e-5
saffie,6,girl,1,7,2.0996178695477422e-5
safina,6,girl,0,6,1.7996724596123505e-5
safiye,6,girl,0,6,1.7996724596123505e-5
safoora,6,girl,0,6,1.7996724596123505e-5
safura,6,girl,0,6,1.7996724596123505e-5
saisha,6,girl,0,6,1.7996724596123505e-5
saja,6,girl,2,8,2.3995632794831342e-5
sakeena,6,girl,0,6,1.7996724596123505e-5
samreet,6,girl,0,6,1.7996724596123505e-5
sandy,6,girl,0,6,1.7996724596123505e-5
sanvi,6,girl,1,7,2.0996178695477422e-5
sapphira,6,girl,0,6,1.7996724596123505e-5
sareena,6,girl,0,6,1.7996724596123505e-5
sariah,6,girl,2,8,2.3995632794831342e-5
saylor,6,girl,1,7,2.0996178695477422e-5
sefora,6,girl,1,7,2.0996178695477422e-5
sehar,6,girl,2,8,2.3995632794831342e-5
sehej,6,girl,0,6,1.7996724596123505e-5
sennen,6,girl,0,6,1.7996724596123505e-5
sequoia,6,girl,0,6,1.7996724596123505e-5
sereena,6,girl,0,6,1.7996724596123505e-5
serina,6,girl,0,6,1.7996724596123505e-5
shah,6,girl,0,6,1.7996724596123505e-5
shahd,6,girl,0,6,1.7996724596123505e-5
shaima,6,girl,0,6,1.7996724596123505e-5
shams,6,girl,0,6,1.7996724596123505e-5
shanti,6,girl,0,6,1.7996724596123505e-5
shanya,6,girl,0,6,1.7996724596123505e-5
shayma,6,girl,0,6,1.7996724596123505e-5
shayna,6,girl,0,6,1.7996724596123505e-5
shazia,6,girl,0,6,1.7996724596123505e-5
shea,6,girl,0,6,1.7996724596123505e-5
sheva,6,girl,0,6,1.7996724596123505e-5
shifra,6,girl,0,6,1.7996724596123505e-5
sidratul,6,girl,0,6,1.7996724596123505e-5
siham,6,girl,0,6,1.7996724596123505e-5
simay,6,girl,0,6,1.7996724596123505e-5
sireen,6,girl,0,6,1.7996724596123505e-5
sitara,6,girl,0,6,1.7996724596123505e-5
sofi,6,girl,0,6,1.7996724596123505e-5
sonja,6,girl,1,7,2.0996178695477422e-5
sophia-marie,6,girl,1,7,2.0996178695477422e-5
sophia-may,6,girl,0,6,1.7996724596123505e-5
sorcha,6,girl,4,10,2.9994540993539176e-5
spencer,6,girl,1,7,2.0996178695477422e-5
su,6,girl,0,6,1.7996724596123505e-5
sukaina,6,girl,0,6,1.7996724596123505e-5
summer-leigh,6,girl,0,6,1.7996724596123505e-5
suzy,6,girl,1,7,2.0996178695477422e-5
taibah,6,girl,0,6,1.7996724596123505e-5
tammy,6,girl,4,10,2.9994540993539176e-5
tanishi,6,girl,0,6,1.7996724596123505e-5
tayyiba,6,girl,0,6,1.7996724596123505e-5
tazmeen,6,girl,0,6,1.7996724596123505e-5
teddi,6,girl,0,6,1.7996724596123505e-5
tesni,6,girl,0,6,1.7996724596123505e-5
tessie,6,girl,1,7,2.0996178695477422e-5
texas,6,girl,0,6,1.7996724596123505e-5
teya,6,girl,0,6,1.7996724596123505e-5
tia-louise,6,girl,0,6,1.7996724596123505e-5
tiaraoluwa,6,girl,0,6,1.7996724596123505e-5
tiegan,6,girl,2,8,2.3995632794831342e-5
tracey,6,girl,0,6,1.7996724596123505e-5
tulip,6,girl,0,6,1.7996724596123505e-5
tyanna,6,girl,0,6,1.7996724596123505e-5
urszula,6,girl,0,6,1.7996724596123505e-5
uswa,6,girl,1,7,2.0996178695477422e-5
vedika,6,girl,0,6,1.7996724596123505e-5
vega,6,girl,1,7,2.0996178695477422e-5
violetta,6,girl,0,6,1.7996724596123505e-5
vrinda,6,girl,0,6,1.7996724596123505e-5
willow-mae,6,girl,0,6,1.7996724596123505e-5
xaria,6,girl,0,6,1.7996724596123505e-5
xi,6,girl,2,8,2.3995632794831342e-5
yagmur,6,girl,0,6,1.7996724596123505e-5
yashika,6,girl,0,6,1.7996724596123505e-5
yitty,6,girl,0,6,1.7996724596123505e-5
yosra,6,girl,0,6,1.7996724596123505e-5
yuki,6,girl,0,6,1.7996724596123505e-5
yusairah,6,girl,0,6,1.7996724596123505e-5
yvaine,6,girl,0,6,1.7996724596123505e-5
zafreen,6,girl,0,6,1.7996724596123505e-5
zain,6,girl,0,6,1.7996724596123505e-5
zakiyyah,6,girl,0,6,1.7996724596123505e-5
zayneb,6,girl,0,6,1.7996724596123505e-5
zeenia,6,girl,0,6,1.7996724596123505e-5
zeina,6,girl,0,6,1.7996724596123505e-5
zerina,6,girl,0,6,1.7996724596123505e-5
zeva,6,girl,0,6,1.7996724596123505e-5
zilan,6,girl,0,6,1.7996724596123505e-5
zita,6,girl,0,6,1.7996724596123505e-5
aaizah,5,girl,0,5,1.4997270496769588e-5
aara,5,girl,1,6,1.7996724596123505e-5
aariana,5,girl,0,5,1.4997270496769588e-5
aashna,5,girl,0,5,1.4997270496769588e-5
abidah,5,girl,0,5,1.4997270496769588e-5
abigael,5,girl,0,5,1.4997270496769588e-5
abigaile,5,girl,1,6,1.7996724596123505e-5
adara,5,girl,1,6,1.7996724596123505e-5
addie,5,girl,0,5,1.4997270496769588e-5
aden,5,girl,0,5,1.4997270496769588e-5
adhira,5,girl,0,5,1.4997270496769588e-5
adiva,5,girl,0,5,1.4997270496769588e-5
adrina,5,girl,0,5,1.4997270496769588e-5
aemilia,5,girl,0,5,1.4997270496769588e-5
ahaana,5,girl,0,5,1.4997270496769588e-5
ahdia,5,girl,0,5,1.4997270496769588e-5
aibhlinn,5,girl,0,5,1.4997270496769588e-5
aiesha,5,girl,1,6,1.7996724596123505e-5
ailbhe,5,girl,2,7,2.0996178695477422e-5
aina,5,girl,1,6,1.7996724596123505e-5
aishleen,5,girl,0,5,1.4997270496769588e-5
aishwarya,5,girl,0,5,1.4997270496769588e-5
aiyah,5,girl,0,5,1.4997270496769588e-5
aiyanna,5,girl,0,5,1.4997270496769588e-5
akshaya,5,girl,0,5,1.4997270496769588e-5
alabama,5,girl,0,5,1.4997270496769588e-5
alaynah,5,girl,0,5,1.4997270496769588e-5
alexis-mae,5,girl,0,5,1.4997270496769588e-5
aliah,5,girl,0,5,1.4997270496769588e-5
alianna,5,girl,1,6,1.7996724596123505e-5
alice-mae,5,girl,1,6,1.7996724596123505e-5
alimah,5,girl,0,5,1.4997270496769588e-5
alisha-rose,5,girl,0,5,1.4997270496769588e-5
aliz,5,girl,0,5,1.4997270496769588e-5
alzbeta,5,girl,0,5,1.4997270496769588e-5
amaarah,5,girl,0,5,1.4997270496769588e-5
amairah,5,girl,0,5,1.4997270496769588e-5
amala,5,girl,0,5,1.4997270496769588e-5
amalee,5,girl,0,5,1.4997270496769588e-5
amarachukwu,5,girl,0,5,1.4997270496769588e-5
amarissa,5,girl,0,5,1.4997270496769588e-5
amarlia,5,girl,0,5,1.4997270496769588e-5
amaryllis,5,girl,0,5,1.4997270496769588e-5
ambar,5,girl,0,5,1.4997270496769588e-5
amber-lily,5,girl,1,6,1.7996724596123505e-5
ameilia,5,girl,0,5,1.4997270496769588e-5
amela,5,girl,0,5,1.4997270496769588e-5
amelia-leigh,5,girl,1,6,1.7996724596123505e-5
amiera,5,girl,1,6,1.7996724596123505e-5
amiira,5,girl,0,5,1.4997270496769588e-5
amiyah-rose,5,girl,0,5,1.4997270496769588e-5
amnah,5,girl,1,6,1.7996724596123505e-5
amy-lee,5,girl,1,6,1.7996724596123505e-5
anae,5,girl,0,5,1.4997270496769588e-5
anahita,5,girl,0,5,1.4997270496769588e-5
anaia,5,girl,0,5,1.4997270496769588e-5
aneesah,5,girl,0,5,1.4997270496769588e-5
anelia,5,girl,0,5,1.4997270496769588e-5
anest,5,girl,0,5,1.4997270496769588e-5
anna-leigh,5,girl,0,5,1.4997270496769588e-5
annabella-rose,5,girl,0,5,1.4997270496769588e-5
annabelle-rose,5,girl,0,5,1.4997270496769588e-5
annah,5,girl,0,5,1.4997270496769588e-5
annalia,5,girl,0,5,1.4997270496769588e-5
anneka,5,girl,0,5,1.4997270496769588e-5
antoinette,5,girl,0,5,1.4997270496769588e-5
anuoluwapo,5,girl,0,5,1.4997270496769588e-5
aphra,5,girl,0,5,1.4997270496769588e-5
apphia,5,girl,0,5,1.4997270496769588e-5
araiya,5,girl,0,5,1.4997270496769588e-5
arden,5,girl,3,8,2.3995632794831342e-5
ariam,5,girl,0,5,1.4997270496769588e-5
arietta,5,girl,0,5,1.4997270496769588e-5
arisa,5,girl,0,5,1.4997270496769588e-5
arizona,5,girl,0,5,1.4997270496769588e-5
arlo,5,girl,0,5,1.4997270496769588e-5
arshi,5,girl,0,5,1.4997270496769588e-5
arshiya,5,girl,0,5,1.4997270496769588e-5
aruna,5,girl,1,6,1.7996724596123505e-5
aseda,5,girl,0,5,1.4997270496769588e-5
asfiya,5,girl,0,5,1.4997270496769588e-5
athena-rose,5,girl,0,5,1.4997270496769588e-5
athira,5,girl,0,5,1.4997270496769588e-5
auriella,5,girl,1,6,1.7996724596123505e-5
avaleigh,5,girl,0,5,1.4997270496769588e-5
avantika,5,girl,0,5,1.4997270496769588e-5
aveya,5,girl,0,5,1.4997270496769588e-5
avigail,5,girl,0,5,1.4997270496769588e-5
aviya,5,girl,0,5,1.4997270496769588e-5
ayla-grace,5,girl,0,5,1.4997270496769588e-5
aysia,5,girl,0,5,1.4997270496769588e-5
ayva-mae,5,girl,0,5,1.4997270496769588e-5
azeen,5,girl,0,5,1.4997270496769588e-5
azmina,5,girl,0,5,1.4997270496769588e-5
azzurra,5,girl,0,5,1.4997270496769588e-5
bali,5,girl,0,5,1.4997270496769588e-5
banu,5,girl,0,5,1.4997270496769588e-5
bayley,5,girl,0,5,1.4997270496769588e-5
bella-marie,5,girl,0,5,1.4997270496769588e-5
berfin,5,girl,0,5,1.4997270496769588e-5
beti,5,girl,0,5,1.4997270496769588e-5
betsey,5,girl,0,5,1.4997270496769588e-5
betsy-may,5,girl,0,5,1.4997270496769588e-5
bibiana,5,girl,0,5,1.4997270496769588e-5
bismah,5,girl,1,6,1.7996724596123505e-5
blaire,5,girl,6,11,3.2993995092893096e-5
blousey,5,girl,0,5,1.4997270496769588e-5
boe,5,girl,0,5,1.4997270496769588e-5
bonnie-may,5,girl,0,5,1.4997270496769588e-5
boux,5,girl,0,5,1.4997270496769588e-5
bridgette,5,girl,0,5,1.4997270496769588e-5
cadie,5,girl,0,5,1.4997270496769588e-5
cailin,5,girl,0,5,1.4997270496769588e-5
carey,5,girl,0,5,1.4997270496769588e-5
carley,5,girl,4,9,2.699508689418526e-5
carol,5,girl,1,6,1.7996724596123505e-5
carter,5,girl,1,6,1.7996724596123505e-5
catalaya,5,girl,0,5,1.4997270496769588e-5
cate,5,girl,1,6,1.7996724596123505e-5
cezara,5,girl,0,5,1.4997270496769588e-5
chantal,5,girl,0,5,1.4997270496769588e-5
charmaine,5,girl,0,5,1.4997270496769588e-5
chelsey,5,girl,2,7,2.0996178695477422e-5
chelsie,5,girl,1,6,1.7996724596123505e-5
chizaram,5,girl,1,6,1.7996724596123505e-5
chloe-ann,5,girl,0,5,1.4997270496769588e-5
chloe-mae,5,girl,0,5,1.4997270496769588e-5
chloe-rose,5,girl,1,6,1.7996724596123505e-5
cleo-rose,5,girl,0,5,1.4997270496769588e-5
corah,5,girl,0,5,1.4997270496769588e-5
daiana,5,girl,0,5,1.4997270496769588e-5
dali,5,girl,0,5,1.4997270496769588e-5
dani,5,girl,2,7,2.0996178695477422e-5
danniella,5,girl,0,5,1.4997270496769588e-5
darcey-leigh,5,girl,0,5,1.4997270496769588e-5
darcey-mae,5,girl,0,5,1.4997270496769588e-5
darci-mae,5,girl,0,5,1.4997270496769588e-5
darcia,5,girl,1,6,1.7996724596123505e-5
darcy-may,5,girl,0,5,1.4997270496769588e-5
darlene,5,girl,0,5,1.4997270496769588e-5
dawn,5,girl,1,6,1.7996724596123505e-5
deeya,5,girl,0,5,1.4997270496769588e-5
delphie,5,girl,0,5,1.4997270496769588e-5
demi-lee,5,girl,2,7,2.0996178695477422e-5
demi-louise,5,girl,0,5,1.4997270496769588e-5
demi-mae,5,girl,0,5,1.4997270496769588e-5
dena,5,girl,1,6,1.7996724596123505e-5
denver,5,girl,1,6,1.7996724596123505e-5
deryn,5,girl,0,5,1.4997270496769588e-5
destina,5,girl,0,5,1.4997270496769588e-5
devanshi,5,girl,0,5,1.4997270496769588e-5
dhruvi,5,girl,0,5,1.4997270496769588e-5
dhwani,5,girl,0,5,1.4997270496769588e-5
dilly,5,girl,0,5,1.4997270496769588e-5
diona,5,girl,0,5,1.4997270496769588e-5
eabha,5,girl,2,7,2.0996178695477422e-5
ebony-mae,5,girl,0,5,1.4997270496769588e-5
eddie,5,girl,0,5,1.4997270496769588e-5
edie-may,5,girl,0,5,1.4997270496769588e-5
edlyn,5,girl,0,5,1.4997270496769588e-5
effi,5,girl,0,5,1.4997270496769588e-5
eimaan,5,girl,0,5,1.4997270496769588e-5
eirian,5,girl,0,5,1.4997270496769588e-5
eirini,5,girl,0,5,1.4997270496769588e-5
ekam,5,girl,0,5,1.4997270496769588e-5
elaya,5,girl,0,5,1.4997270496769588e-5
elenor,5,girl,0,5,1.4997270496769588e-5
elfie,5,girl,0,5,1.4997270496769588e-5
elim,5,girl,0,5,1.4997270496769588e-5
elisabetta,5,girl,1,6,1.7996724596123505e-5
eliza-grace,5,girl,0,5,1.4997270496769588e-5
ella-jade,5,girl,1,6,1.7996724596123505e-5
ellah,5,girl,0,5,1.4997270496769588e-5
ellana,5,girl,0,5,1.4997270496769588e-5
ellarose,5,girl,1,6,1.7996724596123505e-5
ellery,5,girl,0,5,1.4997270496769588e-5
ellie-rae,5,girl,0,5,1.4997270496769588e-5
elliemay,5,girl,0,5,1.4997270496769588e-5
ellin,5,girl,0,5,1.4997270496769588e-5
ellise,5,girl,1,6,1.7996724596123505e-5
elvina,5,girl,0,5,1.4997270496769588e-5
emelyn,5,girl,1,6,1.7996724596123505e-5
emiko,5,girl,0,5,1.4997270496769588e-5
emilie-rose,5,girl,3,8,2.3995632794831342e-5
emma-leigh,5,girl,0,5,1.4997270496769588e-5
era,5,girl,0,5,1.4997270496769588e-5
eseosa,5,girl,0,5,1.4997270496769588e-5
eslem,5,girl,0,5,1.4997270496769588e-5
esme-grace,5,girl,0,5,1.4997270496769588e-5
esty,5,girl,0,5,1.4997270496769588e-5
etty,5,girl,0,5,1.4997270496769588e-5
evah,5,girl,4,9,2.699508689418526e-5
evan,5,girl,1,6,1.7996724596123505e-5
evelyn-grace,5,girl,0,5,1.4997270496769588e-5
evy,5,girl,0,5,1.4997270496769588e-5
eyla,5,girl,1,6,1.7996724596123505e-5
fabiha,5,girl,0,5,1.4997270496769588e-5
fahima,5,girl,0,5,1.4997270496769588e-5
farwa,5,girl,0,5,1.4997270496769588e-5
farzana,5,girl,0,5,1.4997270496769588e-5
fatima-zahra,5,girl,0,5,1.4997270496769588e-5
faustina,5,girl,0,5,1.4997270496769588e-5
fayha,5,girl,0,5,1.4997270496769588e-5
fearn,5,girl,0,5,1.4997270496769588e-5
filza,5,girl,0,5,1.4997270496769588e-5
fionnuala,5,girl,0,5,1.4997270496769588e-5
fiorella,5,girl,0,5,1.4997270496769588e-5
gelila,5,girl,0,5,1.4997270496769588e-5
georgi,5,girl,1,6,1.7996724596123505e-5
gillian,5,girl,1,6,1.7996724596123505e-5
gwenevere,5,girl,0,5,1.4997270496769588e-5
haajirah,5,girl,0,5,1.4997270496769588e-5
haddy,5,girl,0,5,1.4997270496769588e-5
hadeel,5,girl,0,5,1.4997270496769588e-5
hajara,5,girl,0,5,1.4997270496769588e-5
hajer,5,girl,0,5,1.4997270496769588e-5
haley,5,girl,0,5,1.4997270496769588e-5
hali,5,girl,0,5,1.4997270496769588e-5
halle-rae,5,girl,0,5,1.4997270496769588e-5
halo,5,girl,0,5,1.4997270496769588e-5
hamida,5,girl,1,6,1.7996724596123505e-5
haneefah,5,girl,0,5,1.4997270496769588e-5
haniah,5,girl,0,5,1.4997270496769588e-5
hanin,5,girl,0,5,1.4997270496769588e-5
haniyyah,5,girl,0,5,1.4997270496769588e-5
hannah-marie,5,girl,0,5,1.4997270496769588e-5
haram,5,girl,0,5,1.4997270496769588e-5
harley-mae,5,girl,0,5,1.4997270496769588e-5
harley-quinn,5,girl,0,5,1.4997270496769588e-5
harley-rae,5,girl,1,6,1.7996724596123505e-5
harmony-grace,5,girl,0,5,1.4997270496769588e-5
harper-may,5,girl,0,5,1.4997270496769588e-5
harseerat,5,girl,0,5,1.4997270496769588e-5
hazel-grace,5,girl,0,5,1.4997270496769588e-5
helaina,5,girl,2,7,2.0996178695477422e-5
hermela,5,girl,0,5,1.4997270496769588e-5
hifza,5,girl,0,5,1.4997270496769588e-5
hikmah,5,girl,0,5,1.4997270496769588e-5
hina,5,girl,0,5,1.4997270496769588e-5
hind,5,girl,0,5,1.4997270496769588e-5
hiyab,5,girl,0,5,1.4997270496769588e-5
huma,5,girl,0,5,1.4997270496769588e-5
humeyra,5,girl,0,5,1.4997270496769588e-5
hurain,5,girl,0,5,1.4997270496769588e-5
ibtisam,5,girl,0,5,1.4997270496769588e-5
ilah,5,girl,1,6,1.7996724596123505e-5
ilhan,5,girl,0,5,1.4997270496769588e-5
iliza,5,girl,0,5,1.4997270496769588e-5
imara,5,girl,2,7,2.0996178695477422e-5
inca,5,girl,1,6,1.7996724596123505e-5
indi-rose,5,girl,0,5,1.4997270496769588e-5
indie-rae,5,girl,0,5,1.4997270496769588e-5
indra,5,girl,0,5,1.4997270496769588e-5
inna,5,girl,0,5,1.4997270496769588e-5
innaya,5,girl,0,5,1.4997270496769588e-5
innayah,5,girl,0,5,1.4997270496769588e-5
irem,5,girl,0,5,1.4997270496769588e-5
isabella-may,5,girl,0,5,1.4997270496769588e-5
isla-marie,5,girl,0,5,1.4997270496769588e-5
issabella,5,girl,1,6,1.7996724596123505e-5
ivee,5,girl,0,5,1.4997270496769588e-5
ivy-belle,5,girl,0,5,1.4997270496769588e-5
ivy-louise,5,girl,1,6,1.7996724596123505e-5
iya,5,girl,0,5,1.4997270496769588e-5
iyra,5,girl,0,5,1.4997270496769588e-5
izabell,5,girl,0,5,1.4997270496769588e-5
izza,5,girl,0,5,1.4997270496769588e-5
jaanvi,5,girl,0,5,1.4997270496769588e-5
jael,5,girl,0,5,1.4997270496769588e-5
jaimie,5,girl,1,6,1.7996724596123505e-5
janella,5,girl,0,5,1.4997270496769588e-5
janiya,5,girl,0,5,1.4997270496769588e-5
janna,5,girl,0,5,1.4997270496769588e-5
jasnoor,5,girl,0,5,1.4997270496769588e-5
jasreet,5,girl,0,5,1.4997270496769588e-5
jawaria,5,girl,0,5,1.4997270496769588e-5
jaycie,5,girl,0,5,1.4997270496769588e-5
jessamine,5,girl,0,5,1.4997270496769588e-5
jessica-louise,5,girl,0,5,1.4997270496769588e-5
jessie-may,5,girl,0,5,1.4997270496769588e-5
jessie-rae,5,girl,0,5,1.4997270496769588e-5
jianna,5,girl,0,5,1.4997270496769588e-5
jiayi,5,girl,0,5,1.4997270496769588e-5
jinan,5,girl,0,5,1.4997270496769588e-5
jiyana,5,girl,0,5,1.4997270496769588e-5
joely,5,girl,1,6,1.7996724596123505e-5
johannah,5,girl,0,5,1.4997270496769588e-5
jorgie-rose,5,girl,0,5,1.4997270496769588e-5
josefine,5,girl,0,5,1.4997270496769588e-5
joslyn,5,girl,1,6,1.7996724596123505e-5
jovi,5,girl,0,5,1.4997270496769588e-5
jowita,5,girl,0,5,1.4997270496769588e-5
judyta,5,girl,0,5,1.4997270496769588e-5
juri,5,girl,1,6,1.7996724596123505e-5
juste,5,girl,0,5,1.4997270496769588e-5
juwayria,5,girl,0,5,1.4997270496769588e-5
kaavya,5,girl,0,5,1.4997270496769588e-5
kadie-leigh,5,girl,0,5,1.4997270496769588e-5
kaela,5,girl,3,8,2.3995632794831342e-5
kaiah,5,girl,0,5,1.4997270496769588e-5
kainat,5,girl,0,5,1.4997270496769588e-5
kalaya,5,girl,1,6,1.7996724596123505e-5
kalea,5,girl,1,6,1.7996724596123505e-5
kalia,5,girl,0,5,1.4997270496769588e-5
kalsoom,5,girl,0,5,1.4997270496769588e-5
kamiyah,5,girl,0,5,1.4997270496769588e-5
kani,5,girl,1,6,1.7996724596123505e-5
kara-rose,5,girl,0,5,1.4997270496769588e-5
karam,5,girl,0,5,1.4997270496769588e-5
karin,5,girl,1,6,1.7996724596123505e-5
karissa,5,girl,0,5,1.4997270496769588e-5
karlie,5,girl,5,10,2.9994540993539176e-5
karly,5,girl,5,10,2.9994540993539176e-5
kashaf,5,girl,0,5,1.4997270496769588e-5
kassie,5,girl,1,6,1.7996724596123505e-5
katie-louise,5,girl,0,5,1.4997270496769588e-5
katie-rose,5,girl,0,5,1.4997270496769588e-5
katya,5,girl,1,6,1.7996724596123505e-5
kawthar,5,girl,0,5,1.4997270496769588e-5
kaysha,5,girl,0,5,1.4997270496769588e-5
keanna,5,girl,1,6,1.7996724596123505e-5
keirah,5,girl,0,5,1.4997270496769588e-5
keona,5,girl,0,5,1.4997270496769588e-5
keyla,5,girl,0,5,1.4997270496769588e-5
khalisah,5,girl,0,5,1.4997270496769588e-5
khansa,5,girl,0,5,1.4997270496769588e-5
khirad,5,girl,1,6,1.7996724596123505e-5
kiannah,5,girl,0,5,1.4997270496769588e-5
kimran,5,girl,0,5,1.4997270496769588e-5
kinsley,5,girl,2,7,2.0996178695477422e-5
kirpa,5,girl,1,6,1.7996724596123505e-5
kiyomi,5,girl,0,5,1.4997270496769588e-5
kosisochukwu,5,girl,0,5,1.4997270496769588e-5
kubra,5,girl,0,5,1.4997270496769588e-5
lacee,5,girl,0,5,1.4997270496769588e-5
lacie-rose,5,girl,0,5,1.4997270496769588e-5
laila-rose,5,girl,1,6,1.7996724596123505e-5
lainie,5,girl,0,5,1.4997270496769588e-5
laken,5,girl,0,5,1.4997270496769588e-5
lama,5,girl,1,6,1.7996724596123505e-5
lanya,5,girl,0,5,1.4997270496769588e-5
lareen,5,girl,2,7,2.0996178695477422e-5
latisha,5,girl,0,5,1.4997270496769588e-5
lava,5,girl,0,5,1.4997270496769588e-5
layla-marie,5,girl,0,5,1.4997270496769588e-5
leia-rose,5,girl,0,5,1.4997270496769588e-5
leigh,5,girl,1,6,1.7996724596123505e-5
lela,5,girl,1,6,1.7996724596123505e-5
lema,5,girl,0,5,1.4997270496769588e-5
lenni,5,girl,0,5,1.4997270496769588e-5
letisha,5,girl,0,5,1.4997270496769588e-5
letitia,5,girl,1,6,1.7996724596123505e-5
leusa,5,girl,0,5,1.4997270496769588e-5
levaeh,5,girl,0,5,1.4997270496769588e-5
levi,5,girl,2,7,2.0996178695477422e-5
lexii,5,girl,3,8,2.3995632794831342e-5
lexus,5,girl,0,5,1.4997270496769588e-5
leyah,5,girl,0,5,1.4997270496769588e-5
liane,5,girl,0,5,1.4997270496769588e-5
libbi,5,girl,1,6,1.7996724596123505e-5
lilah-grace,5,girl,0,5,1.4997270496769588e-5
lilah-mae,5,girl,0,5,1.4997270496769588e-5
lilah-rae,5,girl,0,5,1.4997270496769588e-5
liliana-rose,5,girl,0,5,1.4997270496769588e-5
lilli-mae,5,girl,0,5,1.4997270496769588e-5
lilliah,5,girl,0,5,1.4997270496769588e-5
lillie-louise,5,girl,0,5,1.4997270496769588e-5
lilly-anna,5,girl,0,5,1.4997270496769588e-5
lily-jo,5,girl,0,5,1.4997270496769588e-5
lily-louise,5,girl,0,5,1.4997270496769588e-5
lilyrose,5,girl,0,5,1.4997270496769588e-5
lindsay,5,girl,1,6,1.7996724596123505e-5
linnea,5,girl,1,6,1.7996724596123505e-5
liva,5,girl,0,5,1.4997270496769588e-5
livi,5,girl,1,6,1.7996724596123505e-5
livie,5,girl,0,5,1.4997270496769588e-5
liylah,5,girl,0,5,1.4997270496769588e-5
llio,5,girl,0,5,1.4997270496769588e-5
lorenna,5,girl,0,5,1.4997270496769588e-5
loti,5,girl,0,5,1.4997270496769588e-5
lotta,5,girl,2,7,2.0996178695477422e-5
lottie-louise,5,girl,0,5,1.4997270496769588e-5
lotty,5,girl,0,5,1.4997270496769588e-5
lucia-rose,5,girl,1,6,1.7996724596123505e-5
lucy-ann,5,girl,0,5,1.4997270496769588e-5
lulabelle,5,girl,0,5,1.4997270496769588e-5
lullah,5,girl,0,5,1.4997270496769588e-5
luna-mai,5,girl,0,5,1.4997270496769588e-5
lyan,5,girl,0,5,1.4997270496769588e-5
lydia-mae,5,girl,0,5,1.4997270496769588e-5
lydia-may,5,girl,0,5,1.4997270496769588e-5
maddox,5,girl,0,5,1.4997270496769588e-5
madelaine,5,girl,0,5,1.4997270496769588e-5
madisyn,5,girl,1,6,1.7996724596123505e-5
maggi,5,girl,0,5,1.4997270496769588e-5
mahdia,5,girl,0,5,1.4997270496769588e-5
mahida,5,girl,0,5,1.4997270496769588e-5
mahika,5,girl,0,5,1.4997270496769588e-5
mahjabeen,5,girl,0,5,1.4997270496769588e-5
maicie,5,girl,2,7,2.0996178695477422e-5
maija,5,girl,1,6,1.7996724596123505e-5
mairi,5,girl,7,12,3.599344919224701e-5
maisa,5,girl,0,5,1.4997270496769588e-5
maisie-louise,5,girl,0,5,1.4997270496769588e-5
maisie-mai,5,girl,0,5,1.4997270496769588e-5
maiza,5,girl,0,5,1.4997270496769588e-5
mala,5,girl,0,5,1.4997270496769588e-5
malena,5,girl,0,5,1.4997270496769588e-5
malikah,5,girl,0,5,1.4997270496769588e-5
malu,5,girl,0,5,1.4997270496769588e-5
mankirat,5,girl,0,5,1.4997270496769588e-5
manveer,5,girl,0,5,1.4997270496769588e-5
mariela,5,girl,1,6,1.7996724596123505e-5
marigold,5,girl,0,5,1.4997270496769588e-5
marley-rae,5,girl,0,5,1.4997270496769588e-5
marley-rose,5,girl,1,6,1.7996724596123505e-5
marnie-leigh,5,girl,0,5,1.4997270496769588e-5
marykate,5,girl,0,5,1.4997270496769588e-5
masal,5,girl,0,5,1.4997270496769588e-5
mateja,5,girl,0,5,1.4997270496769588e-5
mattie,5,girl,0,5,1.4997270496769588e-5
maymoonah,5,girl,0,5,1.4997270496769588e-5
mckayla,5,girl,0,5,1.4997270496769588e-5
medine,5,girl,0,5,1.4997270496769588e-5
melaher,5,girl,0,5,1.4997270496769588e-5
melany,5,girl,0,5,1.4997270496769588e-5
melika,5,girl,0,5,1.4997270496769588e-5
melinda,5,girl,0,5,1.4997270496769588e-5
memphis,5,girl,0,5,1.4997270496769588e-5
meryl,5,girl,1,6,1.7996724596123505e-5
mia-jade,5,girl,0,5,1.4997270496769588e-5
mia-lily,5,girl,4,9,2.699508689418526e-5
michaella,5,girl,0,5,1.4997270496769588e-5
mihika,5,girl,0,5,1.4997270496769588e-5
milda,5,girl,0,5,1.4997270496769588e-5
miley-rae,5,girl,0,5,1.4997270496769588e-5
mili,5,girl,1,6,1.7996724596123505e-5
millie-anne,5,girl,0,5,1.4997270496769588e-5
miroslava,5,girl,0,5,1.4997270496769588e-5
mishika,5,girl,0,5,1.4997270496769588e-5
misri,5,girl,0,5,1.4997270496769588e-5
momoka,5,girl,0,5,1.4997270496769588e-5
monique,5,girl,2,7,2.0996178695477422e-5
montanna,5,girl,0,5,1.4997270496769588e-5
morireoluwa,5,girl,0,5,1.4997270496769588e-5
morrigan,5,girl,0,5,1.4997270496769588e-5
morwenna,5,girl,0,5,1.4997270496769588e-5
moyosoreoluwa,5,girl,0,5,1.4997270496769588e-5
muniba,5,girl,0,5,1.4997270496769588e-5
nadira,5,girl,0,5,1.4997270496769588e-5
nadiya,5,girl,0,5,1.4997270496769588e-5
naeema,5,girl,1,6,1.7996724596123505e-5
naevia,5,girl,0,5,1.4997270496769588e-5
nafeesah,5,girl,0,5,1.4997270496769588e-5
naimah,5,girl,0,5,1.4997270496769588e-5
nainika,5,girl,0,5,1.4997270496769588e-5
nalah,5,girl,0,5,1.4997270496769588e-5
nanci,5,girl,0,5,1.4997270496769588e-5
nandi,5,girl,0,5,1.4997270496769588e-5
nandini,5,girl,0,5,1.4997270496769588e-5
nathania,5,girl,0,5,1.4997270496769588e-5
nava,5,girl,0,5,1.4997270496769588e-5
nayah,5,girl,0,5,1.4997270496769588e-5
nazli,5,girl,0,5,1.4997270496769588e-5
neeya,5,girl,0,5,1.4997270496769588e-5
nefertari,5,girl,0,5,1.4997270496769588e-5
nilah,5,girl,1,6,1.7996724596123505e-5
nilay,5,girl,0,5,1.4997270496769588e-5
nneoma,5,girl,0,5,1.4997270496769588e-5
noah,5,girl,0,5,1.4997270496769588e-5
noha,5,girl,0,5,1.4997270496769588e-5
nori,5,girl,0,5,1.4997270496769588e-5
nouf,5,girl,0,5,1.4997270496769588e-5
nurah,5,girl,0,5,1.4997270496769588e-5
nuralain,5,girl,0,5,1.4997270496769588e-5
nuriyah,5,girl,0,5,1.4997270496769588e-5
nyssa,5,girl,0,5,1.4997270496769588e-5
oakleigh,5,girl,0,5,1.4997270496769588e-5
odessa,5,girl,0,5,1.4997270496769588e-5
olamide,5,girl,0,5,1.4997270496769588e-5
olanna,5,girl,1,6,1.7996724596123505e-5
olivia-jayne,5,girl,0,5,1.4997270496769588e-5
olivia-lily,5,girl,0,5,1.4997270496769588e-5
olivia-marie,5,girl,0,5,1.4997270496769588e-5
oluwaferanmi,5,girl,0,5,1.4997270496769588e-5
oluwatobiloba,5,girl,0,5,1.4997270496769588e-5
oluwatofunmi,5,girl,0,5,1.4997270496769588e-5
omolara,5,girl,0,5,1.4997270496769588e-5
omotola,5,girl,0,5,1.4997270496769588e-5
orli,5,girl,0,5,1.4997270496769588e-5
ottilia,5,girl,1,6,1.7996724596123505e-5
otylia,5,girl,1,6,1.7996724596123505e-5
oyindamola,5,girl,0,5,1.4997270496769588e-5
paisley-grace,5,girl,0,5,1.4997270496769588e-5
paisley-mae,5,girl,0,5,1.4997270496769588e-5
pamela,5,girl,2,7,2.0996178695477422e-5
pareesa,5,girl,0,5,1.4997270496769588e-5
pavneet,5,girl,0,5,1.4997270496769588e-5
peggie,5,girl,0,5,1.4997270496769588e-5
pelin,5,girl,0,5,1.4997270496769588e-5
pheobie,5,girl,0,5,1.4997270496769588e-5
poppy-ann,5,girl,0,5,1.4997270496769588e-5
posey,5,girl,0,5,1.4997270496769588e-5
posie,5,girl,0,5,1.4997270496769588e-5
pranavi,5,girl,0,5,1.4997270496769588e-5
pranaya,5,girl,0,5,1.4997270496769588e-5
radha,5,girl,2,7,2.0996178695477422e-5
rafia,5,girl,0,5,1.4997270496769588e-5
rain,5,girl,1,6,1.7996724596123505e-5
raizel,5,girl,0,5,1.4997270496769588e-5
ramiah,5,girl,0,5,1.4997270496769588e-5
ramla,5,girl,0,5,1.4997270496769588e-5
rayhana,5,girl,0,5,1.4997270496769588e-5
rehmat,5,girl,1,6,1.7996724596123505e-5
remi-leigh,5,girl,1,6,1.7996724596123505e-5
remi-mae,5,girl,0,5,1.4997270496769588e-5
renesme,5,girl,0,5,1.4997270496769588e-5
reyyan,5,girl,0,5,1.4997270496769588e-5
rhianne,5,girl,0,5,1.4997270496769588e-5
riah,5,girl,3,8,2.3995632794831342e-5
richelle,5,girl,0,5,1.4997270496769588e-5
riddhi,5,girl,0,5,1.4997270496769588e-5
rifka,5,girl,0,5,1.4997270496769588e-5
rileigh,5,girl,0,5,1.4997270496769588e-5
ritaj,5,girl,0,5,1.4997270496769588e-5
ritanya,5,girl,0,5,1.4997270496769588e-5
rithika,5,girl,0,5,1.4997270496769588e-5
rivah,5,girl,0,5,1.4997270496769588e-5
roha,5,girl,0,5,1.4997270496769588e-5
romani,5,girl,0,5,1.4997270496769588e-5
romaya,5,girl,0,5,1.4997270496769588e-5
romi,5,girl,4,9,2.699508689418526e-5
rona,5,girl,3,8,2.3995632794831342e-5
ronnie-may,5,girl,0,5,1.4997270496769588e-5
ronya,5,girl,0,5,1.4997270496769588e-5
rosaline,5,girl,0,5,1.4997270496769588e-5
rose-ella,5,girl,0,5,1.4997270496769588e-5
rosella,5,girl,1,6,1.7996724596123505e-5
rosie-ann,5,girl,0,5,1.4997270496769588e-5
roslyn,5,girl,6,11,3.2993995092893096e-5
rubie-mae,5,girl,0,5,1.4997270496769588e-5
rubina,5,girl,0,5,1.4997270496769588e-5
ruby-anna,5,girl,0,5,1.4997270496769588e-5
ruby-lou,5,girl,0,5,1.4997270496769588e-5
rudy,5,girl,0,5,1.4997270496769588e-5
rumi,5,girl,1,6,1.7996724596123505e-5
ruqaiya,5,girl,0,5,1.4997270496769588e-5
rushika,5,girl,0,5,1.4997270496769588e-5
ruslana,5,girl,0,5,1.4997270496769588e-5
rutvi,5,girl,0,5,1.4997270496769588e-5
sabeeha,5,girl,0,5,1.4997270496769588e-5
safreen,5,girl,0,5,1.4997270496769588e-5
safwana,5,girl,0,5,1.4997270496769588e-5
sahasra,5,girl,0,5,1.4997270496769588e-5
saiba,5,girl,0,5,1.4997270496769588e-5
saiya,5,girl,0,5,1.4997270496769588e-5
sajida,5,girl,0,5,1.4997270496769588e-5
salina,5,girl,0,5,1.4997270496769588e-5
sanam,5,girl,0,5,1.4997270496769588e-5
sansa,5,girl,0,5,1.4997270496769588e-5
santanna,5,girl,0,5,1.4997270496769588e-5
saphire,5,girl,0,5,1.4997270496769588e-5
sapphire-rose,5,girl,0,5,1.4997270496769588e-5
sarah-jane,5,girl,2,7,2.0996178695477422e-5
sariyah,5,girl,0,5,1.4997270496769588e-5
sarya,5,girl,0,5,1.4997270496769588e-5
savana,5,girl,0,5,1.4997270496769588e-5
savannah-rae,5,girl,0,5,1.4997270496769588e-5
selen,5,girl,0,5,1.4997270496769588e-5
seraphine,5,girl,0,5,1.4997270496769588e-5
serin,5,girl,0,5,1.4997270496769588e-5
serine,5,girl,0,5,1.4997270496769588e-5
serra,5,girl,0,5,1.4997270496769588e-5
shaam,5,girl,0,5,1.4997270496769588e-5
shaylee,5,girl,0,5,1.4997270496769588e-5
shia,5,girl,0,5,1.4997270496769588e-5
shivanya,5,girl,1,6,1.7996724596123505e-5
shree,5,girl,0,5,1.4997270496769588e-5
siaana,5,girl,0,5,1.4997270496769588e-5
sienna-louise,5,girl,0,5,1.4997270496769588e-5
silvie,5,girl,0,5,1.4997270496769588e-5
sima,5,girl,0,5,1.4997270496769588e-5
simrit,5,girl,0,5,1.4997270496769588e-5
sioned,5,girl,0,5,1.4997270496769588e-5
skarlett,5,girl,0,5,1.4997270496769588e-5
skylah-rose,5,girl,0,5,1.4997270496769588e-5
sofina,5,girl,0,5,1.4997270496769588e-5
sol,5,girl,0,5,1.4997270496769588e-5
soliana,5,girl,0,5,1.4997270496769588e-5
sophie-louise,5,girl,2,7,2.0996178695477422e-5
sophie-mae,5,girl,1,6,1.7996724596123505e-5
sophie-rose,5,girl,1,6,1.7996724596123505e-5
sophy,5,girl,0,5,1.4997270496769588e-5
stevie-leigh,5,girl,0,5,1.4997270496769588e-5
story,5,girl,0,5,1.4997270496769588e-5
sude,5,girl,0,5,1.4997270496769588e-5
suha,5,girl,0,5,1.4997270496769588e-5
sukhpreet,5,girl,0,5,1.4997270496769588e-5
summer-mae,5,girl,0,5,1.4997270496769588e-5
sunaina,5,girl,0,5,1.4997270496769588e-5
sydnee,5,girl,0,5,1.4997270496769588e-5
sydney-rose,5,girl,0,5,1.4997270496769588e-5
sydni,5,girl,0,5,1.4997270496769588e-5
sydnie,5,girl,0,5,1.4997270496769588e-5
tabetha,5,girl,0,5,1.4997270496769588e-5
tahani,5,girl,0,5,1.4997270496769588e-5
tahirah,5,girl,0,5,1.4997270496769588e-5
tallulah-rose,5,girl,0,5,1.4997270496769588e-5
talulla,5,girl,0,5,1.4997270496769588e-5
tamanna,5,girl,0,5,1.4997270496769588e-5
tamia,5,girl,0,5,1.4997270496769588e-5
tamika,5,girl,0,5,1.4997270496769588e-5
tanishka,5,girl,0,5,1.4997270496769588e-5
tansy,5,girl,1,6,1.7996724596123505e-5
tayana,5,girl,0,5,1.4997270496769588e-5
tayla-mae,5,girl,0,5,1.4997270496769588e-5
taylor-rose,5,girl,1,6,1.7996724596123505e-5
teighan,5,girl,3,8,2.3995632794831342e-5
teleri,5,girl,0,5,1.4997270496769588e-5
thea-mae,5,girl,0,5,1.4997270496769588e-5
tia-mae,5,girl,0,5,1.4997270496769588e-5
tiffany-rose,5,girl,0,5,1.4997270496769588e-5
tilia,5,girl,0,5,1.4997270496769588e-5
tilley,5,girl,0,5,1.4997270496769588e-5
tillie-rose,5,girl,1,6,1.7996724596123505e-5
tinashe,5,girl,0,5,1.4997270496769588e-5
tirenioluwa,5,girl,1,6,1.7996724596123505e-5
tiwalade,5,girl,0,5,1.4997270496769588e-5
tuba,5,girl,1,6,1.7996724596123505e-5
tulisa,5,girl,0,5,1.4997270496769588e-5
tuppence,5,girl,0,5,1.4997270496769588e-5
umaamah,5,girl,0,5,1.4997270496769588e-5
umayma,5,girl,0,5,1.4997270496769588e-5
urwah,5,girl,0,5,1.4997270496769588e-5
valentine,5,girl,0,5,1.4997270496769588e-5
valerija,5,girl,0,5,1.4997270496769588e-5
vesta,5,girl,0,5,1.4997270496769588e-5
vianna,5,girl,0,5,1.4997270496769588e-5
vidhi,5,girl,0,5,1.4997270496769588e-5
viktoriya,5,girl,0,5,1.4997270496769588e-5
violet-mae,5,girl,0,5,1.4997270496769588e-5
violett,5,girl,1,6,1.7996724596123505e-5
viyona,5,girl,0,5,1.4997270496769588e-5
wafaa,5,girl,0,5,1.4997270496769588e-5
widad,5,girl,0,5,1.4997270496769588e-5
wilhelmina,5,girl,0,5,1.4997270496769588e-5
wynter-rose,5,girl,1,6,1.7996724596123505e-5
ya,5,girl,0,5,1.4997270496769588e-5
yi,5,girl,1,6,1.7996724596123505e-5
yousra,5,girl,0,5,1.4997270496769588e-5
yvonne,5,girl,2,7,2.0996178695477422e-5
zaha,5,girl,0,5,1.4997270496769588e-5
zainah,5,girl,0,5,1.4997270496769588e-5
zakirah,5,girl,0,5,1.4997270496769588e-5
zamira,5,girl,0,5,1.4997270496769588e-5
zaneta,5,girl,0,5,1.4997270496769588e-5
zaniyah,5,girl,0,5,1.4997270496769588e-5
zareenah,5,girl,0,5,1.4997270496769588e-5
zayana,5,girl,0,5,1.4997270496769588e-5
zeena,5,girl,0,5,1.4997270496769588e-5
zenab,5,girl,0,5,1.4997270496769588e-5
zeynab,5,girl,0,5,1.4997270496769588e-5
zianna,5,girl,0,5,1.4997270496769588e-5
zoeya,5,girl,1,6,1.7996724596123505e-5
zohal,5,girl,0,5,1.4997270496769588e-5
zosha,5,girl,0,5,1.4997270496769588e-5
zyrah,5,girl,1,6,1.7996724596123505e-5
aabidah,4,girl,0,4,1.1997816397415671e-5
aadhira,4,girl,0,4,1.1997816397415671e-5
aalayah,4,girl,0,4,1.1997816397415671e-5
aaliah,4,girl,1,5,1.4997270496769588e-5
aaliyah-mai,4,girl,0,4,1.1997816397415671e-5
aaliyah-rae,4,girl,0,4,1.1997816397415671e-5
aamena,4,girl,0,4,1.1997816397415671e-5
aariah,4,girl,3,7,2.0996178695477422e-5
aaruhi,4,girl,0,4,1.1997816397415671e-5
aasia,4,girl,0,4,1.1997816397415671e-5
aava,4,girl,0,4,1.1997816397415671e-5
aayana,4,girl,0,4,1.1997816397415671e-5
aayra,4,girl,0,4,1.1997816397415671e-5
abigayle,4,girl,0,4,1.1997816397415671e-5
abigel,4,girl,0,4,1.1997816397415671e-5
abira,4,girl,0,4,1.1997816397415671e-5
abriella,4,girl,0,4,1.1997816397415671e-5
abrielle,4,girl,0,4,1.1997816397415671e-5
ada-grace,4,girl,0,4,1.1997816397415671e-5
adama,4,girl,1,5,1.4997270496769588e-5
adelie,4,girl,0,4,1.1997816397415671e-5
adelynn,4,girl,1,5,1.4997270496769588e-5
aderinsola,4,girl,0,4,1.1997816397415671e-5
adithi,4,girl,0,4,1.1997816397415671e-5
adrienne,4,girl,0,4,1.1997816397415671e-5
adwoa,4,girl,0,4,1.1997816397415671e-5
afeefah,4,girl,0,4,1.1997816397415671e-5
afnaan,4,girl,0,4,1.1997816397415671e-5
afraa,4,girl,0,4,1.1997816397415671e-5
ahlaam,4,girl,0,4,1.1997816397415671e-5
aibhlin,4,girl,0,4,1.1997816397415671e-5
ailani,4,girl,0,4,1.1997816397415671e-5
ailis,4,girl,0,4,1.1997816397415671e-5
aimee-rose,4,girl,1,5,1.4997270496769588e-5
aishat,4,girl,0,4,1.1997816397415671e-5
aislinn,4,girl,0,4,1.1997816397415671e-5
aiste,4,girl,0,4,1.1997816397415671e-5
aizah-noor,4,girl,0,4,1.1997816397415671e-5
aizzah,4,girl,0,4,1.1997816397415671e-5
ajana,4,girl,0,4,1.1997816397415671e-5
ajla,4,girl,0,4,1.1997816397415671e-5
akeelah,4,girl,1,5,1.4997270496769588e-5
akosua,4,girl,0,4,1.1997816397415671e-5
akua,4,girl,0,4,1.1997816397415671e-5
alaiza,4,girl,0,4,1.1997816397415671e-5
albertine,4,girl,0,4,1.1997816397415671e-5
albie,4,girl,0,4,1.1997816397415671e-5
aleeah,4,girl,2,6,1.7996724596123505e-5
aleeha,4,girl,0,4,1.1997816397415671e-5
aleema,4,girl,0,4,1.1997816397415671e-5
aleezah,4,girl,0,4,1.1997816397415671e-5
alexia-rose,4,girl,0,4,1.1997816397415671e-5
alica,4,girl,0,4,1.1997816397415671e-5
alicia-rose,4,girl,0,4,1.1997816397415671e-5
alin,4,girl,0,4,1.1997816397415671e-5
alivia-rose,4,girl,0,4,1.1997816397415671e-5
alizeh,4,girl,0,4,1.1997816397415671e-5
allyssa,4,girl,0,4,1.1997816397415671e-5
almas,4,girl,0,4,1.1997816397415671e-5
alylah,4,girl,0,4,1.1997816397415671e-5
alysa,4,girl,0,4,1.1997816397415671e-5
alyzza,4,girl,0,4,1.1997816397415671e-5
amaaya,4,girl,0,4,1.1997816397415671e-5
amalya,4,girl,0,4,1.1997816397415671e-5
aman,4,girl,0,4,1.1997816397415671e-5
amara-rose,4,girl,0,4,1.1997816397415671e-5
amaria,4,girl,0,4,1.1997816397415671e-5
amariyah,4,girl,0,4,1.1997816397415671e-5
ameelia,4,girl,0,4,1.1997816397415671e-5
ameila,4,girl,1,5,1.4997270496769588e-5
amelia-jayne,4,girl,0,4,1.1997816397415671e-5
amerie,4,girl,0,4,1.1997816397415671e-5
amethyst,4,girl,0,4,1.1997816397415671e-5
amika,4,girl,0,4,1.1997816397415671e-5
amily,4,girl,1,5,1.4997270496769588e-5
ammaarah,4,girl,0,4,1.1997816397415671e-5
amtul,4,girl,0,4,1.1997816397415671e-5
amy-leigh,4,girl,0,4,1.1997816397415671e-5
amy-rose,4,girl,0,4,1.1997816397415671e-5
amyah,4,girl,0,4,1.1997816397415671e-5
anab,4,girl,0,4,1.1997816397415671e-5
anand,4,girl,0,4,1.1997816397415671e-5
anara,4,girl,0,4,1.1997816397415671e-5
andria,4,girl,0,4,1.1997816397415671e-5
aneeka,4,girl,0,4,1.1997816397415671e-5
aneeqa,4,girl,0,4,1.1997816397415671e-5
anfaal,4,girl,0,4,1.1997816397415671e-5
angel-louise,4,girl,0,4,1.1997816397415671e-5
anha,4,girl,0,4,1.1997816397415671e-5
aniella,4,girl,0,4,1.1997816397415671e-5
anise,4,girl,1,5,1.4997270496769588e-5
aniyah-rae,4,girl,0,4,1.1997816397415671e-5
ankita,4,girl,0,4,1.1997816397415671e-5
ann-marie,4,girl,1,5,1.4997270496769588e-5
anna-may,4,girl,2,6,1.7996724596123505e-5
annaleigh,4,girl,1,5,1.4997270496769588e-5
annaleise,4,girl,0,4,1.1997816397415671e-5
annam,4,girl,0,4,1.1997816397415671e-5
annamarie,4,girl,0,4,1.1997816397415671e-5
annelie,4,girl,0,4,1.1997816397415671e-5
annie-marie,4,girl,0,4,1.1997816397415671e-5
annmarie,4,girl,0,4,1.1997816397415671e-5
anokhi,4,girl,0,4,1.1997816397415671e-5
anola,4,girl,0,4,1.1997816397415671e-5
anousheh,4,girl,0,4,1.1997816397415671e-5
anouska,4,girl,0,4,1.1997816397415671e-5
ansha,4,girl,1,5,1.4997270496769588e-5
anshi,4,girl,0,4,1.1997816397415671e-5
anvitha,4,girl,0,4,1.1997816397415671e-5
aphrodite,4,girl,0,4,1.1997816397415671e-5
aradhana,4,girl,0,4,1.1997816397415671e-5
araoluwa,4,girl,0,4,1.1997816397415671e-5
areesa,4,girl,0,4,1.1997816397415671e-5
areya,4,girl,0,4,1.1997816397415671e-5
aria-jane,4,girl,1,5,1.4997270496769588e-5
aria-may,4,girl,0,4,1.1997816397415671e-5
aria-rae,4,girl,0,4,1.1997816397415671e-5
arifah,4,girl,0,4,1.1997816397415671e-5
arla-rae,4,girl,0,4,1.1997816397415671e-5
arooj,4,girl,1,5,1.4997270496769588e-5
aroosh,4,girl,0,4,1.1997816397415671e-5
arshia,4,girl,1,5,1.4997270496769588e-5
arzoo,4,girl,0,4,1.1997816397415671e-5
ashira,4,girl,0,4,1.1997816397415671e-5
ashwini,4,girl,0,4,1.1997816397415671e-5
assia,4,girl,1,5,1.4997270496769588e-5
atika,4,girl,0,4,1.1997816397415671e-5
audra,4,girl,0,4,1.1997816397415671e-5
aurora-jane,4,girl,0,4,1.1997816397415671e-5
ava-jean,4,girl,0,4,1.1997816397415671e-5
avanna,4,girl,0,4,1.1997816397415671e-5
aveah,4,girl,0,4,1.1997816397415671e-5
avelyn,4,girl,0,4,1.1997816397415671e-5
aviarna,4,girl,0,4,1.1997816397415671e-5
awel,4,girl,0,4,1.1997816397415671e-5
ayaah,4,girl,0,4,1.1997816397415671e-5
ayaan,4,girl,0,4,1.1997816397415671e-5
ayala,4,girl,0,4,1.1997816397415671e-5
ayla-may,4,girl,0,4,1.1997816397415671e-5
aynur,4,girl,0,4,1.1997816397415671e-5
azayah,4,girl,0,4,1.1997816397415671e-5
azma,4,girl,0,4,1.1997816397415671e-5
azrah,4,girl,0,4,1.1997816397415671e-5
bailey-rose,4,girl,0,4,1.1997816397415671e-5
baran,4,girl,0,4,1.1997816397415671e-5
bassi,4,girl,0,4,1.1997816397415671e-5
begw,4,girl,0,4,1.1997816397415671e-5
bella-,4,girl,0,4,1.1997816397415671e-5
benin,4,girl,0,4,1.1997816397415671e-5
bethany-rose,4,girl,1,5,1.4997270496769588e-5
bethia,4,girl,0,4,1.1997816397415671e-5
betsy-lou,4,girl,0,4,1.1997816397415671e-5
betsy-mae,4,girl,0,4,1.1997816397415671e-5
betsy-rae,4,girl,0,4,1.1997816397415671e-5
betul,4,girl,0,4,1.1997816397415671e-5
beverly,4,girl,0,4,1.1997816397415671e-5
bhavya,4,girl,0,4,1.1997816397415671e-5
bia,4,girl,0,4,1.1997816397415671e-5
bilan,4,girl,0,4,1.1997816397415671e-5
billie-may,4,girl,0,4,1.1997816397415671e-5
billie-rae,4,girl,0,4,1.1997816397415671e-5
blanca,4,girl,1,5,1.4997270496769588e-5
blanche,4,girl,0,4,1.1997816397415671e-5
bobbie-jo,4,girl,0,4,1.1997816397415671e-5
bobbie-rae,4,girl,0,4,1.1997816397415671e-5
bonnie-leigh,4,girl,0,4,1.1997816397415671e-5
bonnie-louise,4,girl,0,4,1.1997816397415671e-5
bozhidara,4,girl,0,4,1.1997816397415671e-5
brittany,4,girl,0,4,1.1997816397415671e-5
brocha,4,girl,0,4,1.1997816397415671e-5
bryanna,4,girl,1,5,1.4997270496769588e-5
bryoni,4,girl,0,4,1.1997816397415671e-5
bunnie,4,girl,0,4,1.1997816397415671e-5
caela,4,girl,1,5,1.4997270496769588e-5
caitlin-rose,4,girl,0,4,1.1997816397415671e-5
caleesi,4,girl,0,4,1.1997816397415671e-5
callista,4,girl,1,5,1.4997270496769588e-5
capri,4,girl,0,4,1.1997816397415671e-5
cara-rose,4,girl,0,4,1.1997816397415671e-5
carmella,4,girl,0,4,1.1997816397415671e-5
carris,4,girl,1,5,1.4997270496769588e-5
casey-mae,4,girl,0,4,1.1997816397415671e-5
casey-may,4,girl,0,4,1.1997816397415671e-5
casiana,4,girl,0,4,1.1997816397415671e-5
catelyn,4,girl,0,4,1.1997816397415671e-5
ceci,4,girl,0,4,1.1997816397415671e-5
cecile,4,girl,0,4,1.1997816397415671e-5
chanell,4,girl,0,4,1.1997816397415671e-5
chardonnay,4,girl,0,4,1.1997816397415671e-5
charley-rose,4,girl,0,4,1.1997816397415671e-5
cheyanne,4,girl,0,4,1.1997816397415671e-5
chidimma,4,girl,0,4,1.1997816397415671e-5
chiedza,4,girl,0,4,1.1997816397415671e-5
chisimdi,4,girl,1,5,1.4997270496769588e-5
chloe-louise,4,girl,0,4,1.1997816397415671e-5
christa,4,girl,1,5,1.4997270496769588e-5
christabelle,4,girl,0,4,1.1997816397415671e-5
ciana,4,girl,0,4,1.1997816397415671e-5
clare,4,girl,0,4,1.1997816397415671e-5
claudie,4,girl,0,4,1.1997816397415671e-5
clemencie,4,girl,0,4,1.1997816397415671e-5
colleen,4,girl,1,5,1.4997270496769588e-5
comfort,4,girl,0,4,1.1997816397415671e-5
connie-may,4,girl,0,4,1.1997816397415671e-5
constanca,4,girl,0,4,1.1997816397415671e-5
corey,4,girl,0,4,1.1997816397415671e-5
cosmina,4,girl,0,4,1.1997816397415671e-5
csenge,4,girl,0,4,1.1997816397415671e-5
csilla,4,girl,0,4,1.1997816397415671e-5
cyrine,4,girl,0,4,1.1997816397415671e-5
daenerys,4,girl,0,4,1.1997816397415671e-5
daisey,4,girl,0,4,1.1997816397415671e-5
daisy-marie,4,girl,0,4,1.1997816397415671e-5
dakota-rose,4,girl,0,4,1.1997816397415671e-5
dalya,4,girl,0,4,1.1997816397415671e-5
damarisa,4,girl,0,4,1.1997816397415671e-5
danah,4,girl,0,4,1.1997816397415671e-5
daneen,4,girl,0,4,1.1997816397415671e-5
daniyah,4,girl,0,4,1.1997816397415671e-5
darcey-may,4,girl,1,5,1.4997270496769588e-5
darcie-grace,4,girl,0,4,1.1997816397415671e-5
darlah,4,girl,2,6,1.7996724596123505e-5
darwin,4,girl,0,4,1.1997816397415671e-5
deeana,4,girl,0,4,1.1997816397415671e-5
deimante,4,girl,0,4,1.1997816397415671e-5
delara,4,girl,0,4,1.1997816397415671e-5
delfina,4,girl,0,4,1.1997816397415671e-5
delilah-mae,4,girl,0,4,1.1997816397415671e-5
delphina,4,girl,0,4,1.1997816397415671e-5
delsa,4,girl,0,4,1.1997816397415671e-5
delsie,4,girl,1,5,1.4997270496769588e-5
demi-lea,4,girl,0,4,1.1997816397415671e-5
denise,4,girl,1,5,1.4997270496769588e-5
dennie,4,girl,0,4,1.1997816397415671e-5
despina,4,girl,0,4,1.1997816397415671e-5
destiny-rose,4,girl,1,5,1.4997270496769588e-5
devi,4,girl,0,4,1.1997816397415671e-5
devika,4,girl,0,4,1.1997816397415671e-5
devoiry,4,girl,0,4,1.1997816397415671e-5
dhyana,4,girl,0,4,1.1997816397415671e-5
dilek,4,girl,0,4,1.1997816397415671e-5
dillon,4,girl,2,6,1.7996724596123505e-5
dilpreet,4,girl,0,4,1.1997816397415671e-5
dimitra,4,girl,2,6,1.7996724596123505e-5
diora,4,girl,0,4,1.1997816397415671e-5
divleen,4,girl,0,4,1.1997816397415671e-5
dolcie-mae,4,girl,0,4,1.1997816397415671e-5
dolly-mai,4,girl,0,4,1.1997816397415671e-5
donia,4,girl,0,4,1.1997816397415671e-5
donika,4,girl,0,4,1.1997816397415671e-5
durga,4,girl,0,4,1.1997816397415671e-5
duru,4,girl,0,4,1.1997816397415671e-5
dusty,4,girl,0,4,1.1997816397415671e-5
dzesika,4,girl,0,4,1.1997816397415671e-5
ebony-rae,4,girl,0,4,1.1997816397415671e-5
ebru,4,girl,0,4,1.1997816397415671e-5
ebunoluwa,4,girl,0,4,1.1997816397415671e-5
ecaterina,4,girl,0,4,1.1997816397415671e-5
ece,4,girl,0,4,1.1997816397415671e-5
eden-grace,4,girl,0,4,1.1997816397415671e-5
eila-rose,4,girl,0,4,1.1997816397415671e-5
eilah,4,girl,0,4,1.1997816397415671e-5
eireann,4,girl,1,5,1.4997270496769588e-5
eirwen,4,girl,1,5,1.4997270496769588e-5
ekroop,4,girl,0,4,1.1997816397415671e-5
elaf,4,girl,1,5,1.4997270496769588e-5
elanor,4,girl,2,6,1.7996724596123505e-5
elayah,4,girl,0,4,1.1997816397415671e-5
elcie,4,girl,0,4,1.1997816397415671e-5
elena-rose,4,girl,1,5,1.4997270496769588e-5
eliane,4,girl,0,4,1.1997816397415671e-5
elifnaz,4,girl,0,4,1.1997816397415671e-5
elifsu,4,girl,0,4,1.1997816397415671e-5
eliza-lily,4,girl,0,4,1.1997816397415671e-5
eliza-may,4,girl,0,4,1.1997816397415671e-5
eliza-rae,4,girl,0,4,1.1997816397415671e-5
elizabet,4,girl,0,4,1.1997816397415671e-5
elizabeth-grace,4,girl,0,4,1.1997816397415671e-5
elliah,4,girl,0,4,1.1997816397415671e-5
ellianna,4,girl,0,4,1.1997816397415671e-5
ellie-ann,4,girl,0,4,1.1997816397415671e-5
ellie-jay,4,girl,0,4,1.1997816397415671e-5
ellie-marie,4,girl,0,4,1.1997816397415671e-5
ellison,4,girl,0,4,1.1997816397415671e-5
ellissa,4,girl,0,4,1.1997816397415671e-5
ellissia,4,girl,0,4,1.1997816397415671e-5
elliza,4,girl,0,4,1.1997816397415671e-5
ellyn,4,girl,1,5,1.4997270496769588e-5
ellysia,4,girl,0,4,1.1997816397415671e-5
elphie,4,girl,0,4,1.1997816397415671e-5
elsa-rose,4,girl,0,4,1.1997816397415671e-5
elsee,4,girl,0,4,1.1997816397415671e-5
elsie-leigh,4,girl,0,4,1.1997816397415671e-5
elsy,4,girl,0,4,1.1997816397415671e-5
elvira,4,girl,1,5,1.4997270496769588e-5
elya,4,girl,0,4,1.1997816397415671e-5
elysha,4,girl,0,4,1.1997816397415671e-5
elza,4,girl,2,6,1.7996724596123505e-5
emberly,4,girl,0,4,1.1997816397415671e-5
emelia-lily,4,girl,0,4,1.1997816397415671e-5
emilia-mae,4,girl,0,4,1.1997816397415671e-5
emillia,4,girl,0,4,1.1997816397415671e-5
emily-louise,4,girl,0,4,1.1997816397415671e-5
emine,4,girl,3,7,2.0996178695477422e-5
emma-louise,4,girl,1,5,1.4997270496769588e-5
emmie-may,4,girl,0,4,1.1997816397415671e-5
eos,4,girl,0,4,1.1997816397415671e-5
eowyn,4,girl,1,5,1.4997270496769588e-5
erinn,4,girl,0,4,1.1997816397415671e-5
erisa,4,girl,0,4,1.1997816397415671e-5
eshani,4,girl,0,4,1.1997816397415671e-5
esmae-louise,4,girl,0,4,1.1997816397415671e-5
esmai-rose,4,girl,0,4,1.1997816397415671e-5
esosa,4,girl,0,4,1.1997816397415671e-5
essi,4,girl,0,4,1.1997816397415671e-5
estee,4,girl,1,5,1.4997270496769588e-5
esther-rose,4,girl,0,4,1.1997816397415671e-5
eszter,4,girl,1,5,1.4997270496769588e-5
etana,4,girl,0,4,1.1997816397415671e-5
evalie,4,girl,0,4,1.1997816397415671e-5
evangelia,4,girl,2,6,1.7996724596123505e-5
eveleen,4,girl,0,4,1.1997816397415671e-5
eveleigh,4,girl,0,4,1.1997816397415671e-5
evelyn-mae,4,girl,0,4,1.1997816397415671e-5
evelyna,4,girl,0,4,1.1997816397415671e-5
ever,4,girl,1,5,1.4997270496769588e-5
evie-jo,4,girl,0,4,1.1997816397415671e-5
evie-sue,4,girl,0,4,1.1997816397415671e-5
evlyn,4,girl,0,4,1.1997816397415671e-5
evolet,4,girl,0,4,1.1997816397415671e-5
ewelina,4,girl,0,4,1.1997816397415671e-5
ezri,4,girl,0,4,1.1997816397415671e-5
faheema,4,girl,0,4,1.1997816397415671e-5
fahmida,4,girl,0,4,1.1997816397415671e-5
faridah,4,girl,0,4,1.1997816397415671e-5
farwah,4,girl,1,5,1.4997270496769588e-5
fateha,4,girl,0,4,1.1997816397415671e-5
fatheha,4,girl,0,4,1.1997816397415671e-5
fathimah,4,girl,0,4,1.1997816397415671e-5
fatoumatta,4,girl,0,4,1.1997816397415671e-5
faustine,4,girl,0,4,1.1997816397415671e-5
faustyna,4,girl,0,4,1.1997816397415671e-5
fawn,4,girl,0,4,1.1997816397415671e-5
faya,4,girl,0,4,1.1997816397415671e-5
fayrouz,4,girl,0,4,1.1997816397415671e-5
fayth,4,girl,3,7,2.0996178695477422e-5
felicity-rose,4,girl,0,4,1.1997816397415671e-5
feyza,4,girl,0,4,1.1997816397415671e-5
fflur,4,girl,0,4,1.1997816397415671e-5
fizza,4,girl,1,5,1.4997270496769588e-5
floella,4,girl,0,4,1.1997816397415671e-5
flori,4,girl,0,4,1.1997816397415671e-5
flynn,4,girl,0,4,1.1997816397415671e-5
franciszka,4,girl,0,4,1.1997816397415671e-5
frankee,4,girl,0,4,1.1997816397415671e-5
frankie-marie,4,girl,0,4,1.1997816397415671e-5
frankie-may,4,girl,0,4,1.1997816397415671e-5
freeda,4,girl,0,4,1.1997816397415671e-5
georgette,4,girl,0,4,1.1997816397415671e-5
georgia-leigh,4,girl,0,4,1.1997816397415671e-5
georgie-rose,4,girl,0,4,1.1997816397415671e-5
gerda,4,girl,0,4,1.1997816397415671e-5
giavanna,4,girl,1,5,1.4997270496769588e-5
gilda,4,girl,0,4,1.1997816397415671e-5
gisele,4,girl,0,4,1.1997816397415671e-5
gizem,4,girl,0,4,1.1997816397415671e-5
gladys,4,girl,0,4,1.1997816397415671e-5
goldy,4,girl,0,4,1.1997816397415671e-5
gracie-ella,4,girl,0,4,1.1997816397415671e-5
gracie-lee,4,girl,0,4,1.1997816397415671e-5
grae,4,girl,0,4,1.1997816397415671e-5
greisi,4,girl,0,4,1.1997816397415671e-5
gurjot,4,girl,1,5,1.4997270496769588e-5
gurkirat,4,girl,0,4,1.1997816397415671e-5
gursimran,4,girl,0,4,1.1997816397415671e-5
haajar,4,girl,1,5,1.4997270496769588e-5
haaniyah,4,girl,0,4,1.1997816397415671e-5
hadasa,4,girl,0,4,1.1997816397415671e-5
hafizah,4,girl,0,4,1.1997816397415671e-5
hajarah,4,girl,0,4,1.1997816397415671e-5
halle-rose,4,girl,0,4,1.1997816397415671e-5
hallie-mai,4,girl,0,4,1.1997816397415671e-5
hanaan,4,girl,0,4,1.1997816397415671e-5
hannah-rose,4,girl,1,5,1.4997270496769588e-5
harla,4,girl,1,5,1.4997270496769588e-5
harleigh-rae,4,girl,0,4,1.1997816397415671e-5
harlie-rose,4,girl,0,4,1.1997816397415671e-5
harmonie,4,girl,0,4,1.1997816397415671e-5
harper-jean,4,girl,0,4,1.1997816397415671e-5
harper-mai,4,girl,0,4,1.1997816397415671e-5
harrietta,4,girl,0,4,1.1997816397415671e-5
hasanat,4,girl,0,4,1.1997816397415671e-5
hattie-mae,4,girl,0,4,1.1997816397415671e-5
havanna,4,girl,0,4,1.1997816397415671e-5
havannah,4,girl,1,5,1.4997270496769588e-5
havisha,4,girl,0,4,1.1997816397415671e-5
hawi,4,girl,0,4,1.1997816397415671e-5
hawwaa,4,girl,0,4,1.1997816397415671e-5
hayaat,4,girl,0,4,1.1997816397415671e-5
hayla,4,girl,0,4,1.1997816397415671e-5
haylee,4,girl,0,4,1.1997816397415671e-5
heeya,4,girl,0,4,1.1997816397415671e-5
heidi-mae,4,girl,0,4,1.1997816397415671e-5
helan,4,girl,0,4,1.1997816397415671e-5
helayna,4,girl,0,4,1.1997816397415671e-5
hephzibah,4,girl,0,4,1.1997816397415671e-5
hettienne,4,girl,0,4,1.1997816397415671e-5
hiya,4,girl,0,4,1.1997816397415671e-5
holli,4,girl,1,5,1.4997270496769588e-5
hollie-ann,4,girl,0,4,1.1997816397415671e-5
holly-rose,4,girl,1,5,1.4997270496769588e-5
honey-mae,4,girl,0,4,1.1997816397415671e-5
hoor,4,girl,0,4,1.1997816397415671e-5
hunni,4,girl,1,5,1.4997270496769588e-5
ianthe,4,girl,0,4,1.1997816397415671e-5
iba,4,girl,0,4,1.1997816397415671e-5
iffah,4,girl,0,4,1.1997816397415671e-5
ijeoma,4,girl,0,4,1.1997816397415671e-5
ileana,4,girl,0,4,1.1997816397415671e-5
ilithyia,4,girl,0,4,1.1997816397415671e-5
illiyeen,4,girl,0,4,1.1997816397415671e-5
ilma,4,girl,0,4,1.1997816397415671e-5
ilsa,4,girl,0,4,1.1997816397415671e-5
ilse,4,girl,0,4,1.1997816397415671e-5
imarah,4,girl,0,4,1.1997816397415671e-5
inaiya,4,girl,0,4,1.1997816397415671e-5
inarah,4,girl,0,4,1.1997816397415671e-5
inas,4,girl,0,4,1.1997816397415671e-5
indya,4,girl,0,4,1.1997816397415671e-5
inesa,4,girl,0,4,1.1997816397415671e-5
inola,4,girl,0,4,1.1997816397415671e-5
intisaar,4,girl,0,4,1.1997816397415671e-5
ionie,4,girl,0,4,1.1997816397415671e-5
iris-rose,4,girl,0,4,1.1997816397415671e-5
irisa,4,girl,0,4,1.1997816397415671e-5
isabelle-grace,4,girl,0,4,1.1997816397415671e-5
isbah,4,girl,0,4,1.1997816397415671e-5
iseult,4,girl,0,4,1.1997816397415671e-5
ishanvi,4,girl,1,5,1.4997270496769588e-5
ishita,4,girl,0,4,1.1997816397415671e-5
isla-,4,girl,0,4,1.1997816397415671e-5
isla-jane,4,girl,0,4,1.1997816397415671e-5
isla-lily,4,girl,0,4,1.1997816397415671e-5
islah,4,girl,0,4,1.1997816397415671e-5
ismay,4,girl,0,4,1.1997816397415671e-5
isobell,4,girl,0,4,1.1997816397415671e-5
israel,4,girl,0,4,1.1997816397415671e-5
israh,4,girl,0,4,1.1997816397415671e-5
izma,4,girl,0,4,1.1997816397415671e-5
izzi,4,girl,0,4,1.1997816397415671e-5
izzie,4,girl,0,4,1.1997816397415671e-5
jadzia,4,girl,0,4,1.1997816397415671e-5
jagna,4,girl,0,4,1.1997816397415671e-5
jainaba,4,girl,0,4,1.1997816397415671e-5
jamielee,4,girl,1,5,1.4997270496769588e-5
janai,4,girl,0,4,1.1997816397415671e-5
janat,4,girl,0,4,1.1997816397415671e-5
janey,4,girl,1,5,1.4997270496769588e-5
jaskirat,4,girl,0,4,1.1997816397415671e-5
jasmeen,4,girl,0,4,1.1997816397415671e-5
jaymie-leigh,4,girl,0,4,1.1997816397415671e-5
jazz,4,girl,0,4,1.1997816397415671e-5
jeanie,4,girl,1,5,1.4997270496769588e-5
jeeya,4,girl,0,4,1.1997816397415671e-5
jena,4,girl,1,5,1.4997270496769588e-5
jenara,4,girl,0,4,1.1997816397415671e-5
jenevieve,4,girl,0,4,1.1997816397415671e-5
jenica,4,girl,1,5,1.4997270496769588e-5
jenifer,4,girl,0,4,1.1997816397415671e-5
jenisha,4,girl,0,4,1.1997816397415671e-5
jersie,4,girl,1,5,1.4997270496769588e-5
jiana,4,girl,0,4,1.1997816397415671e-5
jimena,4,girl,0,4,1.1997816397415671e-5
jing,4,girl,1,5,1.4997270496769588e-5
jojo,4,girl,0,4,1.1997816397415671e-5
jordan,4,girl,0,4,1.1997816397415671e-5
jorgie-leigh,4,girl,0,4,1.1997816397415671e-5
jorgie-rae,4,girl,0,4,1.1997816397415671e-5
josefina,4,girl,0,4,1.1997816397415671e-5
josie-leigh,4,girl,0,4,1.1997816397415671e-5
joss,4,girl,1,5,1.4997270496769588e-5
josslyn,4,girl,0,4,1.1997816397415671e-5
joury,4,girl,0,4,1.1997816397415671e-5
jozefina,4,girl,0,4,1.1997816397415671e-5
juana,4,girl,0,4,1.1997816397415671e-5
julianne,4,girl,0,4,1.1997816397415671e-5
jumaymah,4,girl,0,4,1.1997816397415671e-5
juweriya,4,girl,0,4,1.1997816397415671e-5
jwana,4,girl,0,4,1.1997816397415671e-5
kacey-may,4,girl,1,5,1.4997270496769588e-5
kadisha,4,girl,0,4,1.1997816397415671e-5
kahlan,4,girl,0,4,1.1997816397415671e-5
kailah,4,girl,2,6,1.7996724596123505e-5
kailey,4,girl,0,4,1.1997816397415671e-5
kalli,4,girl,1,5,1.4997270496769588e-5
kamiya,4,girl,0,4,1.1997816397415671e-5
karishma,4,girl,0,4,1.1997816397415671e-5
katelin,4,girl,1,5,1.4997270496769588e-5
katey,4,girl,0,4,1.1997816397415671e-5
katriel,4,girl,0,4,1.1997816397415671e-5
katrin,4,girl,0,4,1.1997816397415671e-5
kavnoor,4,girl,0,4,1.1997816397415671e-5
kay,4,girl,1,5,1.4997270496769588e-5
kaydie,4,girl,3,7,2.0996178695477422e-5
kayla-mai,4,girl,0,4,1.1997816397415671e-5
kaylin,4,girl,1,5,1.4997270496769588e-5
keegan,4,girl,0,4,1.1997816397415671e-5
kehlani,4,girl,0,4,1.1997816397415671e-5
keiko,4,girl,0,4,1.1997816397415671e-5
kejsi,4,girl,0,4,1.1997816397415671e-5
kelise,4,girl,0,4,1.1997816397415671e-5
kelly-marie,4,girl,0,4,1.1997816397415671e-5
kelsey-leigh,4,girl,1,5,1.4997270496769588e-5
kenisha,4,girl,0,4,1.1997816397415671e-5
khadeja,4,girl,0,4,1.1997816397415671e-5
khairah,4,girl,0,4,1.1997816397415671e-5
khalisa,4,girl,0,4,1.1997816397415671e-5
khivi,4,girl,0,4,1.1997816397415671e-5
kieva,4,girl,1,5,1.4997270496769588e-5
kimia,4,girl,0,4,1.1997816397415671e-5
kiri,4,girl,0,4,1.1997816397415671e-5
kiswa,4,girl,0,4,1.1997816397415671e-5
kit,4,girl,0,4,1.1997816397415671e-5
klaudija,4,girl,0,4,1.1997816397415671e-5
krina,4,girl,0,4,1.1997816397415671e-5
kristin,4,girl,1,5,1.4997270496769588e-5
kulsuma,4,girl,0,4,1.1997816397415671e-5
kyla-mae,4,girl,0,4,1.1997816397415671e-5
kyler,4,girl,0,4,1.1997816397415671e-5
kyrie,4,girl,1,5,1.4997270496769588e-5
lacey-jane,4,girl,0,4,1.1997816397415671e-5
lacey-lou,4,girl,0,4,1.1997816397415671e-5
lacie-leigh,4,girl,1,5,1.4997270496769588e-5
lacie-rae,4,girl,0,4,1.1997816397415671e-5
lahna,4,girl,0,4,1.1997816397415671e-5
laia,4,girl,1,5,1.4997270496769588e-5
laila-mai,4,girl,0,4,1.1997816397415671e-5
laila-may,4,girl,0,4,1.1997816397415671e-5
laiya,4,girl,1,5,1.4997270496769588e-5
lanai,4,girl,0,4,1.1997816397415671e-5
larayah,4,girl,0,4,1.1997816397415671e-5
larni,4,girl,0,4,1.1997816397415671e-5
larnie,4,girl,0,4,1.1997816397415671e-5
larosa,4,girl,0,4,1.1997816397415671e-5
laveah,4,girl,0,4,1.1997816397415671e-5
laycey,4,girl,0,4,1.1997816397415671e-5
laynee,4,girl,0,4,1.1997816397415671e-5
le,4,girl,0,4,1.1997816397415671e-5
leah-mae,4,girl,0,4,1.1997816397415671e-5
leah-marie,4,girl,0,4,1.1997816397415671e-5
leea,4,girl,0,4,1.1997816397415671e-5
leiarna,4,girl,0,4,1.1997816397415671e-5
leila-mae,4,girl,0,4,1.1997816397415671e-5
lenaya,4,girl,0,4,1.1997816397415671e-5
lenna,4,girl,0,4,1.1997816397415671e-5
leola,4,girl,0,4,1.1997816397415671e-5
leonore,4,girl,0,4,1.1997816397415671e-5
lerryn,4,girl,0,4,1.1997816397415671e-5
lexi-marie,4,girl,1,5,1.4997270496769588e-5
lexxi,4,girl,1,5,1.4997270496769588e-5
leyana,4,girl,0,4,1.1997816397415671e-5
li,4,girl,0,4,1.1997816397415671e-5
liah,4,girl,1,5,1.4997270496769588e-5
lianne,4,girl,0,4,1.1997816397415671e-5
liat,4,girl,0,4,1.1997816397415671e-5
libbie-mae,4,girl,0,4,1.1997816397415671e-5
libby-rose,4,girl,0,4,1.1997816397415671e-5
lielle,4,girl,0,4,1.1997816397415671e-5
liesel,4,girl,1,5,1.4997270496769588e-5
lijana,4,girl,0,4,1.1997816397415671e-5
lilac,4,girl,0,4,1.1997816397415671e-5
lili-rose,4,girl,0,4,1.1997816397415671e-5
lillith,4,girl,2,6,1.7996724596123505e-5
lilly-,4,girl,0,4,1.1997816397415671e-5
lilly-jayne,4,girl,0,4,1.1997816397415671e-5
lilly-jean,4,girl,0,4,1.1997816397415671e-5
lilly-louise,4,girl,1,5,1.4997270496769588e-5
lily-beth,4,girl,1,5,1.4997270496769588e-5
lily-jay,4,girl,0,4,1.1997816397415671e-5
lin,4,girl,0,4,1.1997816397415671e-5
linh,4,girl,0,4,1.1997816397415671e-5
liyaanah,4,girl,0,4,1.1997816397415671e-5
liz,4,girl,0,4,1.1997816397415671e-5
lola-jo,4,girl,0,4,1.1997816397415671e-5
lolita,4,girl,0,4,1.1997816397415671e-5
loredana,4,girl,0,4,1.1997816397415671e-5
lorenza,4,girl,0,4,1.1997816397415671e-5
louisianna,4,girl,0,4,1.1997816397415671e-5
loveday,4,girl,1,5,1.4997270496769588e-5
luchia,4,girl,0,4,1.1997816397415671e-5
lucienne,4,girl,0,4,1.1997816397415671e-5
lucy-louise,4,girl,0,4,1.1997816397415671e-5
lujza,4,girl,0,4,1.1997816397415671e-5
luna-belle,4,girl,0,4,1.1997816397415671e-5
lya,4,girl,0,4,1.1997816397415671e-5
lyana,4,girl,0,4,1.1997816397415671e-5
lyanna,4,girl,1,5,1.4997270496769588e-5
lylah-rose,4,girl,0,4,1.1997816397415671e-5
lyrah,4,girl,0,4,1.1997816397415671e-5
lyssia,4,girl,0,4,1.1997816397415671e-5
maanvi,4,girl,0,4,1.1997816397415671e-5
macey-leigh,4,girl,0,4,1.1997816397415671e-5
macey-may,4,girl,0,4,1.1997816397415671e-5
maci-rose,4,girl,0,4,1.1997816397415671e-5
macie-rae,4,girl,0,4,1.1997816397415671e-5
maddalena,4,girl,1,5,1.4997270496769588e-5
maddison-grace,4,girl,0,4,1.1997816397415671e-5
maddison-leigh,4,girl,0,4,1.1997816397415671e-5
mahenoor,4,girl,0,4,1.1997816397415671e-5
mahiya,4,girl,0,4,1.1997816397415671e-5
mahnaz,4,girl,0,4,1.1997816397415671e-5
maiah,4,girl,0,4,1.1997816397415671e-5
maisie-ann,4,girl,0,4,1.1997816397415671e-5
majka,4,girl,2,6,1.7996724596123505e-5
makanaka,4,girl,1,5,1.4997270496769588e-5
malala,4,girl,0,4,1.1997816397415671e-5
malayka,4,girl,0,4,1.1997816397415671e-5
maleah,4,girl,0,4,1.1997816397415671e-5
malina,4,girl,1,5,1.4997270496769588e-5
malissa,4,girl,0,4,1.1997816397415671e-5
mamie,4,girl,0,4,1.1997816397415671e-5
manna,4,girl,0,4,1.1997816397415671e-5
mansimran,4,girl,0,4,1.1997816397415671e-5
mante,4,girl,0,4,1.1997816397415671e-5
maraya,4,girl,0,4,1.1997816397415671e-5
marisol,4,girl,0,4,1.1997816397415671e-5
marium,4,girl,0,4,1.1997816397415671e-5
marjan,4,girl,0,4,1.1997816397415671e-5
marjorie,4,girl,0,4,1.1997816397415671e-5
marney,4,girl,1,5,1.4997270496769588e-5
mary-ann,4,girl,0,4,1.1997816397415671e-5
maryanne,4,girl,2,6,1.7996724596123505e-5
maryellen,4,girl,0,4,1.1997816397415671e-5
masa,4,girl,1,5,1.4997270496769588e-5
masha,4,girl,0,4,1.1997816397415671e-5
masooma,4,girl,0,4,1.1997816397415671e-5
massa,4,girl,0,4,1.1997816397415671e-5
matilda-mae,4,girl,0,4,1.1997816397415671e-5
mattea,4,girl,0,4,1.1997816397415671e-5
mavleen,4,girl,0,4,1.1997816397415671e-5
maycie,4,girl,0,4,1.1997816397415671e-5
maysam,4,girl,0,4,1.1997816397415671e-5
meelah,4,girl,1,5,1.4997270496769588e-5
mehnaz,4,girl,0,4,1.1997816397415671e-5
meklit,4,girl,0,4,1.1997816397415671e-5
melat,4,girl,0,4,1.1997816397415671e-5
melike,4,girl,0,4,1.1997816397415671e-5
menahil,4,girl,0,4,1.1997816397415671e-5
meri,4,girl,0,4,1.1997816397415671e-5
merrin,4,girl,0,4,1.1997816397415671e-5
meta,4,girl,1,5,1.4997270496769588e-5
mia-faith,4,girl,0,4,1.1997816397415671e-5
mia-mai,4,girl,0,4,1.1997816397415671e-5
micaiah,4,girl,0,4,1.1997816397415671e-5
mickayla,4,girl,0,4,1.1997816397415671e-5
miesha,4,girl,0,4,1.1997816397415671e-5
mija,4,girl,1,5,1.4997270496769588e-5
milcah,4,girl,0,4,1.1997816397415671e-5
mileena,4,girl,0,4,1.1997816397415671e-5
mileta,4,girl,0,4,1.1997816397415671e-5
miley-mae,4,girl,0,4,1.1997816397415671e-5
millie-ann,4,girl,1,5,1.4997270496769588e-5
millie-louise,4,girl,0,4,1.1997816397415671e-5
milly-may,4,girl,0,4,1.1997816397415671e-5
milly-rose,4,girl,0,4,1.1997816397415671e-5
minahal,4,girl,0,4,1.1997816397415671e-5
minal,4,girl,0,4,1.1997816397415671e-5
mireille,4,girl,0,4,1.1997816397415671e-5
miren,4,girl,1,5,1.4997270496769588e-5
mishall,4,girl,0,4,1.1997816397415671e-5
mithra,4,girl,0,4,1.1997816397415671e-5
mitzi,4,girl,0,4,1.1997816397415671e-5
miyah-rose,4,girl,0,4,1.1997816397415671e-5
mollie-ann,4,girl,0,4,1.1997816397415671e-5
molly-ann,4,girl,0,4,1.1997816397415671e-5
molly-anne,4,girl,0,4,1.1997816397415671e-5
molly-rae,4,girl,0,4,1.1997816397415671e-5
moriah,4,girl,0,4,1.1997816397415671e-5
motunrayo,4,girl,1,5,1.4997270496769588e-5
moya,4,girl,1,5,1.4997270496769588e-5
mumina,4,girl,0,4,1.1997816397415671e-5
munachimso,4,girl,0,4,1.1997816397415671e-5
mya-may,4,girl,0,4,1.1997816397415671e-5
mya-rae,4,girl,0,4,1.1997816397415671e-5
myesha,4,girl,0,4,1.1997816397415671e-5
myla-mae,4,girl,0,4,1.1997816397415671e-5
nabeela,4,girl,0,4,1.1997816397415671e-5
nadiyah,4,girl,0,4,1.1997816397415671e-5
nadra,4,girl,0,4,1.1997816397415671e-5
nafisah,4,girl,1,5,1.4997270496769588e-5
nahida,4,girl,0,4,1.1997816397415671e-5
nahiya,4,girl,0,4,1.1997816397415671e-5
najah,4,girl,1,5,1.4997270496769588e-5
najla,4,girl,0,4,1.1997816397415671e-5
nakshatra,4,girl,0,4,1.1997816397415671e-5
namira,4,girl,0,4,1.1997816397415671e-5
nancee,4,girl,0,4,1.1997816397415671e-5
nancy-leigh,4,girl,0,4,1.1997816397415671e-5
nancy-mae,4,girl,0,4,1.1997816397415671e-5
narcisa,4,girl,0,4,1.1997816397415671e-5
natali,4,girl,0,4,1.1997816397415671e-5
nathaly,4,girl,0,4,1.1997816397415671e-5
navisha,4,girl,0,4,1.1997816397415671e-5
navneet,4,girl,0,4,1.1997816397415671e-5
navy,4,girl,0,4,1.1997816397415671e-5
nayara,4,girl,0,4,1.1997816397415671e-5
nayeli,4,girl,0,4,1.1997816397415671e-5
neevah,4,girl,0,4,1.1997816397415671e-5
neiva,4,girl,1,5,1.4997270496769588e-5
nellie-rose,4,girl,0,4,1.1997816397415671e-5
nepheli,4,girl,0,4,1.1997816397415671e-5
nerissa,4,girl,0,4,1.1997816397415671e-5
neriyah,4,girl,0,4,1.1997816397415671e-5
nevaeh-faith,4,girl,0,4,1.1997816397415671e-5
nevaeh-may,4,girl,0,4,1.1997816397415671e-5
nevaya,4,girl,0,4,1.1997816397415671e-5
ngoc,4,girl,0,4,1.1997816397415671e-5
nira,4,girl,1,5,1.4997270496769588e-5
niyati,4,girl,1,5,1.4997270496769588e-5
nneka,4,girl,0,4,1.1997816397415671e-5
nnenna,4,girl,0,4,1.1997816397415671e-5
novella,4,girl,0,4,1.1997816397415671e-5
nurat,4,girl,0,4,1.1997816397415671e-5
nylah-rose,4,girl,0,4,1.1997816397415671e-5
nyree,4,girl,0,4,1.1997816397415671e-5
oaklie,4,girl,0,4,1.1997816397415671e-5
oceanna,4,girl,0,4,1.1997816397415671e-5
odelia,4,girl,0,4,1.1997816397415671e-5
ofelia,4,girl,1,5,1.4997270496769588e-5
olivia-jane,4,girl,2,6,1.7996724596123505e-5
olivia-louise,4,girl,0,4,1.1997816397415671e-5
oluwasemilore,4,girl,0,4,1.1997816397415671e-5
omaira,4,girl,0,4,1.1997816397415671e-5
ophelie,4,girl,0,4,1.1997816397415671e-5
orla-grace,4,girl,0,4,1.1997816397415671e-5
ornela,4,girl,0,4,1.1997816397415671e-5
ostara,4,girl,0,4,1.1997816397415671e-5
oumou,4,girl,0,4,1.1997816397415671e-5
pagan,4,girl,0,4,1.1997816397415671e-5
paisley-may,4,girl,0,4,1.1997816397415671e-5
palwasha,4,girl,0,4,1.1997816397415671e-5
paola,4,girl,0,4,1.1997816397415671e-5
paraskevi,4,girl,0,4,1.1997816397415671e-5
parmis,4,girl,0,4,1.1997816397415671e-5
pavleen,4,girl,0,4,1.1997816397415671e-5
penina,4,girl,0,4,1.1997816397415671e-5
perdita,4,girl,0,4,1.1997816397415671e-5
pessy,4,girl,0,4,1.1997816397415671e-5
peyton-leigh,4,girl,0,4,1.1997816397415671e-5
phia,4,girl,0,4,1.1997816397415671e-5
phillippa,4,girl,0,4,1.1997816397415671e-5
phoebe-ann,4,girl,0,4,1.1997816397415671e-5
phoebe-jane,4,girl,0,4,1.1997816397415671e-5
phoebe-may,4,girl,0,4,1.1997816397415671e-5
phoebe-rae,4,girl,0,4,1.1997816397415671e-5
phoenix-rose,4,girl,0,4,1.1997816397415671e-5
pietra,4,girl,0,4,1.1997816397415671e-5
pihu,4,girl,0,4,1.1997816397415671e-5
piper-rae,4,girl,0,4,1.1997816397415671e-5
pippa-mae,4,girl,1,5,1.4997270496769588e-5
pixie-rose,4,girl,0,4,1.1997816397415671e-5
pooja,4,girl,0,4,1.1997816397415671e-5
poppie-mai,4,girl,0,4,1.1997816397415671e-5
poppy-jane,4,girl,1,5,1.4997270496769588e-5
poppy-jean,4,girl,0,4,1.1997816397415671e-5
poppy-jo,4,girl,0,4,1.1997816397415671e-5
poppy-marie,4,girl,0,4,1.1997816397415671e-5
pranika,4,girl,0,4,1.1997816397415671e-5
preesha,4,girl,1,5,1.4997270496769588e-5
preya,4,girl,0,4,1.1997816397415671e-5
priyana,4,girl,0,4,1.1997816397415671e-5
priyanshi,4,girl,0,4,1.1997816397415671e-5
purdy,4,girl,0,4,1.1997816397415671e-5
purity,4,girl,1,5,1.4997270496769588e-5
queen,4,girl,0,4,1.1997816397415671e-5
racheal,4,girl,1,5,1.4997270496769588e-5
rada,4,girl,0,4,1.1997816397415671e-5
radhika,4,girl,0,4,1.1997816397415671e-5
raene,4,girl,0,4,1.1997816397415671e-5
rafeef,4,girl,0,4,1.1997816397415671e-5
raheel,4,girl,0,4,1.1997816397415671e-5
rahima,4,girl,0,4,1.1997816397415671e-5
raigan,4,girl,0,4,1.1997816397415671e-5
raiha,4,girl,0,4,1.1997816397415671e-5
rajana,4,girl,0,4,1.1997816397415671e-5
raksha,4,girl,0,4,1.1997816397415671e-5
ramiyah,4,girl,0,4,1.1997816397415671e-5
randa,4,girl,1,5,1.4997270496769588e-5
raniya,4,girl,0,4,1.1997816397415671e-5
raquel,4,girl,0,4,1.1997816397415671e-5
raseel,4,girl,0,4,1.1997816397415671e-5
rawda,4,girl,0,4,1.1997816397415671e-5
rayana,4,girl,0,4,1.1997816397415671e-5
rayha,4,girl,0,4,1.1997816397415671e-5
raysa,4,girl,0,4,1.1997816397415671e-5
rayssa,4,girl,0,4,1.1997816397415671e-5
rebecka,4,girl,0,4,1.1997816397415671e-5
reggie,4,girl,0,4,1.1997816397415671e-5
reham,4,girl,0,4,1.1997816397415671e-5
reilly,4,girl,0,4,1.1997816397415671e-5
reiva,4,girl,0,4,1.1997816397415671e-5
remas,4,girl,0,4,1.1997816397415671e-5
remaya,4,girl,0,4,1.1997816397415671e-5
renaiya,4,girl,0,4,1.1997816397415671e-5
renay,4,girl,0,4,1.1997816397415671e-5
reni,4,girl,2,6,1.7996724596123505e-5
rhoda,4,girl,0,4,1.1997816397415671e-5
rianne,4,girl,0,4,1.1997816397415671e-5
ridha,4,girl,0,4,1.1997816397415671e-5
ridhima,4,girl,0,4,1.1997816397415671e-5
riga,4,girl,0,4,1.1997816397415671e-5
rihana,4,girl,0,4,1.1997816397415671e-5
riley-rose,4,girl,0,4,1.1997816397415671e-5
rimsha,4,girl,1,5,1.4997270496769588e-5
rital,4,girl,0,4,1.1997816397415671e-5
river-lea,4,girl,0,4,1.1997816397415671e-5
river-rae,4,girl,0,4,1.1997816397415671e-5
rivkah,4,girl,0,4,1.1997816397415671e-5
riyan,4,girl,0,4,1.1997816397415671e-5
riyana,4,girl,0,4,1.1997816397415671e-5
rizwana,4,girl,0,4,1.1997816397415671e-5
robyn-rose,4,girl,0,4,1.1997816397415671e-5
rochel,4,girl,0,4,1.1997816397415671e-5
roman,4,girl,0,4,1.1997816397415671e-5
romanie,4,girl,0,4,1.1997816397415671e-5
romaysa,4,girl,0,4,1.1997816397415671e-5
rome,4,girl,0,4,1.1997816397415671e-5
romily,4,girl,0,4,1.1997816397415671e-5
romina,4,girl,0,4,1.1997816397415671e-5
rori,4,girl,0,4,1.1997816397415671e-5
rosalina,4,girl,1,5,1.4997270496769588e-5
rosaria,4,girl,0,4,1.1997816397415671e-5
rosie-rae,4,girl,0,4,1.1997816397415671e-5
rosita,4,girl,0,4,1.1997816397415671e-5
rubab,4,girl,0,4,1.1997816397415671e-5
rubee,4,girl,0,4,1.1997816397415671e-5
rubie-rose,4,girl,0,4,1.1997816397415671e-5
ruby-jo,4,girl,0,4,1.1997816397415671e-5
ruby-lee,4,girl,0,4,1.1997816397415671e-5
ruby-marie,4,girl,1,5,1.4997270496769588e-5
ruhika,4,girl,0,4,1.1997816397415671e-5
rukayya,4,girl,0,4,1.1997816397415671e-5
rukia,4,girl,0,4,1.1997816397415671e-5
rumeysa,4,girl,0,4,1.1997816397415671e-5
ruwaydah,4,girl,0,4,1.1997816397415671e-5
ryah,4,girl,1,5,1.4997270496769588e-5
rylea,4,girl,0,4,1.1997816397415671e-5
ryley,4,girl,1,5,1.4997270496769588e-5
saadiya,4,girl,0,4,1.1997816397415671e-5
saaya,4,girl,0,4,1.1997816397415671e-5
sabaa,4,girl,0,4,1.1997816397415671e-5
sabirah,4,girl,0,4,1.1997816397415671e-5
sabirin,4,girl,0,4,1.1997816397415671e-5
sadhbh,4,girl,0,4,1.1997816397415671e-5
sahab,4,girl,0,4,1.1997816397415671e-5
sajidah,4,girl,0,4,1.1997816397415671e-5
saleena,4,girl,0,4,1.1997816397415671e-5
salem,4,girl,0,4,1.1997816397415671e-5
salmah,4,girl,0,4,1.1997816397415671e-5
samina,4,girl,0,4,1.1997816397415671e-5
samuela,4,girl,0,4,1.1997816397415671e-5
samuella,4,girl,0,4,1.1997816397415671e-5
sanah,4,girl,0,4,1.1997816397415671e-5
saniyah,4,girl,0,4,1.1997816397415671e-5
saran,4,girl,0,4,1.1997816397415671e-5
sarayah,4,girl,0,4,1.1997816397415671e-5
sari,4,girl,0,4,1.1997816397415671e-5
saroop,4,girl,0,4,1.1997816397415671e-5
scarlett-marie,4,girl,0,4,1.1997816397415671e-5
seanna,4,girl,1,5,1.4997270496769588e-5
selihom,4,girl,0,4,1.1997816397415671e-5
sephora,4,girl,0,4,1.1997816397415671e-5
sera,4,girl,0,4,1.1997816397415671e-5
serah,4,girl,0,4,1.1997816397415671e-5
seraya,4,girl,0,4,1.1997816397415671e-5
seren-rose,4,girl,0,4,1.1997816397415671e-5
shaden,4,girl,0,4,1.1997816397415671e-5
shadia,4,girl,0,4,1.1997816397415671e-5
shai,4,girl,0,4,1.1997816397415671e-5
shamiso,4,girl,0,4,1.1997816397415671e-5
shanai,4,girl,0,4,1.1997816397415671e-5
shanela,4,girl,0,4,1.1997816397415671e-5
shani,4,girl,0,4,1.1997816397415671e-5
shaniah,4,girl,0,4,1.1997816397415671e-5
shanika,4,girl,0,4,1.1997816397415671e-5
shara,4,girl,1,5,1.4997270496769588e-5
sheindel,4,girl,0,4,1.1997816397415671e-5
sheindy,4,girl,0,4,1.1997816397415671e-5
shianne,4,girl,0,4,1.1997816397415671e-5
shloka,4,girl,0,4,1.1997816397415671e-5
shruthi,4,girl,0,4,1.1997816397415671e-5
shruti,4,girl,0,4,1.1997816397415671e-5
shyanne,4,girl,0,4,1.1997816397415671e-5
sieanna,4,girl,0,4,1.1997816397415671e-5
sienna-grace,4,girl,0,4,1.1997816397415671e-5
sienna-leigh,4,girl,0,4,1.1997816397415671e-5
sienna-lily,4,girl,0,4,1.1997816397415671e-5
sienna-marie,4,girl,0,4,1.1997816397415671e-5
signe,4,girl,2,6,1.7996724596123505e-5
silka,4,girl,0,4,1.1997816397415671e-5
simina,4,girl,0,4,1.1997816397415671e-5
sinit,4,girl,0,4,1.1997816397415671e-5
sirine,4,girl,0,4,1.1997816397415671e-5
siwan,4,girl,0,4,1.1997816397415671e-5
skye-marie,4,girl,0,4,1.1997816397415671e-5
skye-rose,4,girl,0,4,1.1997816397415671e-5
skylar-may,4,girl,0,4,1.1997816397415671e-5
sneha,4,girl,0,4,1.1997816397415671e-5
sofia-grace,4,girl,0,4,1.1997816397415671e-5
sofiyah,4,girl,0,4,1.1997816397415671e-5
soleil,4,girl,0,4,1.1997816397415671e-5
solin,4,girl,1,5,1.4997270496769588e-5
solomia,4,girl,0,4,1.1997816397415671e-5
soma,4,girl,0,4,1.1997816397415671e-5
sona,4,girl,0,4,1.1997816397415671e-5
sorayah,4,girl,0,4,1.1997816397415671e-5
srinika,4,girl,1,5,1.4997270496769588e-5
stacy,4,girl,0,4,1.1997816397415671e-5
stela,4,girl,1,5,1.4997270496769588e-5
stevi,4,girl,0,4,1.1997816397415671e-5
suhaavi,4,girl,0,4,1.1997816397415671e-5
suhaila,4,girl,0,4,1.1997816397415671e-5
sula,4,girl,0,4,1.1997816397415671e-5
sumaira,4,girl,0,4,1.1997816397415671e-5
summer-grace,4,girl,0,4,1.1997816397415671e-5
suranne,4,girl,0,4,1.1997816397415671e-5
sureya,4,girl,0,4,1.1997816397415671e-5
surveen,4,girl,0,4,1.1997816397415671e-5
swyn,4,girl,0,4,1.1997816397415671e-5
szofia,4,girl,0,4,1.1997816397415671e-5
tabassum,4,girl,0,4,1.1997816397415671e-5
tahiya,4,girl,0,4,1.1997816397415671e-5
tahiyah,4,girl,0,4,1.1997816397415671e-5
taia,4,girl,1,5,1.4997270496769588e-5
taja,4,girl,0,4,1.1997816397415671e-5
tali,4,girl,0,4,1.1997816397415671e-5
tamina,4,girl,1,5,1.4997270496769588e-5
taraji,4,girl,0,4,1.1997816397415671e-5
taseefa,4,girl,0,4,1.1997816397415671e-5
tasfia,4,girl,0,4,1.1997816397415671e-5
tasia,4,girl,0,4,1.1997816397415671e-5
taslima,4,girl,0,4,1.1997816397415671e-5
tasnia,4,girl,0,4,1.1997816397415671e-5
tatyana,4,girl,0,4,1.1997816397415671e-5
tayah-rose,4,girl,0,4,1.1997816397415671e-5
taylor-mae,4,girl,0,4,1.1997816397415671e-5
taymiyyah,4,girl,0,4,1.1997816397415671e-5
teal,4,girl,0,4,1.1997816397415671e-5
teanna,4,girl,0,4,1.1997816397415671e-5
teniola,4,girl,0,4,1.1997816397415671e-5
teona,4,girl,0,4,1.1997816397415671e-5
teyana,4,girl,0,4,1.1997816397415671e-5
thea-louise,4,girl,0,4,1.1997816397415671e-5
thelma,4,girl,0,4,1.1997816397415671e-5
thomasina,4,girl,0,4,1.1997816397415671e-5
tia-may,4,girl,0,4,1.1997816397415671e-5
tiana-rose,4,girl,0,4,1.1997816397415671e-5
tianna-rose,4,girl,0,4,1.1997816397415671e-5
tienna,4,girl,0,4,1.1997816397415671e-5
tillie-anne,4,girl,0,4,1.1997816397415671e-5
tillie-mai,4,girl,0,4,1.1997816397415671e-5
tilly-rae,4,girl,0,4,1.1997816397415671e-5
tisha,4,girl,0,4,1.1997816397415671e-5
tiyana,4,girl,0,4,1.1997816397415671e-5
tooba,4,girl,0,4,1.1997816397415671e-5
tove,4,girl,1,5,1.4997270496769588e-5
tracy,4,girl,1,5,1.4997270496769588e-5
treasure,4,girl,0,4,1.1997816397415671e-5
trudie,4,girl,0,4,1.1997816397415671e-5
tuana,4,girl,0,4,1.1997816397415671e-5
twisha,4,girl,0,4,1.1997816397415671e-5
tyler,4,girl,1,5,1.4997270496769588e-5
tzivia,4,girl,0,4,1.1997816397415671e-5
uchechi,4,girl,0,4,1.1997816397415671e-5
ula,4,girl,2,6,1.7996724596123505e-5
umairah,4,girl,0,4,1.1997816397415671e-5
umayrah,4,girl,0,4,1.1997816397415671e-5
ummul,4,girl,0,4,1.1997816397415671e-5
unaysa,4,girl,0,4,1.1997816397415671e-5
urooj,4,girl,0,4,1.1997816397415671e-5
uswah,4,girl,0,4,1.1997816397415671e-5
vada,4,girl,1,5,1.4997270496769588e-5
vaida,4,girl,0,4,1.1997816397415671e-5
vanda,4,girl,0,4,1.1997816397415671e-5
varisha,4,girl,0,4,1.1997816397415671e-5
varsha,4,girl,0,4,1.1997816397415671e-5
varvara,4,girl,0,4,1.1997816397415671e-5
victory,4,girl,0,4,1.1997816397415671e-5
vina,4,girl,0,4,1.1997816397415671e-5
vita,4,girl,0,4,1.1997816397415671e-5
vivi,4,girl,0,4,1.1997816397415671e-5
vivianne,4,girl,0,4,1.1997816397415671e-5
wanda,4,girl,1,5,1.4997270496769588e-5
warda,4,girl,0,4,1.1997816397415671e-5
willow-faith,4,girl,0,4,1.1997816397415671e-5
willow-rae,4,girl,1,5,1.4997270496769588e-5
wuraola,4,girl,0,4,1.1997816397415671e-5
xuan,4,girl,0,4,1.1997816397415671e-5
yameena,4,girl,0,4,1.1997816397415671e-5
yehudis,4,girl,0,4,1.1997816397415671e-5
yuvika,4,girl,0,4,1.1997816397415671e-5
zahaa,4,girl,0,4,1.1997816397415671e-5
zaheen,4,girl,0,4,1.1997816397415671e-5
zaida,4,girl,0,4,1.1997816397415671e-5
zaineb,4,girl,0,4,1.1997816397415671e-5
zaiya,4,girl,0,4,1.1997816397415671e-5
zakiya,4,girl,0,4,1.1997816397415671e-5
zala,4,girl,0,4,1.1997816397415671e-5
zara-rose,4,girl,1,5,1.4997270496769588e-5
zayba,4,girl,0,4,1.1997816397415671e-5
zeen,4,girl,0,4,1.1997816397415671e-5
zemira,4,girl,0,4,1.1997816397415671e-5
zeyna,4,girl,1,5,1.4997270496769588e-5
zeyneb,4,girl,0,4,1.1997816397415671e-5
zhi,4,girl,0,4,1.1997816397415671e-5
ziggy,4,girl,1,5,1.4997270496769588e-5
zissy,4,girl,0,4,1.1997816397415671e-5
zora,4,girl,0,4,1.1997816397415671e-5
zorka,4,girl,0,4,1.1997816397415671e-5
zuha,4,girl,0,4,1.1997816397415671e-5
zuriel,4,girl,1,5,1.4997270496769588e-5
zuzia,4,girl,0,4,1.1997816397415671e-5
a'niyah,3,girl,0,3,8.998362298061752e-6
aadilah,3,girl,0,3,8.998362298061752e-6
aaditri,3,girl,0,3,8.998362298061752e-6
aaeesha,3,girl,0,3,8.998362298061752e-6
aaidah,3,girl,0,3,8.998362298061752e-6
aalaa,3,girl,0,3,8.998362298061752e-6
aalimah,3,girl,0,3,8.998362298061752e-6
aaliyah-grace,3,girl,0,3,8.998362298061752e-6
aamaal,3,girl,0,3,8.998362298061752e-6
aamaya,3,girl,0,3,8.998362298061752e-6
aamirah,3,girl,1,4,1.1997816397415671e-5
aamnah,3,girl,0,3,8.998362298061752e-6
aania,3,girl,0,3,8.998362298061752e-6
aarini,3,girl,0,3,8.998362298061752e-6
aashni,3,girl,0,3,8.998362298061752e-6
aayath,3,girl,0,3,8.998362298061752e-6
aayushi,3,girl,0,3,8.998362298061752e-6
abbie-rose,3,girl,2,5,1.4997270496769588e-5
abby-rose,3,girl,0,3,8.998362298061752e-6
abbygail,3,girl,0,3,8.998362298061752e-6
abeedah,3,girl,0,3,8.998362298061752e-6
abeer,3,girl,0,3,8.998362298061752e-6
abeerah,3,girl,0,3,8.998362298061752e-6
abinaya,3,girl,0,3,8.998362298061752e-6
abir,3,girl,0,3,8.998362298061752e-6
abisola,3,girl,0,3,8.998362298061752e-6
acelya,3,girl,0,3,8.998362298061752e-6
adalia,3,girl,0,3,8.998362298061752e-6
adalie,3,girl,0,3,8.998362298061752e-6
addalyn,3,girl,0,3,8.998362298061752e-6
addisyn,3,girl,1,4,1.1997816397415671e-5
adelia,3,girl,0,3,8.998362298061752e-6
adelle,3,girl,0,3,8.998362298061752e-6
ademide,3,girl,0,3,8.998362298061752e-6
aderyn,3,girl,0,3,8.998362298061752e-6
adesuwa,3,girl,0,3,8.998362298061752e-6
adia,3,girl,0,3,8.998362298061752e-6
adibah,3,girl,0,3,8.998362298061752e-6
adonia,3,girl,0,3,8.998362298061752e-6
adriel,3,girl,0,3,8.998362298061752e-6
adrijana,3,girl,1,4,1.1997816397415671e-5
advita,3,girl,0,3,8.998362298061752e-6
aesha,3,girl,0,3,8.998362298061752e-6
afifah,3,girl,0,3,8.998362298061752e-6
afrah,3,girl,0,3,8.998362298061752e-6
afrin,3,girl,0,3,8.998362298061752e-6
afsana,3,girl,0,3,8.998362298061752e-6
agape,3,girl,0,3,8.998362298061752e-6
aggeliki,3,girl,0,3,8.998362298061752e-6
agota,3,girl,0,3,8.998362298061752e-6
aia,3,girl,0,3,8.998362298061752e-6
aideen,3,girl,0,3,8.998362298061752e-6
aiden,3,girl,0,3,8.998362298061752e-6
ailie,3,girl,5,8,2.3995632794831342e-5
aimie,3,girl,1,4,1.1997816397415671e-5
aisa,3,girl,0,3,8.998362298061752e-6
aitana,3,girl,0,3,8.998362298061752e-6
akilah,3,girl,0,3,8.998362298061752e-6
aksara,3,girl,0,3,8.998362298061752e-6
alaana,3,girl,0,3,8.998362298061752e-6
alahna,3,girl,0,3,8.998362298061752e-6
alana-rae,3,girl,0,3,8.998362298061752e-6
alanoud,3,girl,0,3,8.998362298061752e-6
alanta,3,girl,0,3,8.998362298061752e-6
alarah,3,girl,2,5,1.4997270496769588e-5
alaria,3,girl,0,3,8.998362298061752e-6
alayha,3,girl,0,3,8.998362298061752e-6
aleemah,3,girl,1,4,1.1997816397415671e-5
aleenah,3,girl,0,3,8.998362298061752e-6
alegra,3,girl,1,4,1.1997816397415671e-5
aleina,3,girl,0,3,8.998362298061752e-6
alejandra,3,girl,0,3,8.998362298061752e-6
aleksa,3,girl,0,3,8.998362298061752e-6
alesha-rose,3,girl,0,3,8.998362298061752e-6
alessia-maria,3,girl,0,3,8.998362298061752e-6
alev,3,girl,0,3,8.998362298061752e-6
alexa-may,3,girl,0,3,8.998362298061752e-6
alexandrea,3,girl,1,4,1.1997816397415671e-5
alexiah,3,girl,0,3,8.998362298061752e-6
alexis-may,3,girl,0,3,8.998362298061752e-6
alexsandra,3,girl,0,3,8.998362298061752e-6
alfiya,3,girl,0,3,8.998362298061752e-6
alice-ann,3,girl,0,3,8.998362298061752e-6
alice-may,3,girl,0,3,8.998362298061752e-6
alicia-mae,3,girl,0,3,8.998362298061752e-6
alicia-marie,3,girl,0,3,8.998362298061752e-6
alifiya,3,girl,0,3,8.998362298061752e-6
alishia,3,girl,0,3,8.998362298061752e-6
alisson,3,girl,0,3,8.998362298061752e-6
aliyah-grace,3,girl,1,4,1.1997816397415671e-5
aliye,3,girl,0,3,8.998362298061752e-6
aliza-mae,3,girl,0,3,8.998362298061752e-6
aliza-rae,3,girl,0,3,8.998362298061752e-6
alizay,3,girl,0,3,8.998362298061752e-6
alizey,3,girl,0,3,8.998362298061752e-6
allexis,3,girl,0,3,8.998362298061752e-6
alleyah,3,girl,0,3,8.998362298061752e-6
allia,3,girl,0,3,8.998362298061752e-6
alliana,3,girl,0,3,8.998362298061752e-6
allora,3,girl,0,3,8.998362298061752e-6
allyssia,3,girl,0,3,8.998362298061752e-6
almina,3,girl,0,3,8.998362298061752e-6
alreem,3,girl,0,3,8.998362298061752e-6
alveera,3,girl,0,3,8.998362298061752e-6
alyana,3,girl,0,3,8.998362298061752e-6
alyce,3,girl,0,3,8.998362298061752e-6
alyssia-rose,3,girl,0,3,8.998362298061752e-6
alyx,3,girl,1,4,1.1997816397415671e-5
alyzah,3,girl,0,3,8.998362298061752e-6
amanpreet,3,girl,0,3,8.998362298061752e-6
amarie,3,girl,0,3,8.998362298061752e-6
amarnie,3,girl,0,3,8.998362298061752e-6
amaya-rose,3,girl,0,3,8.998362298061752e-6
amayrah,3,girl,0,3,8.998362298061752e-6
amber-grace,3,girl,0,3,8.998362298061752e-6
amber-lilly,3,girl,0,3,8.998362298061752e-6
amber-marie,3,girl,0,3,8.998362298061752e-6
amber-may,3,girl,0,3,8.998362298061752e-6
amber-rae,3,girl,0,3,8.998362298061752e-6
ambika,3,girl,0,3,8.998362298061752e-6
ambreen,3,girl,0,3,8.998362298061752e-6
ameli,3,girl,0,3,8.998362298061752e-6
amelia-faith,3,girl,0,3,8.998362298061752e-6
amelia-hope,3,girl,0,3,8.998362298061752e-6
amelia-jean,3,girl,0,3,8.998362298061752e-6
amelia-lee,3,girl,0,3,8.998362298061752e-6
ameliyah,3,girl,0,3,8.998362298061752e-6
amelya,3,girl,1,4,1.1997816397415671e-5
amena,3,girl,0,3,8.998362298061752e-6
amiina,3,girl,0,3,8.998362298061752e-6
amillia,3,girl,0,3,8.998362298061752e-6
amillie,3,girl,0,3,8.998362298061752e-6
aminah-noor,3,girl,0,3,8.998362298061752e-6
amman,3,girl,0,3,8.998362298061752e-6
amorae,3,girl,0,3,8.998362298061752e-6
amore,3,girl,0,3,8.998362298061752e-6
amrutha,3,girl,0,3,8.998362298061752e-6
amya,3,girl,0,3,8.998362298061752e-6
ana-lucia,3,girl,0,3,8.998362298061752e-6
anabiyah,3,girl,0,3,8.998362298061752e-6
anaise,3,girl,0,3,8.998362298061752e-6
anaiss,3,girl,0,3,8.998362298061752e-6
analeigh,3,girl,0,3,8.998362298061752e-6
anamta,3,girl,0,3,8.998362298061752e-6
anarita,3,girl,0,3,8.998362298061752e-6
anastasiya,3,girl,0,3,8.998362298061752e-6
anastazia,3,girl,2,5,1.4997270496769588e-5
anaum,3,girl,1,4,1.1997816397415671e-5
anayah-rose,3,girl,0,3,8.998362298061752e-6
anayss,3,girl,0,3,8.998362298061752e-6
anda,3,girl,0,3,8.998362298061752e-6
andia,3,girl,0,3,8.998362298061752e-6
aneela,3,girl,0,3,8.998362298061752e-6
anesa,3,girl,0,3,8.998362298061752e-6
anette,3,girl,0,3,8.998362298061752e-6
anfa,3,girl,0,3,8.998362298061752e-6
angel-hope,3,girl,0,3,8.998362298061752e-6
angel-mae,3,girl,0,3,8.998362298061752e-6
angeliki,3,girl,0,3,8.998362298061752e-6
angelpreet,3,girl,0,3,8.998362298061752e-6
anjana,3,girl,0,3,8.998362298061752e-6
anjum,3,girl,0,3,8.998362298061752e-6
anna-mae,3,girl,0,3,8.998362298061752e-6
anna-marie,3,girl,0,3,8.998362298061752e-6
annalie,3,girl,1,4,1.1997816397415671e-5
annamaria,3,girl,0,3,8.998362298061752e-6
annamay,3,girl,0,3,8.998362298061752e-6
anneli,3,girl,1,4,1.1997816397415671e-5
annia,3,girl,0,3,8.998362298061752e-6
annie-lou,3,girl,0,3,8.998362298061752e-6
annija,3,girl,1,4,1.1997816397415671e-5
annis,3,girl,0,3,8.998362298061752e-6
anoop,3,girl,0,3,8.998362298061752e-6
ansharah,3,girl,0,3,8.998362298061752e-6
anthea,3,girl,2,5,1.4997270496769588e-5
anthi,3,girl,1,4,1.1997816397415671e-5
antonia-maria,3,girl,0,3,8.998362298061752e-6
anu,3,girl,0,3,8.998362298061752e-6
anuja,3,girl,0,3,8.998362298061752e-6
anwyn,3,girl,0,3,8.998362298061752e-6
anzal,3,girl,0,3,8.998362298061752e-6
aoibhe,3,girl,3,6,1.7996724596123505e-5
aoibheann,3,girl,0,3,8.998362298061752e-6
aoibhin,3,girl,0,3,8.998362298061752e-6
aoife-belle,3,girl,0,3,8.998362298061752e-6
aphia,3,girl,0,3,8.998362298061752e-6
april-rose,3,girl,0,3,8.998362298061752e-6
arabel,3,girl,1,4,1.1997816397415671e-5
archer,3,girl,0,3,8.998362298061752e-6
arella,3,girl,0,3,8.998362298061752e-6
aren,3,girl,0,3,8.998362298061752e-6
aretha,3,girl,0,3,8.998362298061752e-6
ariana-rose,3,girl,0,3,8.998362298061752e-6
arianna-rose,3,girl,0,3,8.998362298061752e-6
aribella,3,girl,0,3,8.998362298061752e-6
arija,3,girl,1,4,1.1997816397415671e-5
ariyanna,3,girl,1,4,1.1997816397415671e-5
arlene,3,girl,1,4,1.1997816397415671e-5
armita,3,girl,0,3,8.998362298061752e-6
arnika,3,girl,0,3,8.998362298061752e-6
arohi,3,girl,0,3,8.998362298061752e-6
arooba,3,girl,0,3,8.998362298061752e-6
arriana,3,girl,0,3,8.998362298061752e-6
arshdeep,3,girl,1,4,1.1997816397415671e-5
arshin,3,girl,0,3,8.998362298061752e-6
arshpreet,3,girl,0,3,8.998362298061752e-6
aryaa,3,girl,0,3,8.998362298061752e-6
asel,3,girl,0,3,8.998362298061752e-6
asena,3,girl,1,4,1.1997816397415671e-5
asenath,3,girl,0,3,8.998362298061752e-6
ashiya,3,girl,0,3,8.998362298061752e-6
ashly,3,girl,0,3,8.998362298061752e-6
ashmeen,3,girl,0,3,8.998362298061752e-6
ashna,3,girl,0,3,8.998362298061752e-6
ashni,3,girl,0,3,8.998362298061752e-6
ashwaq,3,girl,0,3,8.998362298061752e-6
asraa,3,girl,0,3,8.998362298061752e-6
assiya,3,girl,0,3,8.998362298061752e-6
astera,3,girl,0,3,8.998362298061752e-6
astra,3,girl,0,3,8.998362298061752e-6
atara,3,girl,0,3,8.998362298061752e-6
ateeyah,3,girl,0,3,8.998362298061752e-6
atene,3,girl,0,3,8.998362298061752e-6
athalia,3,girl,0,3,8.998362298061752e-6
atikah,3,girl,0,3,8.998362298061752e-6
aubree-rose,3,girl,0,3,8.998362298061752e-6
aubrey-rose,3,girl,0,3,8.998362298061752e-6
august,3,girl,0,3,8.998362298061752e-6
aurela,3,girl,0,3,8.998362298061752e-6
auria,3,girl,1,4,1.1997816397415671e-5
aurla,3,girl,4,7,2.0996178695477422e-5
aurora-grace,3,girl,0,3,8.998362298061752e-6
aurora-leigh,3,girl,0,3,8.998362298061752e-6
autumn-grace,3,girl,0,3,8.998362298061752e-6
ava-,3,girl,0,3,8.998362298061752e-6
ava-jay,3,girl,0,3,8.998362298061752e-6
ava-maria,3,girl,0,3,8.998362298061752e-6
ava-violet,3,girl,0,3,8.998362298061752e-6
avaana,3,girl,0,3,8.998362298061752e-6
avaiyah,3,girl,0,3,8.998362298061752e-6
avalynn,3,girl,0,3,8.998362298061752e-6
avary,3,girl,0,3,8.998362298061752e-6
aveyah,3,girl,0,3,8.998362298061752e-6
aviah,3,girl,0,3,8.998362298061752e-6
avin,3,girl,0,3,8.998362298061752e-6
aviva,3,girl,0,3,8.998362298061752e-6
avya,3,girl,0,3,8.998362298061752e-6
avyanna,3,girl,0,3,8.998362298061752e-6
axelle,3,girl,2,5,1.4997270496769588e-5
ayaanah,3,girl,0,3,8.998362298061752e-6
ayah-noor,3,girl,0,3,8.998362298061752e-6
ayeesha,3,girl,0,3,8.998362298061752e-6
ayeshah,3,girl,0,3,8.998362298061752e-6
ayman,3,girl,0,3,8.998362298061752e-6
ayshe,3,girl,0,3,8.998362298061752e-6
aysu,3,girl,0,3,8.998362298061752e-6
ayushi,3,girl,0,3,8.998362298061752e-6
ayzah,3,girl,0,3,8.998362298061752e-6
azbah,3,girl,0,3,8.998362298061752e-6
azeemah,3,girl,0,3,8.998362298061752e-6
azeeza,3,girl,0,3,8.998362298061752e-6
azwa,3,girl,0,3,8.998362298061752e-6
baila,3,girl,0,3,8.998362298061752e-6
bailey-grace,3,girl,0,3,8.998362298061752e-6
bailey-may,3,girl,0,3,8.998362298061752e-6
bakhtawar,3,girl,0,3,8.998362298061752e-6
bana,3,girl,0,3,8.998362298061752e-6
baraa,3,girl,0,3,8.998362298061752e-6
bareeha,3,girl,0,3,8.998362298061752e-6
barin,3,girl,0,3,8.998362298061752e-6
barira,3,girl,0,3,8.998362298061752e-6
bayaan,3,girl,0,3,8.998362298061752e-6
baye,3,girl,0,3,8.998362298061752e-6
becca,3,girl,2,5,1.4997270496769588e-5
bee,3,girl,0,3,8.998362298061752e-6
belicia,3,girl,0,3,8.998362298061752e-6
belina,3,girl,0,3,8.998362298061752e-6
belinda,3,girl,0,3,8.998362298061752e-6
belis,3,girl,0,3,8.998362298061752e-6
bella-grace,3,girl,0,3,8.998362298061752e-6
bella-ivy,3,girl,0,3,8.998362298061752e-6
bella-mia,3,girl,0,3,8.998362298061752e-6
berenice,3,girl,0,3,8.998362298061752e-6
betsie-mae,3,girl,0,3,8.998362298061752e-6
bettina,3,girl,0,3,8.998362298061752e-6
betty-mae,3,girl,0,3,8.998362298061752e-6
betty-rose,3,girl,0,3,8.998362298061752e-6
beverley,3,girl,0,3,8.998362298061752e-6
bexley,3,girl,0,3,8.998362298061752e-6
beyza,3,girl,0,3,8.998362298061752e-6
bhakti,3,girl,0,3,8.998362298061752e-6
biba,3,girl,0,3,8.998362298061752e-6
billi,3,girl,0,3,8.998362298061752e-6
bilqees,3,girl,0,3,8.998362298061752e-6
bina,3,girl,0,3,8.998362298061752e-6
bintou,3,girl,0,3,8.998362298061752e-6
birdie,3,girl,0,3,8.998362298061752e-6
blaise,3,girl,1,4,1.1997816397415671e-5
blakely,3,girl,1,4,1.1997816397415671e-5
boadicea,3,girl,0,3,8.998362298061752e-6
bobbi-leigh,3,girl,0,3,8.998362298061752e-6
bobbi-mae,3,girl,0,3,8.998362298061752e-6
bobbie-ann,3,girl,0,3,8.998362298061752e-6
bobbie-mae,3,girl,0,3,8.998362298061752e-6
bobbie-may,3,girl,0,3,8.998362298061752e-6
bobby,3,girl,0,3,8.998362298061752e-6
boglarka,3,girl,1,4,1.1997816397415671e-5
bonita,3,girl,0,3,8.998362298061752e-6
bonni,3,girl,1,4,1.1997816397415671e-5
bonnie-blu,3,girl,0,3,8.998362298061752e-6
bonnie-lou,3,girl,0,3,8.998362298061752e-6
bonnie-mai,3,girl,0,3,8.998362298061752e-6
bonnie-marie,3,girl,0,3,8.998362298061752e-6
borbala,3,girl,0,3,8.998362298061752e-6
bowe,3,girl,0,3,8.998362298061752e-6
breindy,3,girl,0,3,8.998362298061752e-6
briarna,3,girl,0,3,8.998362298061752e-6
brieanna,3,girl,0,3,8.998362298061752e-6
brienne,3,girl,0,3,8.998362298061752e-6
brodie-leigh,3,girl,0,3,8.998362298061752e-6
brody,3,girl,0,3,8.998362298061752e-6
brooke-lea,3,girl,0,3,8.998362298061752e-6
bruchi,3,girl,0,3,8.998362298061752e-6
busra,3,girl,0,3,8.998362298061752e-6
cadee,3,girl,0,3,8.998362298061752e-6
caitlynn,3,girl,1,4,1.1997816397415671e-5
caja,3,girl,1,4,1.1997816397415671e-5
caleigh,3,girl,0,3,8.998362298061752e-6
cali-rose,3,girl,0,3,8.998362298061752e-6
calleigh,3,girl,1,4,1.1997816397415671e-5
callie-mae,3,girl,0,3,8.998362298061752e-6
callie-may,3,girl,0,3,8.998362298061752e-6
candela,3,girl,0,3,8.998362298061752e-6
caragh,3,girl,7,10,2.9994540993539176e-5
casey-leigh,3,girl,1,4,1.1997816397415671e-5
casey-mai,3,girl,0,3,8.998362298061752e-6
casey-rae,3,girl,1,4,1.1997816397415671e-5
cassidy-mae,3,girl,0,3,8.998362298061752e-6
cassy,3,girl,0,3,8.998362298061752e-6
catharina,3,girl,0,3,8.998362298061752e-6
cathy,3,girl,0,3,8.998362298061752e-6
cecylia,3,girl,0,3,8.998362298061752e-6
celestia,3,girl,0,3,8.998362298061752e-6
celia-rose,3,girl,0,3,8.998362298061752e-6
ceri,3,girl,0,3,8.998362298061752e-6
ceyda,3,girl,0,3,8.998362298061752e-6
ceylan,3,girl,0,3,8.998362298061752e-6
chanice,3,girl,0,3,8.998362298061752e-6
channel,3,girl,0,3,8.998362298061752e-6
chantel,3,girl,0,3,8.998362298061752e-6
chantell,3,girl,0,3,8.998362298061752e-6
charissa,3,girl,0,3,8.998362298061752e-6
charlie-mai,3,girl,0,3,8.998362298061752e-6
charlie-rose,3,girl,0,3,8.998362298061752e-6
charlotta,3,girl,0,3,8.998362298061752e-6
charlotte-mae,3,girl,0,3,8.998362298061752e-6
charlotte-rae,3,girl,0,3,8.998362298061752e-6
charvi,3,girl,0,3,8.998362298061752e-6
chawan,3,girl,0,3,8.998362298061752e-6
chelsea-may,3,girl,0,3,8.998362298061752e-6
chevonne,3,girl,0,3,8.998362298061752e-6
chi,3,girl,0,3,8.998362298061752e-6
chika,3,girl,0,3,8.998362298061752e-6
chinyere,3,girl,0,3,8.998362298061752e-6
chloe-anne,3,girl,0,3,8.998362298061752e-6
christelle,3,girl,0,3,8.998362298061752e-6
christie,3,girl,3,6,1.7996724596123505e-5
chyanne,3,girl,0,3,8.998362298061752e-6
ciera,3,girl,0,3,8.998362298061752e-6
clancy,3,girl,0,3,8.998362298061752e-6
clarisse,3,girl,0,3,8.998362298061752e-6
claudette,3,girl,0,3,8.998362298061752e-6
clea,3,girl,0,3,8.998362298061752e-6
cliodhna,3,girl,0,3,8.998362298061752e-6
clove,3,girl,0,3,8.998362298061752e-6
connie-mai,3,girl,0,3,8.998362298061752e-6
constantina,3,girl,0,3,8.998362298061752e-6
crina,3,girl,0,3,8.998362298061752e-6
cristiana,3,girl,0,3,8.998362298061752e-6
daaniya,3,girl,0,3,8.998362298061752e-6
daina,3,girl,0,3,8.998362298061752e-6
daisy-ann,3,girl,0,3,8.998362298061752e-6
daisy-anne,3,girl,0,3,8.998362298061752e-6
daisy-belle,3,girl,0,3,8.998362298061752e-6
daisy-jane,3,girl,0,3,8.998362298061752e-6
daisy-jay,3,girl,0,3,8.998362298061752e-6
daizie,3,girl,0,3,8.998362298061752e-6
daizy,3,girl,0,3,8.998362298061752e-6
dakoda,3,girl,0,3,8.998362298061752e-6
daliah,3,girl,1,4,1.1997816397415671e-5
damia,3,girl,0,3,8.998362298061752e-6
damla,3,girl,1,4,1.1997816397415671e-5
daniah,3,girl,0,3,8.998362298061752e-6
daniya,3,girl,0,3,8.998362298061752e-6
daphney,3,girl,0,3,8.998362298061752e-6
darah,3,girl,1,4,1.1997816397415671e-5
darcey-rae,3,girl,0,3,8.998362298061752e-6
darci-rose,3,girl,0,3,8.998362298061752e-6
darcie-ann,3,girl,0,3,8.998362298061752e-6
darcie-marie,3,girl,0,3,8.998362298061752e-6
darcie-rai,3,girl,0,3,8.998362298061752e-6
darcy-grace,3,girl,0,3,8.998362298061752e-6
darcy-lee,3,girl,0,3,8.998362298061752e-6
darcy-mai,3,girl,0,3,8.998362298061752e-6
darcy-marie,3,girl,0,3,8.998362298061752e-6
dareen,3,girl,0,3,8.998362298061752e-6
dariana,3,girl,0,3,8.998362298061752e-6
darine,3,girl,0,3,8.998362298061752e-6
darla-rose,3,girl,0,3,8.998362298061752e-6
dasha,3,girl,0,3,8.998362298061752e-6
dasia,3,girl,0,3,8.998362298061752e-6
dassy,3,girl,0,3,8.998362298061752e-6
deenah,3,girl,0,3,8.998362298061752e-6
deepika,3,girl,0,3,8.998362298061752e-6
deeqa,3,girl,0,3,8.998362298061752e-6
delal,3,girl,0,3,8.998362298061752e-6
delcie,3,girl,0,3,8.998362298061752e-6
delilah-may,3,girl,0,3,8.998362298061752e-6
delilah-rae,3,girl,0,3,8.998362298061752e-6
demi-grace,3,girl,0,3,8.998362298061752e-6
demi-mai,3,girl,0,3,8.998362298061752e-6
denaya,3,girl,0,3,8.998362298061752e-6
dervla,3,girl,0,3,8.998362298061752e-6
desara,3,girl,0,3,8.998362298061752e-6
deshna,3,girl,0,3,8.998362298061752e-6
destinee,3,girl,0,3,8.998362298061752e-6
destini,3,girl,0,3,8.998362298061752e-6
destiny-louise,3,girl,0,3,8.998362298061752e-6
devani,3,girl,0,3,8.998362298061752e-6
devin,3,girl,0,3,8.998362298061752e-6
devora,3,girl,0,3,8.998362298061752e-6
dexy,3,girl,0,3,8.998362298061752e-6
deyana,3,girl,0,3,8.998362298061752e-6
dhanya,3,girl,0,3,8.998362298061752e-6
dhara,3,girl,1,4,1.1997816397415671e-5
dhriya,3,girl,0,3,8.998362298061752e-6
dhruti,3,girl,0,3,8.998362298061752e-6
dhuha,3,girl,0,3,8.998362298061752e-6
diala,3,girl,0,3,8.998362298061752e-6
dianna,3,girl,0,3,8.998362298061752e-6
didi,3,girl,0,3,8.998362298061752e-6
dilan,3,girl,0,3,8.998362298061752e-6
diren,3,girl,0,3,8.998362298061752e-6
diva,3,girl,0,3,8.998362298061752e-6
divyanka,3,girl,0,3,8.998362298061752e-6
dolci,3,girl,0,3,8.998362298061752e-6
dolcie-may,3,girl,0,3,8.998362298061752e-6
dolcie-rae,3,girl,0,3,8.998362298061752e-6
dolli,3,girl,0,3,8.998362298061752e-6
dona,3,girl,0,3,8.998362298061752e-6
donna-marie,3,girl,0,3,8.998362298061752e-6
dorota,3,girl,2,5,1.4997270496769588e-5
duha,3,girl,1,4,1.1997816397415671e-5
dulce,3,girl,0,3,8.998362298061752e-6
dunia,3,girl,0,3,8.998362298061752e-6
ebony-grace,3,girl,0,3,8.998362298061752e-6
ebrar,3,girl,0,3,8.998362298061752e-6
edina,3,girl,0,3,8.998362298061752e-6
edith-may,3,girl,0,3,8.998362298061752e-6
edith-rose,3,girl,0,3,8.998362298061752e-6
edom,3,girl,0,3,8.998362298061752e-6
eduarda,3,girl,0,3,8.998362298061752e-6
edwina,3,girl,0,3,8.998362298061752e-6
eeva,3,girl,1,4,1.1997816397415671e-5
effie-mae,3,girl,0,3,8.998362298061752e-6
eibhleann,3,girl,0,3,8.998362298061752e-6
eilis,3,girl,1,4,1.1997816397415671e-5
eilish,3,girl,7,10,2.9994540993539176e-5
eire,3,girl,1,4,1.1997816397415671e-5
eirinn,3,girl,1,4,1.1997816397415671e-5
eivissa,3,girl,0,3,8.998362298061752e-6
ekamdeep,3,girl,0,3,8.998362298061752e-6
elaia,3,girl,1,4,1.1997816397415671e-5
elain,3,girl,0,3,8.998362298061752e-6
elarna,3,girl,0,3,8.998362298061752e-6
elba,3,girl,0,3,8.998362298061752e-6
elbie,3,girl,0,3,8.998362298061752e-6
elda,3,girl,0,3,8.998362298061752e-6
eleah,3,girl,0,3,8.998362298061752e-6
eleanore,3,girl,0,3,8.998362298061752e-6
eleina,3,girl,0,3,8.998362298061752e-6
eleisha,3,girl,0,3,8.998362298061752e-6
elenid,3,girl,0,3,8.998362298061752e-6
elexa,3,girl,1,4,1.1997816397415671e-5
eliah,3,girl,0,3,8.998362298061752e-6
elijah,3,girl,0,3,8.998362298061752e-6
elinam,3,girl,0,3,8.998362298061752e-6
elisaveta,3,girl,0,3,8.998362298061752e-6
elissia-rose,3,girl,0,3,8.998362298061752e-6
elita,3,girl,2,5,1.4997270496769588e-5
elithea,3,girl,0,3,8.998362298061752e-6
elitsa,3,girl,0,3,8.998362298061752e-6
eliza-ann,3,girl,0,3,8.998362298061752e-6
eliza-jean,3,girl,0,3,8.998362298061752e-6
eliza-mai,3,girl,0,3,8.998362298061752e-6
elizabella,3,girl,0,3,8.998362298061752e-6
elizabeta,3,girl,0,3,8.998362298061752e-6
elka,3,girl,0,3,8.998362298061752e-6
elke,3,girl,1,4,1.1997816397415671e-5
ella-,3,girl,0,3,8.998362298061752e-6
ellanor,3,girl,1,4,1.1997816397415671e-5
ellanore,3,girl,0,3,8.998362298061752e-6
ellara,3,girl,0,3,8.998362298061752e-6
ellerie,3,girl,0,3,8.998362298061752e-6
ellice,3,girl,0,3,8.998362298061752e-6
ellicia,3,girl,0,3,8.998362298061752e-6
ellie-jo,3,girl,0,3,8.998362298061752e-6
elliemai,3,girl,0,3,8.998362298061752e-6
elody,3,girl,0,3,8.998362298061752e-6
eloghosa,3,girl,0,3,8.998362298061752e-6
elouisa,3,girl,0,3,8.998362298061752e-6
elpida,3,girl,0,3,8.998362298061752e-6
elsey,3,girl,0,3,8.998362298061752e-6
elshaddai,3,girl,0,3,8.998362298061752e-6
elsie-anne,3,girl,0,3,8.998362298061752e-6
elsie-beau,3,girl,0,3,8.998362298061752e-6
elsie-jane,3,girl,0,3,8.998362298061752e-6
elsie-louise,3,girl,0,3,8.998362298061752e-6
elvy,3,girl,0,3,8.998362298061752e-6
emanuella,3,girl,0,3,8.998362298061752e-6
emelda,3,girl,1,4,1.1997816397415671e-5
emerie,3,girl,0,3,8.998362298061752e-6
emika,3,girl,0,3,8.998362298061752e-6
emilee-rose,3,girl,0,3,8.998362298061752e-6
emileigh,3,girl,1,4,1.1997816397415671e-5
emilia-rae,3,girl,0,3,8.998362298061752e-6
emily-,3,girl,0,3,8.998362298061752e-6
emily-rae,3,girl,0,3,8.998362298061752e-6
emina,3,girl,0,3,8.998362298061752e-6
emiola,3,girl,0,3,8.998362298061752e-6
emmaline,3,girl,0,3,8.998362298061752e-6
emman,3,girl,0,3,8.998362298061752e-6
emmie-lou,3,girl,0,3,8.998362298061752e-6
emmy-lou,3,girl,0,3,8.998362298061752e-6
enaya,3,girl,0,3,8.998362298061752e-6
enea,3,girl,0,3,8.998362298061752e-6
enlli,3,girl,0,3,8.998362298061752e-6
enrika,3,girl,1,4,1.1997816397415671e-5
enya-rose,3,girl,0,3,8.998362298061752e-6
ereshva,3,girl,0,3,8.998362298061752e-6
erin-grace,3,girl,0,3,8.998362298061752e-6
eryka,3,girl,0,3,8.998362298061752e-6
erykah,3,girl,2,5,1.4997270496769588e-5
eshaani,3,girl,0,3,8.998362298061752e-6
esher,3,girl,0,3,8.998362298061752e-6
esmaii,3,girl,0,3,8.998362298061752e-6
esme-rae,3,girl,0,3,8.998362298061752e-6
esmea,3,girl,0,3,8.998362298061752e-6
esmee-rose,3,girl,0,3,8.998362298061752e-6
esmi,3,girl,0,3,8.998362298061752e-6
esmira,3,girl,0,3,8.998362298061752e-6
esperance,3,girl,0,3,8.998362298061752e-6
estrella,3,girl,0,3,8.998362298061752e-6
eulalia,3,girl,0,3,8.998362298061752e-6
eva-lily,3,girl,0,3,8.998362298061752e-6
eva-rae,3,girl,0,3,8.998362298061752e-6
evannah,3,girl,0,3,8.998362298061752e-6
evey,3,girl,1,4,1.1997816397415671e-5
eviana,3,girl,0,3,8.998362298061752e-6
evie-ann,3,girl,0,3,8.998362298061752e-6
evie-elizabeth,3,girl,0,3,8.998362298061752e-6
evie-jade,3,girl,0,3,8.998362298061752e-6
evie-lea,3,girl,0,3,8.998362298061752e-6
evija,3,girl,0,3,8.998362298061752e-6
eyra,3,girl,0,3,8.998362298061752e-6
eysan,3,girl,0,3,8.998362298061752e-6
ezgi,3,girl,0,3,8.998362298061752e-6
fabienne,3,girl,0,3,8.998362298061752e-6
faduma,3,girl,0,3,8.998362298061752e-6
faisa,3,girl,0,3,8.998362298061752e-6
faith-louise,3,girl,0,3,8.998362298061752e-6
fajar,3,girl,0,3,8.998362298061752e-6
farha,3,girl,0,3,8.998362298061752e-6
fariah,3,girl,0,3,8.998362298061752e-6
farisha,3,girl,0,3,8.998362298061752e-6
fariya,3,girl,0,3,8.998362298061752e-6
farryn,3,girl,1,4,1.1997816397415671e-5
farzeen,3,girl,0,3,8.998362298061752e-6
feigy,3,girl,0,3,8.998362298061752e-6
felicja,3,girl,0,3,8.998362298061752e-6
fenn,3,girl,0,3,8.998362298061752e-6
fiamma,3,girl,0,3,8.998362298061752e-6
fidan,3,girl,0,3,8.998362298061752e-6
finlay,3,girl,0,3,8.998362298061752e-6
finley,3,girl,0,3,8.998362298061752e-6
finola,3,girl,0,3,8.998362298061752e-6
firdous,3,girl,0,3,8.998362298061752e-6
florena,3,girl,0,3,8.998362298061752e-6
florencia,3,girl,0,3,8.998362298061752e-6
floriana,3,girl,0,3,8.998362298061752e-6
flossy,3,girl,0,3,8.998362298061752e-6
folashade,3,girl,0,3,8.998362298061752e-6
franca,3,girl,0,3,8.998362298061752e-6
franceska,3,girl,1,4,1.1997816397415671e-5
frankie-lou,3,girl,0,3,8.998362298061752e-6
frayah,3,girl,1,4,1.1997816397415671e-5
frederica,3,girl,0,3,8.998362298061752e-6
freia,3,girl,0,3,8.998362298061752e-6
frenchie,3,girl,0,3,8.998362298061752e-6
freya-mai,3,girl,0,3,8.998362298061752e-6
freya-may,3,girl,0,3,8.998362298061752e-6
fruzsina,3,girl,0,3,8.998362298061752e-6
gabia,3,girl,0,3,8.998362298061752e-6
galena,3,girl,0,3,8.998362298061752e-6
gauri,3,girl,0,3,8.998362298061752e-6
gayathri,3,girl,0,3,8.998362298061752e-6
gemima,3,girl,0,3,8.998362298061752e-6
georgia-grace,3,girl,0,3,8.998362298061752e-6
georgia-mai,3,girl,0,3,8.998362298061752e-6
georgia-rae,3,girl,0,3,8.998362298061752e-6
georgina-rose,3,girl,0,3,8.998362298061752e-6
geraldine,3,girl,1,4,1.1997816397415671e-5
ghazal,3,girl,0,3,8.998362298061752e-6
ghena,3,girl,0,3,8.998362298061752e-6
gift,3,girl,1,4,1.1997816397415671e-5
gifty,3,girl,0,3,8.998362298061752e-6
ginika,3,girl,0,3,8.998362298061752e-6
gisella,3,girl,0,3,8.998362298061752e-6
giulietta,3,girl,0,3,8.998362298061752e-6
gizelle,3,girl,0,3,8.998362298061752e-6
gloriana,3,girl,0,3,8.998362298061752e-6
golda,3,girl,0,3,8.998362298061752e-6
gowri,3,girl,0,3,8.998362298061752e-6
grace-elizabeth,3,girl,0,3,8.998362298061752e-6
gracey-may,3,girl,0,3,8.998362298061752e-6
gracie-lea,3,girl,0,3,8.998362298061752e-6
gracie-louise,3,girl,0,3,8.998362298061752e-6
grishma,3,girl,0,3,8.998362298061752e-6
guinevere,3,girl,0,3,8.998362298061752e-6
gurasees,3,girl,0,3,8.998362298061752e-6
gurman,3,girl,0,3,8.998362298061752e-6
gurnaaz,3,girl,0,3,8.998362298061752e-6
gurpreet,3,girl,0,3,8.998362298061752e-6
gurseerat,3,girl,0,3,8.998362298061752e-6
gurveen,3,girl,0,3,8.998362298061752e-6
gwenan,3,girl,0,3,8.998362298061752e-6
gwennie,3,girl,0,3,8.998362298061752e-6
gypsie,3,girl,0,3,8.998362298061752e-6
habeebah,3,girl,0,3,8.998362298061752e-6
hadiqa,3,girl,0,3,8.998362298061752e-6
hadleigh,3,girl,0,3,8.998362298061752e-6
hajera,3,girl,0,3,8.998362298061752e-6
halia,3,girl,0,3,8.998362298061752e-6
halle-mae,3,girl,0,3,8.998362298061752e-6
halli,3,girl,1,4,1.1997816397415671e-5
hameedah,3,girl,0,3,8.998362298061752e-6
han,3,girl,1,4,1.1997816397415671e-5
hanasa,3,girl,0,3,8.998362298061752e-6
hanaya,3,girl,0,3,8.998362298061752e-6
haneet,3,girl,0,3,8.998362298061752e-6
hanga,3,girl,1,4,1.1997816397415671e-5
hannah-grace,3,girl,0,3,8.998362298061752e-6
hannah-may,3,girl,2,5,1.4997270496769588e-5
hanshika,3,girl,0,3,8.998362298061752e-6
hany,3,girl,0,3,8.998362298061752e-6
hareer,3,girl,1,4,1.1997816397415671e-5
harkiran,3,girl,0,3,8.998362298061752e-6
harkirat,3,girl,0,3,8.998362298061752e-6
harlee-mae,3,girl,0,3,8.998362298061752e-6
harlie-grace,3,girl,0,3,8.998362298061752e-6
harlie-rae,3,girl,0,3,8.998362298061752e-6
harlow-rose,3,girl,0,3,8.998362298061752e-6
harman,3,girl,0,3,8.998362298061752e-6
harpa,3,girl,0,3,8.998362298061752e-6
harper-lea,3,girl,0,3,8.998362298061752e-6
harper-lillie,3,girl,0,3,8.998362298061752e-6
harrie,3,girl,0,3,8.998362298061752e-6
haseena,3,girl,0,3,8.998362298061752e-6
hattie-may,3,girl,0,3,8.998362298061752e-6
hauwa,3,girl,1,4,1.1997816397415671e-5
havva,3,girl,0,3,8.998362298061752e-6
hawah,3,girl,0,3,8.998362298061752e-6
hayfa,3,girl,0,3,8.998362298061752e-6
hayley-may,3,girl,0,3,8.998362298061752e-6
heavenly-joy,3,girl,0,3,8.998362298061752e-6
hebron,3,girl,0,3,8.998362298061752e-6
helia,3,girl,0,3,8.998362298061752e-6
hendrix,3,girl,0,3,8.998362298061752e-6
hennessy,3,girl,0,3,8.998362298061752e-6
henny,3,girl,0,3,8.998362298061752e-6
hessa,3,girl,0,3,8.998362298061752e-6
hijrah,3,girl,0,3,8.998362298061752e-6
hila,3,girl,0,3,8.998362298061752e-6
hilal,3,girl,0,3,8.998362298061752e-6
hiu,3,girl,0,3,8.998362298061752e-6
hivda,3,girl,0,3,8.998362298061752e-6
hodan,3,girl,0,3,8.998362298061752e-6
hodo,3,girl,0,3,8.998362298061752e-6
hollie-grace,3,girl,0,3,8.998362298061752e-6
holly-may,3,girl,0,3,8.998362298061752e-6
holy,3,girl,0,3,8.998362298061752e-6
honey-may,3,girl,1,4,1.1997816397415671e-5
honey-rae,3,girl,0,3,8.998362298061752e-6
hosna,3,girl,0,3,8.998362298061752e-6
hui,3,girl,0,3,8.998362298061752e-6
humnah,3,girl,0,3,8.998362298061752e-6
huxley,3,girl,0,3,8.998362298061752e-6
iara,3,girl,0,3,8.998362298061752e-6
ibukunoluwa,3,girl,0,3,8.998362298061752e-6
ida-may,3,girl,0,3,8.998362298061752e-6
ifeoma,3,girl,0,3,8.998362298061752e-6
ikhlaas,3,girl,0,3,8.998362298061752e-6
ikran,3,girl,0,3,8.998362298061752e-6
ilyaana,3,girl,0,3,8.998362298061752e-6
imari,3,girl,0,3,8.998362298061752e-6
imelia,3,girl,0,3,8.998362298061752e-6
immy,3,girl,1,4,1.1997816397415671e-5
inabiyah,3,girl,0,3,8.998362298061752e-6
inayaa,3,girl,0,3,8.998362298061752e-6
inayaah,3,girl,0,3,8.998362298061752e-6
inci,3,girl,0,3,8.998362298061752e-6
indiana-rose,3,girl,1,4,1.1997816397415671e-5
indiyah,3,girl,0,3,8.998362298061752e-6
indy-rose,3,girl,0,3,8.998362298061752e-6
inessa,3,girl,0,3,8.998362298061752e-6
iniya,3,girl,0,3,8.998362298061752e-6
inshirah,3,girl,1,4,1.1997816397415671e-5
ionela,3,girl,0,3,8.998362298061752e-6
irfa,3,girl,0,3,8.998362298061752e-6
iris-lily,3,girl,0,3,8.998362298061752e-6
irma,3,girl,0,3,8.998362298061752e-6
irmak,3,girl,0,3,8.998362298061752e-6
irtiqa,3,girl,0,3,8.998362298061752e-6
isabele,3,girl,0,3,8.998362298061752e-6
isabella-louise,3,girl,0,3,8.998362298061752e-6
isatou,3,girl,0,3,8.998362298061752e-6
isidora,3,girl,0,3,8.998362298061752e-6
isis,3,girl,0,3,8.998362298061752e-6
isla-beau,3,girl,0,3,8.998362298061752e-6
isla-belle,3,girl,0,3,8.998362298061752e-6
isla-faith,3,girl,0,3,8.998362298061752e-6
isla-jade,3,girl,0,3,8.998362298061752e-6
issabelle,3,girl,0,3,8.998362298061752e-6
issra,3,girl,0,3,8.998362298061752e-6
iustina,3,girl,1,4,1.1997816397415671e-5
ivanah,3,girl,0,3,8.998362298061752e-6
ivanka,3,girl,0,3,8.998362298061752e-6
ivon,3,girl,0,3,8.998362298061752e-6
ivy-beau,3,girl,0,3,8.998362298061752e-6
ivy-jane,3,girl,0,3,8.998362298061752e-6
ivy-lee,3,girl,1,4,1.1997816397415671e-5
ivy-willow,3,girl,0,3,8.998362298061752e-6
iyla-jane,3,girl,0,3,8.998362298061752e-6
iyla-mai,3,girl,0,3,8.998362298061752e-6
iyrah,3,girl,0,3,8.998362298061752e-6
iysha,3,girl,0,3,8.998362298061752e-6
iyzah,3,girl,0,3,8.998362298061752e-6
iza,3,girl,1,4,1.1997816397415671e-5
jadesola,3,girl,0,3,8.998362298061752e-6
jahnae,3,girl,0,3,8.998362298061752e-6
jaiyah,3,girl,0,3,8.998362298061752e-6
jamaima,3,girl,0,3,8.998362298061752e-6
jameelah,3,girl,0,3,8.998362298061752e-6
james,3,girl,0,3,8.998362298061752e-6
jamilah,3,girl,0,3,8.998362298061752e-6
jamima,3,girl,0,3,8.998362298061752e-6
janaki,3,girl,0,3,8.998362298061752e-6
janan,3,girl,0,3,8.998362298061752e-6
janaya,3,girl,0,3,8.998362298061752e-6
janka,3,girl,0,3,8.998362298061752e-6
jannet,3,girl,0,3,8.998362298061752e-6
japneet,3,girl,1,4,1.1997816397415671e-5
japnoor,3,girl,0,3,8.998362298061752e-6
jasgun,3,girl,0,3,8.998362298061752e-6
jasia,3,girl,0,3,8.998362298061752e-6
jaslyn,3,girl,0,3,8.998362298061752e-6
jawhara,3,girl,0,3,8.998362298061752e-6
jaylah,3,girl,0,3,8.998362298061752e-6
jayme,3,girl,0,3,8.998362298061752e-6
jazzlyn,3,girl,0,3,8.998362298061752e-6
jeanelle,3,girl,1,4,1.1997816397415671e-5
jeanette,3,girl,0,3,8.998362298061752e-6
jeanne,3,girl,2,5,1.4997270496769588e-5
jeannie,3,girl,0,3,8.998362298061752e-6
jedidah,3,girl,0,3,8.998362298061752e-6
jehan,3,girl,0,3,8.998362298061752e-6
jeni,3,girl,1,4,1.1997816397415671e-5
jeorgia,3,girl,1,4,1.1997816397415671e-5
jerusha,3,girl,0,3,8.998362298061752e-6
jesica,3,girl,1,4,1.1997816397415671e-5
jessenia,3,girl,0,3,8.998362298061752e-6
jessi,3,girl,1,4,1.1997816397415671e-5
jessica-grace,3,girl,0,3,8.998362298061752e-6
jessica-jane,3,girl,0,3,8.998362298061752e-6
jessie-leigh,3,girl,0,3,8.998362298061752e-6
jessie-mae,3,girl,0,3,8.998362298061752e-6
jessyca,3,girl,0,3,8.998362298061752e-6
jewell,3,girl,0,3,8.998362298061752e-6
jiaqi,3,girl,0,3,8.998362298061752e-6
jiayue,3,girl,0,3,8.998362298061752e-6
jihan,3,girl,0,3,8.998362298061752e-6
jolee,3,girl,0,3,8.998362298061752e-6
jordyn,3,girl,3,6,1.7996724596123505e-5
jore,3,girl,0,3,8.998362298061752e-6
jorgiana,3,girl,0,3,8.998362298061752e-6
jorgie-may,3,girl,0,3,8.998362298061752e-6
jorji,3,girl,0,3,8.998362298061752e-6
jorjie,3,girl,0,3,8.998362298061752e-6
jory,3,girl,0,3,8.998362298061752e-6
joselyn,3,girl,0,3,8.998362298061752e-6
josie-mae,3,girl,0,3,8.998362298061752e-6
josie-may,3,girl,0,3,8.998362298061752e-6
josselyn,3,girl,0,3,8.998362298061752e-6
joules,3,girl,0,3,8.998362298061752e-6
journey,3,girl,1,4,1.1997816397415671e-5
jovita,3,girl,0,3,8.998362298061752e-6
juhaina,3,girl,0,3,8.998362298061752e-6
jules,3,girl,0,3,8.998362298061752e-6
jumaimah,3,girl,0,3,8.998362298061752e-6
juman,3,girl,0,3,8.998362298061752e-6
junia,3,girl,0,3,8.998362298061752e-6
juwairiya,3,girl,0,3,8.998362298061752e-6
kacey-ann,3,girl,0,3,8.998362298061752e-6
kacie-leigh,3,girl,0,3,8.998362298061752e-6
kacy,3,girl,1,4,1.1997816397415671e-5
kaelyn,3,girl,0,3,8.998362298061752e-6
kaesha,3,girl,0,3,8.998362298061752e-6
kaeya,3,girl,0,3,8.998362298061752e-6
kaidi,3,girl,0,3,8.998362298061752e-6
kailani,3,girl,0,3,8.998362298061752e-6
kaisha,3,girl,0,3,8.998362298061752e-6
kaley,3,girl,1,4,1.1997816397415671e-5
kalkidan,3,girl,0,3,8.998362298061752e-6
kalliopi,3,girl,0,3,8.998362298061752e-6
kamara,3,girl,0,3,8.998362298061752e-6
kamelia,3,girl,0,3,8.998362298061752e-6
kami,3,girl,1,4,1.1997816397415671e-5
kamilya,3,girl,0,3,8.998362298061752e-6
kanika,3,girl,0,3,8.998362298061752e-6
kanishka,3,girl,0,3,8.998362298061752e-6
kany,3,girl,0,3,8.998362298061752e-6
kari,3,girl,0,3,8.998362298061752e-6
karimah,3,girl,1,4,1.1997816397415671e-5
karlotta,3,girl,0,3,8.998362298061752e-6
karman,3,girl,0,3,8.998362298061752e-6
karys,3,girl,0,3,8.998362298061752e-6
kasie,3,girl,1,4,1.1997816397415671e-5
katelyn-rose,3,girl,0,3,8.998362298061752e-6
kateryna,3,girl,0,3,8.998362298061752e-6
katie-mae,3,girl,0,3,8.998362298061752e-6
katinka,3,girl,0,3,8.998362298061752e-6
katja,3,girl,0,3,8.998362298061752e-6
katriona,3,girl,0,3,8.998362298061752e-6
kavi,3,girl,0,3,8.998362298061752e-6
kavisha,3,girl,0,3,8.998362298061752e-6
kavisna,3,girl,0,3,8.998362298061752e-6
kaviya,3,girl,0,3,8.998362298061752e-6
kayah,3,girl,1,4,1.1997816397415671e-5
kayan,3,girl,0,3,8.998362298061752e-6
kayde,3,girl,0,3,8.998362298061752e-6
kaydi,3,girl,0,3,8.998362298061752e-6
kayla-jai,3,girl,0,3,8.998362298061752e-6
kayleigh-marie,3,girl,0,3,8.998362298061752e-6
kaylen,3,girl,0,3,8.998362298061752e-6
kaylie,3,girl,0,3,8.998362298061752e-6
keara,3,girl,1,4,1.1997816397415671e-5
keely,3,girl,0,3,8.998362298061752e-6
keera,3,girl,0,3,8.998362298061752e-6
keerthika,3,girl,0,3,8.998362298061752e-6
keesha,3,girl,0,3,8.998362298061752e-6
keira-mai,3,girl,0,3,8.998362298061752e-6
keira-may,3,girl,0,3,8.998362298061752e-6
keisi,3,girl,0,3,8.998362298061752e-6
keita,3,girl,1,4,1.1997816397415671e-5
kelcie,3,girl,1,4,1.1997816397415671e-5
kelsi,3,girl,0,3,8.998362298061752e-6
kelsy,3,girl,0,3,8.998362298061752e-6
kenechukwu,3,girl,0,3,8.998362298061752e-6
kensie,3,girl,1,4,1.1997816397415671e-5
kerenza,3,girl,0,3,8.998362298061752e-6
kerry-ann,3,girl,0,3,8.998362298061752e-6
kesiena,3,girl,0,3,8.998362298061752e-6
ketsia,3,girl,0,3,8.998362298061752e-6
kevina,3,girl,0,3,8.998362298061752e-6
khadra,3,girl,0,3,8.998362298061752e-6
khaliah,3,girl,0,3,8.998362298061752e-6
khaliyah,3,girl,0,3,8.998362298061752e-6
kharis,3,girl,1,4,1.1997816397415671e-5
khatija,3,girl,0,3,8.998362298061752e-6
khayra,3,girl,0,3,8.998362298061752e-6
khizra,3,girl,0,3,8.998362298061752e-6
khulud,3,girl,0,3,8.998362298061752e-6
khushpreet,3,girl,0,3,8.998362298061752e-6
kianna-rose,3,girl,0,3,8.998362298061752e-6
kiaya,3,girl,0,3,8.998362298061752e-6
kienna,3,girl,1,4,1.1997816397415671e-5
kierra,3,girl,0,3,8.998362298061752e-6
kimi,3,girl,0,3,8.998362298061752e-6
kimiya,3,girl,0,3,8.998362298061752e-6
kimora,3,girl,0,3,8.998362298061752e-6
kirit,3,girl,0,3,8.998362298061752e-6
kisa,3,girl,0,3,8.998362298061752e-6
kitty-rose,3,girl,0,3,8.998362298061752e-6
kiyanna,3,girl,0,3,8.998362298061752e-6
kizzie,3,girl,0,3,8.998362298061752e-6
klaudie,3,girl,0,3,8.998362298061752e-6
kleio,3,girl,0,3,8.998362298061752e-6
kleopatra,3,girl,0,3,8.998362298061752e-6
koa,3,girl,0,3,8.998362298061752e-6
kodi,3,girl,0,3,8.998362298061752e-6
kody,3,girl,0,3,8.998362298061752e-6
komal,3,girl,0,3,8.998362298061752e-6
kristie,3,girl,0,3,8.998362298061752e-6
kristine,3,girl,0,3,8.998362298061752e-6
kristyn,3,girl,0,3,8.998362298061752e-6
kristyna,3,girl,0,3,8.998362298061752e-6
kriti,3,girl,1,4,1.1997816397415671e-5
krystyna,3,girl,0,3,8.998362298061752e-6
kulsum,3,girl,0,3,8.998362298061752e-6
kulthum,3,girl,0,3,8.998362298061752e-6
kunashe,3,girl,0,3,8.998362298061752e-6
kyia,3,girl,0,3,8.998362298061752e-6
kyla-rose,3,girl,1,4,1.1997816397415671e-5
kylah-rose,3,girl,0,3,8.998362298061752e-6
kyra-leigh,3,girl,0,3,8.998362298061752e-6
kyra-mae,3,girl,0,3,8.998362298061752e-6
la,3,girl,0,3,8.998362298061752e-6
laana,3,girl,0,3,8.998362298061752e-6
labeena,3,girl,0,3,8.998362298061752e-6
lacey-,3,girl,0,3,8.998362298061752e-6
lacey-jayne,3,girl,0,3,8.998362298061752e-6
lacey-lee,3,girl,0,3,8.998362298061752e-6
laci-mae,3,girl,1,4,1.1997816397415671e-5
lacie-ann,3,girl,0,3,8.998362298061752e-6
lacie-lou,3,girl,0,3,8.998362298061752e-6
ladan,3,girl,0,3,8.998362298061752e-6
laetitia,3,girl,0,3,8.998362298061752e-6
lagertha,3,girl,0,3,8.998362298061752e-6
laicee,3,girl,0,3,8.998362298061752e-6
laicey,3,girl,1,4,1.1997816397415671e-5
laiken,3,girl,1,4,1.1997816397415671e-5
laila-grace,3,girl,0,3,8.998362298061752e-6
laima,3,girl,0,3,8.998362298061752e-6
laine,3,girl,0,3,8.998362298061752e-6
lainee,3,girl,0,3,8.998362298061752e-6
lainey-rae,3,girl,0,3,8.998362298061752e-6
laira,3,girl,0,3,8.998362298061752e-6
lale,3,girl,0,3,8.998362298061752e-6
lamara,3,girl,0,3,8.998362298061752e-6
lameesah,3,girl,0,3,8.998362298061752e-6
lamiyah,3,girl,0,3,8.998362298061752e-6
lana-rose,3,girl,1,4,1.1997816397415671e-5
laniyah,3,girl,0,3,8.998362298061752e-6
lanna,3,girl,1,4,1.1997816397415671e-5
larae,3,girl,0,3,8.998362298061752e-6
larah,3,girl,0,3,8.998362298061752e-6
laraya,3,girl,0,3,8.998362298061752e-6
larysa,3,girl,0,3,8.998362298061752e-6
lataya,3,girl,0,3,8.998362298061752e-6
latifah,3,girl,0,3,8.998362298061752e-6
laurena,3,girl,0,3,8.998362298061752e-6
lavayah,3,girl,0,3,8.998362298061752e-6
laveen,3,girl,0,3,8.998362298061752e-6
lavender,3,girl,0,3,8.998362298061752e-6
lavinya,3,girl,0,3,8.998362298061752e-6
layali,3,girl,0,3,8.998362298061752e-6
layla-leigh,3,girl,0,3,8.998362298061752e-6
layla-louise,3,girl,0,3,8.998362298061752e-6
layli,3,girl,0,3,8.998362298061752e-6
leah-grace,3,girl,0,3,8.998362298061752e-6
leah-mai,3,girl,0,3,8.998362298061752e-6
leala,3,girl,0,3,8.998362298061752e-6
leela-rose,3,girl,0,3,8.998362298061752e-6
leiah,3,girl,0,3,8.998362298061752e-6
leighton,3,girl,2,5,1.4997270496769588e-5
leila-grace,3,girl,0,3,8.998362298061752e-6
leisha,3,girl,0,3,8.998362298061752e-6
lenora,3,girl,0,3,8.998362298061752e-6
lesedi,3,girl,0,3,8.998362298061752e-6
lesley,3,girl,3,6,1.7996724596123505e-5
levayah,3,girl,0,3,8.998362298061752e-6
lexi-,3,girl,0,3,8.998362298061752e-6
lexie-anne,3,girl,0,3,8.998362298061752e-6
lexis,3,girl,1,4,1.1997816397415671e-5
leyla-rose,3,girl,0,3,8.998362298061752e-6
liahona,3,girl,0,3,8.998362298061752e-6
libby-may,3,girl,0,3,8.998362298061752e-6
libi,3,girl,0,3,8.998362298061752e-6
lida,3,girl,0,3,8.998362298061752e-6
liela,3,girl,0,3,8.998362298061752e-6
lili-mai,3,girl,0,3,8.998362298061752e-6
liliah,3,girl,0,3,8.998362298061752e-6
lilie,3,girl,0,3,8.998362298061752e-6
lillee,3,girl,0,3,8.998362298061752e-6
lillie-anna,3,girl,0,3,8.998362298061752e-6
lillie-jean,3,girl,0,3,8.998362298061752e-6
lilly-beth,3,girl,0,3,8.998362298061752e-6
lillyana,3,girl,0,3,8.998362298061752e-6
lillymay,3,girl,2,5,1.4997270496769588e-5
lilo,3,girl,0,3,8.998362298061752e-6
lilu,3,girl,0,3,8.998362298061752e-6
lily-anna,3,girl,0,3,8.998362298061752e-6
lily-joy,3,girl,0,3,8.998362298061752e-6
lindsey,3,girl,0,3,8.998362298061752e-6
lisa-marie,3,girl,2,5,1.4997270496769588e-5
lisamarie,3,girl,1,4,1.1997816397415671e-5
liviya,3,girl,0,3,8.998362298061752e-6
liyla,3,girl,1,4,1.1997816397415671e-5
lizzy,3,girl,0,3,8.998362298061752e-6
lola-anne,3,girl,0,3,8.998362298061752e-6
lola-blu,3,girl,0,3,8.998362298061752e-6
lola-jade,3,girl,0,3,8.998362298061752e-6
lola-jayne,3,girl,0,3,8.998362298061752e-6
lola-leigh,3,girl,0,3,8.998362298061752e-6
lola-marie,3,girl,0,3,8.998362298061752e-6
lona,3,girl,0,3,8.998362298061752e-6
lottie-belle,3,girl,1,4,1.1997816397415671e-5
lottie-marie,3,girl,0,3,8.998362298061752e-6
louisa-may,3,girl,0,3,8.998362298061752e-6
lovelle,3,girl,0,3,8.998362298061752e-6
lowen,3,girl,0,3,8.998362298061752e-6
loxie,3,girl,0,3,8.998362298061752e-6
loza,3,girl,0,3,8.998362298061752e-6
luanna,3,girl,0,3,8.998362298061752e-6
lubna,3,girl,0,3,8.998362298061752e-6
lucea,3,girl,0,3,8.998362298061752e-6
lucie-mae,3,girl,0,3,8.998362298061752e-6
lucie-mai,3,girl,0,3,8.998362298061752e-6
lucrezia,3,girl,0,3,8.998362298061752e-6
ludovica,3,girl,0,3,8.998362298061752e-6
lukrecija,3,girl,0,3,8.998362298061752e-6
lula-rose,3,girl,0,3,8.998362298061752e-6
lumen,3,girl,0,3,8.998362298061752e-6
luna-may,3,girl,0,3,8.998362298061752e-6
lusiana,3,girl,0,3,8.998362298061752e-6
lwsi,3,girl,0,3,8.998362298061752e-6
lyla-belle,3,girl,0,3,8.998362298061752e-6
lyla-may,3,girl,0,3,8.998362298061752e-6
lyra-mae,3,girl,0,3,8.998362298061752e-6
maaida,3,girl,0,3,8.998362298061752e-6
maawa,3,girl,0,3,8.998362298061752e-6
macee,3,girl,0,3,8.998362298061752e-6
madaline,3,girl,0,3,8.998362298061752e-6
madalynn,3,girl,0,3,8.998362298061752e-6
maddison-rae,3,girl,0,3,8.998362298061752e-6
madihah,3,girl,0,3,8.998362298061752e-6
madison-leigh,3,girl,0,3,8.998362298061752e-6
madlen,3,girl,0,3,8.998362298061752e-6
maebel,3,girl,0,3,8.998362298061752e-6
maebh,3,girl,0,3,8.998362298061752e-6
maeda,3,girl,0,3,8.998362298061752e-6
maely,3,girl,0,3,8.998362298061752e-6
magathi,3,girl,0,3,8.998362298061752e-6
magda,3,girl,1,4,1.1997816397415671e-5
maggie-anne,3,girl,0,3,8.998362298061752e-6
magnolia,3,girl,0,3,8.998362298061752e-6
mahera,3,girl,0,3,8.998362298061752e-6
mahia,3,girl,0,3,8.998362298061752e-6
mahsaa,3,girl,0,3,8.998362298061752e-6
maicey,3,girl,1,4,1.1997816397415671e-5
maila,3,girl,0,3,8.998362298061752e-6
maily,3,girl,0,3,8.998362298061752e-6
maimoonah,3,girl,0,3,8.998362298061752e-6
maimouna,3,girl,1,4,1.1997816397415671e-5
mais,3,girl,0,3,8.998362298061752e-6
maisie-marie,3,girl,0,3,8.998362298061752e-6
maissa,3,girl,0,3,8.998362298061752e-6
maisy-rose,3,girl,0,3,8.998362298061752e-6
maite,3,girl,0,3,8.998362298061752e-6
maizee,3,girl,0,3,8.998362298061752e-6
maizey,3,girl,0,3,8.998362298061752e-6
majesty,3,girl,0,3,8.998362298061752e-6
makeda,3,girl,0,3,8.998362298061752e-6
makenzie,3,girl,0,3,8.998362298061752e-6
malaysia,3,girl,0,3,8.998362298061752e-6
maleeka,3,girl,0,3,8.998362298061752e-6
mallak,3,girl,0,3,8.998362298061752e-6
mallie,3,girl,1,4,1.1997816397415671e-5
mame,3,girl,0,3,8.998362298061752e-6
manaahil,3,girl,1,4,1.1997816397415671e-5
manahel,3,girl,0,3,8.998362298061752e-6
manasvi,3,girl,0,3,8.998362298061752e-6
manroop,3,girl,0,3,8.998362298061752e-6
manvi,3,girl,0,3,8.998362298061752e-6
marayah,3,girl,0,3,8.998362298061752e-6
marcey,3,girl,0,3,8.998362298061752e-6
margarida,3,girl,0,3,8.998362298061752e-6
margherita,3,girl,0,3,8.998362298061752e-6
marguerite,3,girl,0,3,8.998362298061752e-6
marielle,3,girl,0,3,8.998362298061752e-6
marietta,3,girl,0,3,8.998362298061752e-6
marin,3,girl,0,3,8.998362298061752e-6
marjaan,3,girl,0,3,8.998362298061752e-6
marleen,3,girl,0,3,8.998362298061752e-6
marloe,3,girl,0,3,8.998362298061752e-6
marnie-grace,3,girl,0,3,8.998362298061752e-6
marnie-mae,3,girl,0,3,8.998362298061752e-6
martha-grace,3,girl,0,3,8.998362298061752e-6
marvellous,3,girl,0,3,8.998362298061752e-6
mary-anne,3,girl,0,3,8.998362298061752e-6
mary-ellen,3,girl,0,3,8.998362298061752e-6
mary-jayne,3,girl,0,3,8.998362298061752e-6
maryanna,3,girl,0,3,8.998362298061752e-6
maryem,3,girl,0,3,8.998362298061752e-6
maryjane,3,girl,1,4,1.1997816397415671e-5
marylou,3,girl,0,3,8.998362298061752e-6
mashal,3,girl,0,3,8.998362298061752e-6
masuma,3,girl,0,3,8.998362298061752e-6
mataya,3,girl,0,3,8.998362298061752e-6
mathea,3,girl,0,3,8.998362298061752e-6
mati,3,girl,0,3,8.998362298061752e-6
matilda-rae,3,girl,0,3,8.998362298061752e-6
mawa,3,girl,0,3,8.998362298061752e-6
maybel,3,girl,0,3,8.998362298061752e-6
maylee,3,girl,0,3,8.998362298061752e-6
maylin,3,girl,0,3,8.998362298061752e-6
mayly,3,girl,0,3,8.998362298061752e-6
maymoona,3,girl,0,3,8.998362298061752e-6
maysarah,3,girl,0,3,8.998362298061752e-6
mayzie,3,girl,0,3,8.998362298061752e-6
mazey,3,girl,0,3,8.998362298061752e-6
meagan,3,girl,1,4,1.1997816397415671e-5
medinah,3,girl,0,3,8.998362298061752e-6
meerub,3,girl,0,3,8.998362298061752e-6
meesha,3,girl,1,4,1.1997816397415671e-5
megha,3,girl,0,3,8.998362298061752e-6
meghan-rose,3,girl,0,3,8.998362298061752e-6
meghna,3,girl,0,3,8.998362298061752e-6
megi,3,girl,0,3,8.998362298061752e-6
meha,3,girl,0,3,8.998362298061752e-6
mehr,3,girl,1,4,1.1997816397415671e-5
mehrab,3,girl,0,3,8.998362298061752e-6
mehwish,3,girl,0,3,8.998362298061752e-6
meia,3,girl,0,3,8.998362298061752e-6
meida,3,girl,1,4,1.1997816397415671e-5
meilani,3,girl,0,3,8.998362298061752e-6
meja,3,girl,0,3,8.998362298061752e-6
melanija,3,girl,0,3,8.998362298061752e-6
meliyah,3,girl,0,3,8.998362298061752e-6
melodi,3,girl,0,3,8.998362298061752e-6
merin,3,girl,0,3,8.998362298061752e-6
merina,3,girl,0,3,8.998362298061752e-6
meya,3,girl,0,3,8.998362298061752e-6
mhairi,3,girl,17,20,5.998908198707835e-5
mi,3,girl,0,3,8.998362298061752e-6
mia-jane,3,girl,0,3,8.998362298061752e-6
mia-lilly,3,girl,0,3,8.998362298061752e-6
mia-marie,3,girl,0,3,8.998362298061752e-6
miah-grace,3,girl,0,3,8.998362298061752e-6
miah-rose,3,girl,0,3,8.998362298061752e-6
mica,3,girl,0,3,8.998362298061752e-6
michal,3,girl,0,3,8.998362298061752e-6
michela,3,girl,0,3,8.998362298061752e-6
michele,3,girl,0,3,8.998362298061752e-6
mikaya,3,girl,0,3,8.998362298061752e-6
mikayla-rose,3,girl,0,3,8.998362298061752e-6
mila-grace,3,girl,0,3,8.998362298061752e-6
mila-rae,3,girl,0,3,8.998362298061752e-6
milagros,3,girl,0,3,8.998362298061752e-6
mildred,3,girl,0,3,8.998362298061752e-6
miliana,3,girl,0,3,8.998362298061752e-6
millan,3,girl,0,3,8.998362298061752e-6
millen,3,girl,1,4,1.1997816397415671e-5
miller,3,girl,0,3,8.998362298061752e-6
millie-jade,3,girl,0,3,8.998362298061752e-6
millie-mai,3,girl,0,3,8.998362298061752e-6
milly-mae,3,girl,0,3,8.998362298061752e-6
minah,3,girl,0,3,8.998362298061752e-6
minh,3,girl,0,3,8.998362298061752e-6
minnie-rose,3,girl,0,3,8.998362298061752e-6
miraal,3,girl,1,4,1.1997816397415671e-5
mirel,3,girl,0,3,8.998362298061752e-6
mirielle,3,girl,0,3,8.998362298061752e-6
mishel,3,girl,0,3,8.998362298061752e-6
mitzie,3,girl,0,3,8.998362298061752e-6
miyla,3,girl,0,3,8.998362298061752e-6
molli,3,girl,1,4,1.1997816397415671e-5
mominah,3,girl,0,3,8.998362298061752e-6
monisha,3,girl,0,3,8.998362298061752e-6
morenike,3,girl,0,3,8.998362298061752e-6
mufaro,3,girl,0,3,8.998362298061752e-6
muhsina,3,girl,0,3,8.998362298061752e-6
muireann,3,girl,1,4,1.1997816397415671e-5
mukti,3,girl,0,3,8.998362298061752e-6
munachi,3,girl,0,3,8.998362298061752e-6
muqaddas,3,girl,0,3,8.998362298061752e-6
musfirah,3,girl,0,3,8.998362298061752e-6
my,3,girl,0,3,8.998362298061752e-6
mya-grace,3,girl,0,3,8.998362298061752e-6
myah-grace,3,girl,0,3,8.998362298061752e-6
myla-may,3,girl,0,3,8.998362298061752e-6
mylah-rose,3,girl,0,3,8.998362298061752e-6
myleigh,3,girl,0,3,8.998362298061752e-6
mylene,3,girl,0,3,8.998362298061752e-6
myley,3,girl,2,5,1.4997270496769588e-5
myriam,3,girl,0,3,8.998362298061752e-6
naavya,3,girl,0,3,8.998362298061752e-6
nabihah,3,girl,0,3,8.998362298061752e-6
nabilah,3,girl,0,3,8.998362298061752e-6
nadah,3,girl,0,3,8.998362298061752e-6
nadeen,3,girl,0,3,8.998362298061752e-6
nafesa,3,girl,0,3,8.998362298061752e-6
nafia,3,girl,0,3,8.998362298061752e-6
naimat,3,girl,0,3,8.998362298061752e-6
naiyana,3,girl,0,3,8.998362298061752e-6
nakita,3,girl,1,4,1.1997816397415671e-5
nala-rose,3,girl,0,3,8.998362298061752e-6
nalani,3,girl,0,3,8.998362298061752e-6
naledi,3,girl,0,3,8.998362298061752e-6
namrita,3,girl,0,3,8.998362298061752e-6
nanaki,3,girl,0,3,8.998362298061752e-6
nancie-mai,3,girl,0,3,8.998362298061752e-6
nancy-lou,3,girl,0,3,8.998362298061752e-6
nancy-rae,3,girl,0,3,8.998362298061752e-6
nandipha,3,girl,0,3,8.998362298061752e-6
nareen,3,girl,0,3,8.998362298061752e-6
narjis,3,girl,0,3,8.998362298061752e-6
nasiha,3,girl,0,3,8.998362298061752e-6
nasira,3,girl,0,3,8.998362298061752e-6
nasreen,3,girl,0,3,8.998362298061752e-6
nasteho,3,girl,0,3,8.998362298061752e-6
natalia-rose,3,girl,0,3,8.998362298061752e-6
nataliya,3,girl,0,3,8.998362298061752e-6
natalya-rose,3,girl,0,3,8.998362298061752e-6
natanya,3,girl,0,3,8.998362298061752e-6
natasa,3,girl,0,3,8.998362298061752e-6
nathalia,3,girl,0,3,8.998362298061752e-6
naureen,3,girl,0,3,8.998362298061752e-6
navaeh,3,girl,0,3,8.998362298061752e-6
naysa,3,girl,0,3,8.998362298061752e-6
nazanin,3,girl,1,4,1.1997816397415671e-5
nazneen,3,girl,0,3,8.998362298061752e-6
ndey,3,girl,0,3,8.998362298061752e-6
nea,3,girl,0,3,8.998362298061752e-6
neesha,3,girl,0,3,8.998362298061752e-6
neev,3,girl,0,3,8.998362298061752e-6
nefes,3,girl,0,3,8.998362298061752e-6
neila,3,girl,0,3,8.998362298061752e-6
nelia,3,girl,0,3,8.998362298061752e-6
nellie-may,3,girl,0,3,8.998362298061752e-6
nellie-rae,3,girl,0,3,8.998362298061752e-6
nelly-rose,3,girl,0,3,8.998362298061752e-6
neoma,3,girl,0,3,8.998362298061752e-6
neri,3,girl,0,3,8.998362298061752e-6
nesrin,3,girl,0,3,8.998362298061752e-6
nesta,3,girl,1,4,1.1997816397415671e-5
netanya,3,girl,0,3,8.998362298061752e-6
nevaeh-louise,3,girl,0,3,8.998362298061752e-6
nevaeh-rae,3,girl,0,3,8.998362298061752e-6
neveyah,3,girl,0,3,8.998362298061752e-6
nevie,3,girl,1,4,1.1997816397415671e-5
ngozi,3,girl,0,3,8.998362298061752e-6
nhi,3,girl,0,3,8.998362298061752e-6
nhyira,3,girl,0,3,8.998362298061752e-6
nia-rose,3,girl,0,3,8.998362298061752e-6
nichelle,3,girl,0,3,8.998362298061752e-6
nienke,3,girl,0,3,8.998362298061752e-6
nihaal,3,girl,0,3,8.998362298061752e-6
nihira,3,girl,0,3,8.998362298061752e-6
nikolia,3,girl,0,3,8.998362298061752e-6
niniola,3,girl,0,3,8.998362298061752e-6
nirbani,3,girl,0,3,8.998362298061752e-6
nirvi,3,girl,0,3,8.998362298061752e-6
nisanur,3,girl,0,3,8.998362298061752e-6
nishtha,3,girl,0,3,8.998362298061752e-6
nitara,3,girl,1,4,1.1997816397415671e-5
nithila,3,girl,0,3,8.998362298061752e-6
niva,3,girl,0,3,8.998362298061752e-6
nivisha,3,girl,0,3,8.998362298061752e-6
niyana,3,girl,0,3,8.998362298061752e-6
niyla,3,girl,0,3,8.998362298061752e-6
niylah,3,girl,0,3,8.998362298061752e-6
noam,3,girl,0,3,8.998362298061752e-6
noel,3,girl,0,3,8.998362298061752e-6
non,3,girl,0,3,8.998362298061752e-6
noori,3,girl,0,3,8.998362298061752e-6
nooriya,3,girl,0,3,8.998362298061752e-6
noorjahan,3,girl,0,3,8.998362298061752e-6
norina,3,girl,0,3,8.998362298061752e-6
norseen,3,girl,0,3,8.998362298061752e-6
noureen,3,girl,0,3,8.998362298061752e-6
nova-lee,3,girl,0,3,8.998362298061752e-6
noya,3,girl,0,3,8.998362298061752e-6
nuseyba,3,girl,0,3,8.998362298061752e-6
nuvee,3,girl,0,3,8.998362298061752e-6
nuzhat,3,girl,0,3,8.998362298061752e-6
nyiah,3,girl,0,3,8.998362298061752e-6
nylah-rae,3,girl,0,3,8.998362298061752e-6
oana,3,girl,0,3,8.998362298061752e-6
oceane,3,girl,2,5,1.4997270496769588e-5
odetta,3,girl,0,3,8.998362298061752e-6
odrija,3,girl,0,3,8.998362298061752e-6
ohana,3,girl,0,3,8.998362298061752e-6
olivia-faith,3,girl,0,3,8.998362298061752e-6
oluwadabira,3,girl,0,3,8.998362298061752e-6
oluwadamilare,3,girl,0,3,8.998362298061752e-6
oluwafikunayomi,3,girl,0,3,8.998362298061752e-6
oluwapelumi,3,girl,0,3,8.998362298061752e-6
oluwaseun,3,girl,0,3,8.998362298061752e-6
oluwateniola,3,girl,0,3,8.998362298061752e-6
oluwatise,3,girl,0,3,8.998362298061752e-6
oluwatoni,3,girl,0,3,8.998362298061752e-6
oluwatosin,3,girl,0,3,8.998362298061752e-6
omara,3,girl,0,3,8.998362298061752e-6
omaya,3,girl,0,3,8.998362298061752e-6
omera,3,girl,0,3,8.998362298061752e-6
omolola,3,girl,1,4,1.1997816397415671e-5
omotara,3,girl,0,3,8.998362298061752e-6
omowunmi,3,girl,0,3,8.998362298061752e-6
onaya,3,girl,0,3,8.998362298061752e-6
onyx,3,girl,0,3,8.998362298061752e-6
oracle,3,girl,0,3,8.998362298061752e-6
oreofeoluwa,3,girl,0,3,8.998362298061752e-6
orla-faith,3,girl,0,3,8.998362298061752e-6
orla-mae,3,girl,0,3,8.998362298061752e-6
orly,3,girl,1,4,1.1997816397415671e-5
osahenrumwen,3,girl,0,3,8.998362298061752e-6
osinachi,3,girl,1,4,1.1997816397415671e-5
osob,3,girl,0,3,8.998362298061752e-6
paislea,3,girl,0,3,8.998362298061752e-6
paiton,3,girl,0,3,8.998362298061752e-6
palmer,3,girl,0,3,8.998362298061752e-6
pana,3,girl,0,3,8.998362298061752e-6
paria,3,girl,1,4,1.1997816397415671e-5
parinaz,3,girl,0,3,8.998362298061752e-6
parinita,3,girl,0,3,8.998362298061752e-6
parmeet,3,girl,0,3,8.998362298061752e-6
parminder,3,girl,0,3,8.998362298061752e-6
parya,3,girl,0,3,8.998362298061752e-6
pascale,3,girl,0,3,8.998362298061752e-6
patrisia,3,girl,0,3,8.998362298061752e-6
pavani,3,girl,0,3,8.998362298061752e-6
peach,3,girl,0,3,8.998362298061752e-6
pearl-rose,3,girl,0,3,8.998362298061752e-6
penda,3,girl,0,3,8.998362298061752e-6
peniel,3,girl,0,3,8.998362298061752e-6
perola,3,girl,0,3,8.998362298061752e-6
petruta,3,girl,0,3,8.998362298061752e-6
phoebe-leigh,3,girl,0,3,8.998362298061752e-6
phoebe-louise,3,girl,0,3,8.998362298061752e-6
phoebe-marie,3,girl,0,3,8.998362298061752e-6
phoibe,3,girl,0,3,8.998362298061752e-6
phyllis,3,girl,0,3,8.998362298061752e-6
pilar,3,girl,0,3,8.998362298061752e-6
piper-marie,3,girl,0,3,8.998362298061752e-6
pollie,3,girl,0,3,8.998362298061752e-6
polly-rose,3,girl,0,3,8.998362298061752e-6
poppie-mae,3,girl,0,3,8.998362298061752e-6
poppy-jay,3,girl,0,3,8.998362298061752e-6
poppy-lea,3,girl,0,3,8.998362298061752e-6
poppy-leigh,3,girl,0,3,8.998362298061752e-6
porcha,3,girl,2,5,1.4997270496769588e-5
porsha-marie,3,girl,0,3,8.998362298061752e-6
prachi,3,girl,0,3,8.998362298061752e-6
pragati,3,girl,0,3,8.998362298061752e-6
pranali,3,girl,0,3,8.998362298061752e-6
praneet,3,girl,0,3,8.998362298061752e-6
pranitha,3,girl,0,3,8.998362298061752e-6
pransi,3,girl,0,3,8.998362298061752e-6
preeya,3,girl,0,3,8.998362298061752e-6
preslava,3,girl,0,3,8.998362298061752e-6
priseis,3,girl,0,3,8.998362298061752e-6
priyal,3,girl,0,3,8.998362298061752e-6
priyasha,3,girl,0,3,8.998362298061752e-6
prue,3,girl,0,3,8.998362298061752e-6
puneet,3,girl,0,3,8.998362298061752e-6
quratulain,3,girl,1,4,1.1997816397415671e-5
qurratul,3,girl,0,3,8.998362298061752e-6
raahi,3,girl,0,3,8.998362298061752e-6
raaina,3,girl,1,4,1.1997816397415671e-5
raavi,3,girl,1,4,1.1997816397415671e-5
rabab,3,girl,0,3,8.998362298061752e-6
rachell,3,girl,0,3,8.998362298061752e-6
radost,3,girl,0,3,8.998362298061752e-6
raeven,3,girl,1,4,1.1997816397415671e-5
raewyn,3,girl,0,3,8.998362298061752e-6
rand,3,girl,0,3,8.998362298061752e-6
raneem,3,girl,0,3,8.998362298061752e-6
raqiya,3,girl,0,3,8.998362298061752e-6
rashi,3,girl,0,3,8.998362298061752e-6
rawdah,3,girl,0,3,8.998362298061752e-6
ray,3,girl,0,3,8.998362298061752e-6
raye,3,girl,0,3,8.998362298061752e-6
rayleigh,3,girl,0,3,8.998362298061752e-6
reanne,3,girl,0,3,8.998362298061752e-6
reba,3,girl,0,3,8.998362298061752e-6
rebecca-rose,3,girl,0,3,8.998362298061752e-6
reegan,3,girl,1,4,1.1997816397415671e-5
reesha,3,girl,0,3,8.998362298061752e-6
rehma,3,girl,0,3,8.998362298061752e-6
reia,3,girl,0,3,8.998362298061752e-6
reisel,3,girl,0,3,8.998362298061752e-6
reisha,3,girl,0,3,8.998362298061752e-6
reka,3,girl,1,4,1.1997816397415671e-5
remae,3,girl,0,3,8.998362298061752e-6
remmi,3,girl,0,3,8.998362298061752e-6
remy-leigh,3,girl,0,3,8.998362298061752e-6
renesmee-jane,3,girl,0,3,8.998362298061752e-6
reneya,3,girl,0,3,8.998362298061752e-6
reyhan,3,girl,0,3,8.998362298061752e-6
rhianwen,3,girl,0,3,8.998362298061752e-6
rhiya,3,girl,0,3,8.998362298061752e-6
rhylee,3,girl,0,3,8.998362298061752e-6
ridhi,3,girl,0,3,8.998362298061752e-6
riella,3,girl,0,3,8.998362298061752e-6
rifky,3,girl,0,3,8.998362298061752e-6
riham,3,girl,0,3,8.998362298061752e-6
rija,3,girl,0,3,8.998362298061752e-6
riki,3,girl,0,3,8.998362298061752e-6
rilee,3,girl,0,3,8.998362298061752e-6
riley-mae,3,girl,0,3,8.998362298061752e-6
rinaad,3,girl,0,3,8.998362298061752e-6
river-leigh,3,girl,0,3,8.998362298061752e-6
riyah,3,girl,0,3,8.998362298061752e-6
riyanshi,3,girl,0,3,8.998362298061752e-6
robyn-leigh,3,girl,1,4,1.1997816397415671e-5
rocio,3,girl,0,3,8.998362298061752e-6
romane,3,girl,0,3,8.998362298061752e-6
romany-rose,3,girl,0,3,8.998362298061752e-6
romee,3,girl,0,3,8.998362298061752e-6
ronny,3,girl,0,3,8.998362298061752e-6
rosabel,3,girl,0,3,8.998362298061752e-6
rosaleen,3,girl,0,3,8.998362298061752e-6
rosalinda,3,girl,0,3,8.998362298061752e-6
rosannah,3,girl,0,3,8.998362298061752e-6
rosario,3,girl,0,3,8.998362298061752e-6
roseann,3,girl,0,3,8.998362298061752e-6
rosie-louise,3,girl,0,3,8.998362298061752e-6
rosie-marie,3,girl,0,3,8.998362298061752e-6
royal,3,girl,0,3,8.998362298061752e-6
rozerin,3,girl,0,3,8.998362298061752e-6
ruba,3,girl,0,3,8.998362298061752e-6
rubi-leigh,3,girl,0,3,8.998362298061752e-6
rubi-rose,3,girl,0,3,8.998362298061752e-6
rubie-leigh,3,girl,0,3,8.998362298061752e-6
ruby-faith,3,girl,0,3,8.998362298061752e-6
ruby-jane,3,girl,0,3,8.998362298061752e-6
ruby-joy,3,girl,0,3,8.998362298061752e-6
ruhama,3,girl,0,3,8.998362298061752e-6
rukaya,3,girl,0,3,8.998362298061752e-6
rukayat,3,girl,0,3,8.998362298061752e-6
rumana,3,girl,0,3,8.998362298061752e-6
ruta,3,girl,0,3,8.998362298061752e-6
rya,3,girl,0,3,8.998362298061752e-6
ryleigh-mae,3,girl,0,3,8.998362298061752e-6
saaleha,3,girl,0,3,8.998362298061752e-6
saalihah,3,girl,0,3,8.998362298061752e-6
saamiya,3,girl,0,3,8.998362298061752e-6
sabeen,3,girl,0,3,8.998362298061752e-6
sacha,3,girl,0,3,8.998362298061752e-6
sachi,3,girl,0,3,8.998362298061752e-6
sada,3,girl,0,3,8.998362298061752e-6
safeeyah,3,girl,0,3,8.998362298061752e-6
saffi,3,girl,0,3,8.998362298061752e-6
safoorah,3,girl,0,3,8.998362298061752e-6
sahej,3,girl,0,3,8.998362298061752e-6
sahib,3,girl,1,4,1.1997816397415671e-5
sahiba,3,girl,0,3,8.998362298061752e-6
sahij,3,girl,0,3,8.998362298061752e-6
sahla,3,girl,2,5,1.4997270496769588e-5
saida,3,girl,0,3,8.998362298061752e-6
saige,3,girl,0,3,8.998362298061752e-6
saimah,3,girl,0,3,8.998362298061752e-6
sakeenah,3,girl,0,3,8.998362298061752e-6
salena,3,girl,0,3,8.998362298061752e-6
salimah,3,girl,0,3,8.998362298061752e-6
salimatou,3,girl,0,3,8.998362298061752e-6
salsabeel,3,girl,0,3,8.998362298061752e-6
samanvi,3,girl,0,3,8.998362298061752e-6
samera,3,girl,0,3,8.998362298061752e-6
samrah,3,girl,0,3,8.998362298061752e-6
samriddhi,3,girl,1,4,1.1997816397415671e-5
samyra,3,girl,0,3,8.998362298061752e-6
sanchi,3,girl,0,3,8.998362298061752e-6
sanela,3,girl,0,3,8.998362298061752e-6
sanika,3,girl,0,3,8.998362298061752e-6
sanna,3,girl,2,5,1.4997270496769588e-5
santa,3,girl,0,3,8.998362298061752e-6
sanya,3,girl,0,3,8.998362298061752e-6
saorlaith,3,girl,1,4,1.1997816397415671e-5
sapphire-marie,3,girl,0,3,8.998362298061752e-6
sarah-louise,3,girl,1,4,1.1997816397415671e-5
sareen,3,girl,0,3,8.998362298061752e-6
sariya,3,girl,0,3,8.998362298061752e-6
sarlote,3,girl,0,3,8.998362298061752e-6
sashini,3,girl,0,3,8.998362298061752e-6
savanna-rose,3,girl,0,3,8.998362298061752e-6
savannah-mae,3,girl,0,3,8.998362298061752e-6
sawda,3,girl,0,3,8.998362298061752e-6
sawsan,3,girl,0,3,8.998362298061752e-6
saydee,3,girl,0,3,8.998362298061752e-6
sayed,3,girl,0,3,8.998362298061752e-6
sayeda,3,girl,0,3,8.998362298061752e-6
sayesha,3,girl,0,3,8.998362298061752e-6
sayyeda,3,girl,0,3,8.998362298061752e-6
scarlett-ann,3,girl,0,3,8.998362298061752e-6
scarlett-anne,3,girl,0,3,8.998362298061752e-6
scarlett-jade,3,girl,0,3,8.998362298061752e-6
scarlett-leigh,3,girl,0,3,8.998362298061752e-6
scarlett-mai,3,girl,0,3,8.998362298061752e-6
scarlott,3,girl,0,3,8.998362298061752e-6
scarlotte,3,girl,0,3,8.998362298061752e-6
seana,3,girl,2,5,1.4997270496769588e-5
seda,3,girl,0,3,8.998362298061752e-6
sedra,3,girl,0,3,8.998362298061752e-6
seerit,3,girl,1,4,1.1997816397415671e-5
sehj,3,girl,0,3,8.998362298061752e-6
sejal,3,girl,0,3,8.998362298061752e-6
setayesh,3,girl,0,3,8.998362298061752e-6
sevda,3,girl,0,3,8.998362298061752e-6
sevgi,3,girl,0,3,8.998362298061752e-6
seyma,3,girl,0,3,8.998362298061752e-6
shaanvi,3,girl,0,3,8.998362298061752e-6
shadae,3,girl,0,3,8.998362298061752e-6
shaddai,3,girl,0,3,8.998362298061752e-6
shahla,3,girl,0,3,8.998362298061752e-6
shaila,3,girl,0,3,8.998362298061752e-6
shakayla,3,girl,0,3,8.998362298061752e-6
shanaaya,3,girl,0,3,8.998362298061752e-6
shanaiya,3,girl,0,3,8.998362298061752e-6
shannara,3,girl,0,3,8.998362298061752e-6
shantelle,3,girl,0,3,8.998362298061752e-6
sharleez,3,girl,0,3,8.998362298061752e-6
sharlyn,3,girl,0,3,8.998362298061752e-6
shasmeen,3,girl,0,3,8.998362298061752e-6
shayla-rae,3,girl,0,3,8.998362298061752e-6
shaylah,3,girl,0,3,8.998362298061752e-6
shayleigh,3,girl,0,3,8.998362298061752e-6
shaynie,3,girl,0,3,8.998362298061752e-6
sheema,3,girl,0,3,8.998362298061752e-6
sheena,3,girl,0,3,8.998362298061752e-6
sheikha,3,girl,0,3,8.998362298061752e-6
shelly,3,girl,0,3,8.998362298061752e-6
shenae,3,girl,0,3,8.998362298061752e-6
shianna,3,girl,0,3,8.998362298061752e-6
shifaa,3,girl,0,3,8.998362298061752e-6
shifah,3,girl,0,3,8.998362298061752e-6
shoshanna,3,girl,0,3,8.998362298061752e-6
shreyashi,3,girl,0,3,8.998362298061752e-6
shri,3,girl,0,3,8.998362298061752e-6
si,3,girl,0,3,8.998362298061752e-6
sianne,3,girl,0,3,8.998362298061752e-6
siddiqa,3,girl,0,3,8.998362298061752e-6
sienna-jane,3,girl,0,3,8.998362298061752e-6
siennah,3,girl,0,3,8.998362298061752e-6
siera,3,girl,0,3,8.998362298061752e-6
silva,3,girl,1,4,1.1997816397415671e-5
simi,3,girl,0,3,8.998362298061752e-6
siqi,3,girl,1,4,1.1997816397415671e-5
sirena,3,girl,0,3,8.998362298061752e-6
sirin,3,girl,1,4,1.1997816397415671e-5
sita,3,girl,0,3,8.998362298061752e-6
sive,3,girl,0,3,8.998362298061752e-6
siyara,3,girl,0,3,8.998362298061752e-6
skarlette,3,girl,0,3,8.998362298061752e-6
skie,3,girl,0,3,8.998362298061752e-6
skyela,3,girl,0,3,8.998362298061752e-6
skyla-grace,3,girl,0,3,8.998362298061752e-6
skyla-jane,3,girl,0,3,8.998362298061752e-6
skyla-leigh,3,girl,0,3,8.998362298061752e-6
skyla-marie,3,girl,0,3,8.998362298061752e-6
skylar-blue,3,girl,0,3,8.998362298061752e-6
skylar-grace,3,girl,0,3,8.998362298061752e-6
skylar-marie,3,girl,0,3,8.998362298061752e-6
sofia-marie,3,girl,0,3,8.998362298061752e-6
sofiah,3,girl,0,3,8.998362298061752e-6
soliyana,3,girl,0,3,8.998362298061752e-6
sonali,3,girl,0,3,8.998362298061752e-6
sondos,3,girl,2,5,1.4997270496769588e-5
sophie-grace,3,girl,1,4,1.1997816397415671e-5
sophie-leigh,3,girl,1,4,1.1997816397415671e-5
sophie-may,3,girl,1,4,1.1997816397415671e-5
sora,3,girl,0,3,8.998362298061752e-6
soraia,3,girl,0,3,8.998362298061752e-6
soumaya,3,girl,0,3,8.998362298061752e-6
srisha,3,girl,0,3,8.998362298061752e-6
srishti,3,girl,0,3,8.998362298061752e-6
starlett,3,girl,0,3,8.998362298061752e-6
stefani,3,girl,0,3,8.998362298061752e-6
stefany,3,girl,0,3,8.998362298061752e-6
steisi,3,girl,0,3,8.998362298061752e-6
stephania,3,girl,0,3,8.998362298061752e-6
suad,3,girl,0,3,8.998362298061752e-6
sumeya,3,girl,0,3,8.998362298061752e-6
sumiya,3,girl,0,3,8.998362298061752e-6
summer-lilly,3,girl,0,3,8.998362298061752e-6
summer-mai,3,girl,0,3,8.998362298061752e-6
summer-may,3,girl,0,3,8.998362298061752e-6
summer-rayne,3,girl,0,3,8.998362298061752e-6
sura,3,girl,0,3,8.998362298061752e-6
suriyah,3,girl,0,3,8.998362298061752e-6
susana,3,girl,0,3,8.998362298061752e-6
suvi,3,girl,0,3,8.998362298061752e-6
suzan,3,girl,1,4,1.1997816397415671e-5
sydney-rae,3,girl,0,3,8.998362298061752e-6
sylvi,3,girl,0,3,8.998362298061752e-6
syna,3,girl,0,3,8.998362298061752e-6
ta'liyah,3,girl,0,3,8.998362298061752e-6
taalia,3,girl,0,3,8.998362298061752e-6
taejah,3,girl,0,3,8.998362298061752e-6
tahlia-rose,3,girl,0,3,8.998362298061752e-6
tais,3,girl,0,3,8.998362298061752e-6
taisiya,3,girl,0,3,8.998362298061752e-6
talayla,3,girl,0,3,8.998362298061752e-6
talia-mae,3,girl,0,3,8.998362298061752e-6
talin,3,girl,0,3,8.998362298061752e-6
taline,3,girl,0,3,8.998362298061752e-6
talisha,3,girl,1,4,1.1997816397415671e-5
taliya,3,girl,0,3,8.998362298061752e-6
tallia,3,girl,0,3,8.998362298061752e-6
tallie,3,girl,0,3,8.998362298061752e-6
tallulah-belle,3,girl,1,4,1.1997816397415671e-5
talullah,3,girl,0,3,8.998362298061752e-6
talyia,3,girl,0,3,8.998362298061752e-6
tamiah,3,girl,0,3,8.998362298061752e-6
tamiranashe,3,girl,0,3,8.998362298061752e-6
tamiya,3,girl,0,3,8.998362298061752e-6
tamiyah,3,girl,0,3,8.998362298061752e-6
tanyaradzwa,3,girl,0,3,8.998362298061752e-6
tanzeela,3,girl,0,3,8.998362298061752e-6
tariro,3,girl,0,3,8.998362298061752e-6
tate,3,girl,1,4,1.1997816397415671e-5
tatum,3,girl,0,3,8.998362298061752e-6
tavia,3,girl,0,3,8.998362298061752e-6
tayba,3,girl,0,3,8.998362298061752e-6
tayiba,3,girl,0,3,8.998362298061752e-6
tazkiyah,3,girl,0,3,8.998362298061752e-6
teah,3,girl,0,3,8.998362298061752e-6
tegen,3,girl,0,3,8.998362298061752e-6
tegh,3,girl,0,3,8.998362298061752e-6
tehilla,3,girl,1,4,1.1997816397415671e-5
tehreem,3,girl,0,3,8.998362298061752e-6
temilola,3,girl,1,4,1.1997816397415671e-5
temitayo,3,girl,0,3,8.998362298061752e-6
terri,3,girl,0,3,8.998362298061752e-6
teuta,3,girl,0,3,8.998362298061752e-6
teyla,3,girl,0,3,8.998362298061752e-6
thandiwe,3,girl,0,3,8.998362298061752e-6
thando,3,girl,0,3,8.998362298061752e-6
tharanya,3,girl,0,3,8.998362298061752e-6
tiana-mai,3,girl,0,3,8.998362298061752e-6
tiana-marie,3,girl,0,3,8.998362298061752e-6
tiannah,3,girl,0,3,8.998362298061752e-6
tianne,3,girl,1,4,1.1997816397415671e-5
tiarna-rose,3,girl,0,3,8.998362298061752e-6
tida,3,girl,0,3,8.998362298061752e-6
tiger,3,girl,0,3,8.998362298061752e-6
tillie-rae,3,girl,0,3,8.998362298061752e-6
tilly-louise,3,girl,0,3,8.998362298061752e-6
tilly-mai,3,girl,0,3,8.998362298061752e-6
tilly-marie,3,girl,0,3,8.998362298061752e-6
tilly-sue,3,girl,0,3,8.998362298061752e-6
tinaye,3,girl,0,3,8.998362298061752e-6
toluwalase,3,girl,0,3,8.998362298061752e-6
toluwani,3,girl,0,3,8.998362298061752e-6
tsion,3,girl,0,3,8.998362298061752e-6
tulin,3,girl,0,3,8.998362298061752e-6
tullulah,3,girl,0,3,8.998362298061752e-6
twinkle,3,girl,0,3,8.998362298061752e-6
ulyana,3,girl,0,3,8.998362298061752e-6
umaya,3,girl,0,3,8.998362298061752e-6
umayah,3,girl,0,3,8.998362298061752e-6
umm,3,girl,0,3,8.998362298061752e-6
umm-e-hani,3,girl,1,4,1.1997816397415671e-5
ummayyah,3,girl,0,3,8.998362298061752e-6
ummehani,3,girl,0,3,8.998362298061752e-6
unika,3,girl,0,3,8.998362298061752e-6
urenna,3,girl,0,3,8.998362298061752e-6
vaidehi,3,girl,0,3,8.998362298061752e-6
vakare,3,girl,1,4,1.1997816397415671e-5
valentina-rose,3,girl,0,3,8.998362298061752e-6
vasilia,3,girl,0,3,8.998362298061752e-6
venba,3,girl,0,3,8.998362298061752e-6
venisha,3,girl,0,3,8.998362298061752e-6
verona,3,girl,0,3,8.998362298061752e-6
veya,3,girl,1,4,1.1997816397415671e-5
viktorie,3,girl,0,3,8.998362298061752e-6
violet-grace,3,girl,0,3,8.998362298061752e-6
vy,3,girl,0,3,8.998362298061752e-6
vyara,3,girl,0,3,8.998362298061752e-6
waliya,3,girl,0,3,8.998362298061752e-6
wanessa,3,girl,0,3,8.998362298061752e-6
waqia,3,girl,0,3,8.998362298061752e-6
warisha,3,girl,0,3,8.998362298061752e-6
wei,3,girl,0,3,8.998362298061752e-6
william,3,girl,0,3,8.998362298061752e-6
willow-hope,3,girl,0,3,8.998362298061752e-6
winry,3,girl,0,3,8.998362298061752e-6
winta,3,girl,0,3,8.998362298061752e-6
xanthia,3,girl,0,3,8.998362298061752e-6
xavier,3,girl,0,3,8.998362298061752e-6
xhensila,3,girl,0,3,8.998362298061752e-6
ximena,3,girl,0,3,8.998362298061752e-6
xinyan,3,girl,1,4,1.1997816397415671e-5
yaa,3,girl,0,3,8.998362298061752e-6
yahvi,3,girl,0,3,8.998362298061752e-6
yan,3,girl,1,4,1.1997816397415671e-5
yaqeen,3,girl,0,3,8.998362298061752e-6
yen,3,girl,0,3,8.998362298061752e-6
yeshika,3,girl,0,3,8.998362298061752e-6
yetunde,3,girl,1,4,1.1997816397415671e-5
yomna,3,girl,0,3,8.998362298061752e-6
youmna,3,girl,0,3,8.998362298061752e-6
yusraa,3,girl,0,3,8.998362298061752e-6
yvette,3,girl,0,3,8.998362298061752e-6
zafiya,3,girl,0,3,8.998362298061752e-6
zaib,3,girl,0,3,8.998362298061752e-6
zaila,3,girl,0,3,8.998362298061752e-6
zaisha,3,girl,0,3,8.998362298061752e-6
zaiyah,3,girl,0,3,8.998362298061752e-6
zane,3,girl,0,3,8.998362298061752e-6
zani,3,girl,0,3,8.998362298061752e-6
zaniah,3,girl,0,3,8.998362298061752e-6
zanyah,3,girl,0,3,8.998362298061752e-6
zareesh,3,girl,0,3,8.998362298061752e-6
zari,3,girl,0,3,8.998362298061752e-6
zarish,3,girl,0,3,8.998362298061752e-6
zariya,3,girl,0,3,8.998362298061752e-6
zarmeen,3,girl,0,3,8.998362298061752e-6
zehna,3,girl,0,3,8.998362298061752e-6
zeliha,3,girl,0,3,8.998362298061752e-6
zenia,3,girl,1,4,1.1997816397415671e-5
zenobia,3,girl,0,3,8.998362298061752e-6
zenya,3,girl,0,3,8.998362298061752e-6
zerin,3,girl,0,3,8.998362298061752e-6
zhia,3,girl,0,3,8.998362298061752e-6
zina,3,girl,1,4,1.1997816397415671e-5
zinat,3,girl,0,3,8.998362298061752e-6
zinneerah,3,girl,0,3,8.998362298061752e-6
ziyah,3,girl,0,3,8.998362298061752e-6
zohha,3,girl,1,4,1.1997816397415671e-5
zoie,3,girl,2,5,1.4997270496769588e-5
zoraya,3,girl,0,3,8.998362298061752e-6
zsofia,3,girl,0,3,8.998362298061752e-6
zubaida,3,girl,0,3,8.998362298061752e-6
zuhal,3,girl,0,3,8.998362298061752e-6
zuhayra,3,girl,0,3,8.998362298061752e-6
zuhra,3,girl,0,3,8.998362298061752e-6
zunayrah,3,girl,0,3,8.998362298061752e-6
zyla,3,girl,0,3,8.998362298061752e-6
aadarsh,0,boy,1,1,2.7761352310993773e-6
aadrian,0,boy,1,1,2.7761352310993773e-6
aadyanth,0,boy,1,1,2.7761352310993773e-6
aaeryn,0,boy,1,1,2.7761352310993773e-6
aahad,0,boy,1,1,2.7761352310993773e-6
aahyan,0,boy,1,1,2.7761352310993773e-6
aarick,0,boy,1,1,2.7761352310993773e-6
aarley-ray,0,boy,1,1,2.7761352310993773e-6
aarlo,0,boy,1,1,2.7761352310993773e-6
aaron-john,0,boy,1,1,2.7761352310993773e-6
aarran,0,boy,1,1,2.7761352310993773e-6
aarvin,0,boy,1,1,2.7761352310993773e-6
aaryav,0,boy,2,2,5.5522704621987546e-6
aaryn,0,boy,2,2,5.5522704621987546e-6
aaryn-john,0,boy,1,1,2.7761352310993773e-6
aashutosh,0,boy,1,1,2.7761352310993773e-6
abaas,0,boy,1,1,2.7761352310993773e-6
abdelmadjid,0,boy,1,1,2.7761352310993773e-6
abdijabar,0,boy,1,1,2.7761352310993773e-6
abdul-aziz,0,boy,1,1,2.7761352310993773e-6
abdul-rafay,0,boy,1,1,2.7761352310993773e-6
abdul-samee,0,boy,1,1,2.7761352310993773e-6
abdul-wahhab,0,boy,1,1,2.7761352310993773e-6
abdulahad,0,boy,1,1,2.7761352310993773e-6
abdulmohsen,0,boy,1,1,2.7761352310993773e-6
abdussalam,0,boy,1,1,2.7761352310993773e-6
abhik,0,boy,1,1,2.7761352310993773e-6
abiman,0,boy,1,1,2.7761352310993773e-6
abinabi,0,boy,1,1,2.7761352310993773e-6
abiral,0,boy,1,1,2.7761352310993773e-6
aboubakr,0,boy,1,1,2.7761352310993773e-6
acoidan,0,boy,1,1,2.7761352310993773e-6
addie,0,boy,1,1,2.7761352310993773e-6
adebare,0,boy,1,1,2.7761352310993773e-6
adetomiwa,0,boy,1,1,2.7761352310993773e-6
adie,0,boy,4,4,1.1104540924397509e-5
adlai-joziya,0,boy,1,1,2.7761352310993773e-6
adrian-james,0,boy,1,1,2.7761352310993773e-6
advith,0,boy,1,1,2.7761352310993773e-6
aedyn,0,boy,1,1,2.7761352310993773e-6
aeson,0,boy,1,1,2.7761352310993773e-6
aethan,0,boy,1,1,2.7761352310993773e-6
agaba,0,boy,1,1,2.7761352310993773e-6
ahmeed,0,boy,1,1,2.7761352310993773e-6
ahungwa,0,boy,1,1,2.7761352310993773e-6
aidan-hugh,0,boy,1,1,2.7761352310993773e-6
aimal,0,boy,1,1,2.7761352310993773e-6
ainsley-junior,0,boy,1,1,2.7761352310993773e-6
aivis,0,boy,1,1,2.7761352310993773e-6
ajias,0,boy,1,1,2.7761352310993773e-6
akaalbir,0,boy,1,1,2.7761352310993773e-6
akaash,0,boy,1,1,2.7761352310993773e-6
akhil,0,boy,1,1,2.7761352310993773e-6
akims,0,boy,1,1,2.7761352310993773e-6
akinleye,0,boy,1,1,2.7761352310993773e-6
alaa,0,boy,1,1,2.7761352310993773e-6
alamdaar,0,boy,1,1,2.7761352310993773e-6
alano-james,0,boy,1,1,2.7761352310993773e-6
alben,0,boy,1,1,2.7761352310993773e-6
albi-george,0,boy,1,1,2.7761352310993773e-6
albus,0,boy,1,1,2.7761352310993773e-6
aldeign,0,boy,1,1,2.7761352310993773e-6
aleksandras,0,boy,1,1,2.7761352310993773e-6
aleksei,0,boy,1,1,2.7761352310993773e-6
aleksy,0,boy,1,1,2.7761352310993773e-6
alexander-james,0,boy,1,1,2.7761352310993773e-6
alexander-john,0,boy,1,1,2.7761352310993773e-6
alexander-jordan,0,boy,1,1,2.7761352310993773e-6
alfi,0,boy,2,2,5.5522704621987546e-6
alfye,0,boy,1,1,2.7761352310993773e-6
alick,0,boy,1,1,2.7761352310993773e-6
alisdair,0,boy,2,2,5.5522704621987546e-6
aliyu,0,boy,1,1,2.7761352310993773e-6
allain-junior,0,boy,1,1,2.7761352310993773e-6
allan-john,0,boy,1,1,2.7761352310993773e-6
ally,0,boy,3,3,8.328405693298133e-6
alphonsus,0,boy,1,1,2.7761352310993773e-6
alvan,0,boy,1,1,2.7761352310993773e-6
alvar,0,boy,1,1,2.7761352310993773e-6
aly,0,boy,1,1,2.7761352310993773e-6
alyn,0,boy,1,1,2.7761352310993773e-6
amat,0,boy,1,1,2.7761352310993773e-6
amaziyah,0,boy,1,1,2.7761352310993773e-6
ambroise,0,boy,1,1,2.7761352310993773e-6
amedeo,0,boy,1,1,2.7761352310993773e-6
ames,0,boy,1,1,2.7761352310993773e-6
ameziane,0,boy,1,1,2.7761352310993773e-6
amhlaidh,0,boy,1,1,2.7761352310993773e-6
amir-driss,0,boy,1,1,2.7761352310993773e-6
amirul,0,boy,1,1,2.7761352310993773e-6
amyr,0,boy,1,1,2.7761352310993773e-6
anatole,0,boy,1,1,2.7761352310993773e-6
andra,0,boy,2,2,5.5522704621987546e-6
andras,0,boy,1,1,2.7761352310993773e-6
andrew-jayden,0,boy,1,1,2.7761352310993773e-6
andrew-john,0,boy,1,1,2.7761352310993773e-6
andrew-junior,0,boy,1,1,2.7761352310993773e-6
aneel,0,boy,1,1,2.7761352310993773e-6
anesu,0,boy,1,1,2.7761352310993773e-6
anfal,0,boy,1,1,2.7761352310993773e-6
angis,0,boy,1,1,2.7761352310993773e-6
aniello,0,boy,1,1,2.7761352310993773e-6
anisor,0,boy,1,1,2.7761352310993773e-6
aniv,0,boy,1,1,2.7761352310993773e-6
anjolaoluwa,0,boy,1,1,2.7761352310993773e-6
anmar,0,boy,1,1,2.7761352310993773e-6
annas,0,boy,1,1,2.7761352310993773e-6
ansen,0,boy,1,1,2.7761352310993773e-6
anshdeep,0,boy,1,1,2.7761352310993773e-6
anthony-jack,0,boy,1,1,2.7761352310993773e-6
anthony-jon,0,boy,1,1,2.7761352310993773e-6
antu,0,boy,1,1,2.7761352310993773e-6
anvit,0,boy,1,1,2.7761352310993773e-6
anxo,0,boy,1,1,2.7761352310993773e-6
aodhan-james,0,boy,1,1,2.7761352310993773e-6
aonghas,0,boy,1,1,2.7761352310993773e-6
aouab,0,boy,1,1,2.7761352310993773e-6
arainn,0,boy,1,1,2.7761352310993773e-6
ardie,0,boy,1,1,2.7761352310993773e-6
arek,0,boy,1,1,2.7761352310993773e-6
argyle,0,boy,1,1,2.7761352310993773e-6
argyll,0,boy,1,1,2.7761352310993773e-6
aristote,0,boy,1,1,2.7761352310993773e-6
arjit,0,boy,1,1,2.7761352310993773e-6
arome,0,boy,1,1,2.7761352310993773e-6
arosh,0,boy,1,1,2.7761352310993773e-6
arragon,0,boy,1,1,2.7761352310993773e-6
arran-james,0,boy,1,1,2.7761352310993773e-6
arrauf,0,boy,1,1,2.7761352310993773e-6
arro,0,boy,1,1,2.7761352310993773e-6
arryn,0,boy,2,2,5.5522704621987546e-6
arsakha,0,boy,1,1,2.7761352310993773e-6
arsheq,0,boy,1,1,2.7761352310993773e-6
arsyaditama,0,boy,1,1,2.7761352310993773e-6
arteen,0,boy,1,1,2.7761352310993773e-6
artel,0,boy,1,1,2.7761352310993773e-6
arthur-william,0,boy,1,1,2.7761352310993773e-6
arvie,0,boy,1,1,2.7761352310993773e-6
aryan-kiyan,0,boy,1,1,2.7761352310993773e-6
arys,0,boy,1,1,2.7761352310993773e-6
asfand,0,boy,1,1,2.7761352310993773e-6
ashdyn,0,boy,1,1,2.7761352310993773e-6
ashlamari,0,boy,1,1,2.7761352310993773e-6
ashvihan,0,boy,1,1,2.7761352310993773e-6
asir,0,boy,1,1,2.7761352310993773e-6
aston-jax,0,boy,1,1,2.7761352310993773e-6
atholl,0,boy,1,1,2.7761352310993773e-6
atmanand,0,boy,1,1,2.7761352310993773e-6
aubai,0,boy,1,1,2.7761352310993773e-6
aulay,0,boy,6,6,1.6656811386596265e-5
auley,0,boy,3,3,8.328405693298133e-6
aurel,0,boy,1,1,2.7761352310993773e-6
aurhyn,0,boy,1,1,2.7761352310993773e-6
auston,0,boy,1,1,2.7761352310993773e-6
avnoor,0,boy,1,1,2.7761352310993773e-6
aybel,0,boy,1,1,2.7761352310993773e-6
ayden-john,0,boy,1,1,2.7761352310993773e-6
ayjai,0,boy,1,1,2.7761352310993773e-6
aylen,0,boy,1,1,2.7761352310993773e-6
aylo,0,boy,1,1,2.7761352310993773e-6
aymar,0,boy,1,1,2.7761352310993773e-6
ayomide-david,0,boy,1,1,2.7761352310993773e-6
ayren,0,boy,1,1,2.7761352310993773e-6
ayrin,0,boy,1,1,2.7761352310993773e-6
ayron,0,boy,1,1,2.7761352310993773e-6
ayven,0,boy,1,1,2.7761352310993773e-6
ayyad,0,boy,1,1,2.7761352310993773e-6
azmar,0,boy,1,1,2.7761352310993773e-6
azz,0,boy,1,1,2.7761352310993773e-6
azzan,0,boy,1,1,2.7761352310993773e-6
bahid,0,boy,1,1,2.7761352310993773e-6
bahos,0,boy,1,1,2.7761352310993773e-6
baillie,0,boy,1,1,2.7761352310993773e-6
bain,0,boy,1,1,2.7761352310993773e-6
baird,0,boy,1,1,2.7761352310993773e-6
balfour,0,boy,1,1,2.7761352310993773e-6
balin,0,boy,1,1,2.7761352310993773e-6
barizar,0,boy,1,1,2.7761352310993773e-6
barzan,0,boy,1,1,2.7761352310993773e-6
basel,0,boy,1,1,2.7761352310993773e-6
benzhi,0,boy,1,1,2.7761352310993773e-6
berzan,0,boy,1,1,2.7761352310993773e-6
bhevin,0,boy,1,1,2.7761352310993773e-6
bhodi,0,boy,1,1,2.7761352310993773e-6
bhradain,0,boy,1,1,2.7761352310993773e-6
billie,0,boy,1,1,2.7761352310993773e-6
billy-dean,0,boy,1,1,2.7761352310993773e-6
billy-jo,0,boy,1,1,2.7761352310993773e-6
birrell,0,boy,1,1,2.7761352310993773e-6
blaik,0,boy,1,1,2.7761352310993773e-6
blane,0,boy,1,1,2.7761352310993773e-6
blase,0,boy,1,1,2.7761352310993773e-6
blayne,0,boy,2,2,5.5522704621987546e-6
blyss,0,boy,1,1,2.7761352310993773e-6
blyth,0,boy,2,2,5.5522704621987546e-6
bobbey,0,boy,1,1,2.7761352310993773e-6
bodi,0,boy,1,1,2.7761352310993773e-6
boew,0,boy,1,1,2.7761352310993773e-6
bohden,0,boy,1,1,2.7761352310993773e-6
boi,0,boy,1,1,2.7761352310993773e-6
boon,0,boy,1,1,2.7761352310993773e-6
boyd,0,boy,5,5,1.3880676155496887e-5
brad,0,boy,1,1,2.7761352310993773e-6
bradly,0,boy,1,1,2.7761352310993773e-6
brahmtej,0,boy,1,1,2.7761352310993773e-6
braiden-scott,0,boy,1,1,2.7761352310993773e-6
braiens,0,boy,1,1,2.7761352310993773e-6
braigh,0,boy,1,1,2.7761352310993773e-6
brandyn,0,boy,1,1,2.7761352310993773e-6
braven,0,boy,1,1,2.7761352310993773e-6
braxden,0,boy,1,1,2.7761352310993773e-6
braxtyn,0,boy,1,1,2.7761352310993773e-6
braxx,0,boy,1,1,2.7761352310993773e-6
braylan,0,boy,1,1,2.7761352310993773e-6
breandan,0,boy,1,1,2.7761352310993773e-6
brenton,0,boy,2,2,5.5522704621987546e-6
bretton,0,boy,1,1,2.7761352310993773e-6
brian-anthony,0,boy,1,1,2.7761352310993773e-6
brice,0,boy,1,1,2.7761352310993773e-6
brin,0,boy,1,1,2.7761352310993773e-6
broady,0,boy,1,1,2.7761352310993773e-6
brochan,0,boy,1,1,2.7761352310993773e-6
brodan,0,boy,1,1,2.7761352310993773e-6
brodyn,0,boy,1,1,2.7761352310993773e-6
broux,0,boy,1,1,2.7761352310993773e-6
bryden,0,boy,2,2,5.5522704621987546e-6
brydone,0,boy,1,1,2.7761352310993773e-6
brysen,0,boy,1,1,2.7761352310993773e-6
burton,0,boy,1,1,2.7761352310993773e-6
bzhean,0,boy,1,1,2.7761352310993773e-6
c-jay,0,boy,2,2,5.5522704621987546e-6
cacey,0,boy,1,1,2.7761352310993773e-6
cadin,0,boy,1,1,2.7761352310993773e-6
caeden,0,boy,3,3,8.328405693298133e-6
caegan,0,boy,1,1,2.7761352310993773e-6
caelin,0,boy,2,2,5.5522704621987546e-6
caelum,0,boy,1,1,2.7761352310993773e-6
caelyn-jaye,0,boy,1,1,2.7761352310993773e-6
caidan,0,boy,1,1,2.7761352310993773e-6
caide,0,boy,1,1,2.7761352310993773e-6
caiene,0,boy,1,1,2.7761352310993773e-6
cailean,0,boy,14,14,3.886589323539128e-5
caileon,0,boy,1,1,2.7761352310993773e-6
cailin,0,boy,2,2,5.5522704621987546e-6
caillen,0,boy,1,1,2.7761352310993773e-6
cairn,0,boy,9,9,2.4985217079894396e-5
caisey,0,boy,1,1,2.7761352310993773e-6
calaeb,0,boy,1,1,2.7761352310993773e-6
calan,0,boy,4,4,1.1104540924397509e-5
calder,0,boy,4,4,1.1104540924397509e-5
caleb-jay,0,boy,1,1,2.7761352310993773e-6
caleb-ryan,0,boy,1,1,2.7761352310993773e-6
caled,0,boy,1,1,2.7761352310993773e-6
calix-hans,0,boy,1,1,2.7761352310993773e-6
calley,0,boy,1,1,2.7761352310993773e-6
callie,0,boy,1,1,2.7761352310993773e-6
calvin-daniel,0,boy,1,1,2.7761352310993773e-6
calvinlee,0,boy,1,1,2.7761352310993773e-6
cameron-jack,0,boy,1,1,2.7761352310993773e-6
cammie,0,boy,1,1,2.7761352310993773e-6
cammy,0,boy,2,2,5.5522704621987546e-6
camryn,0,boy,2,2,5.5522704621987546e-6
carl-peter,0,boy,1,1,2.7761352310993773e-6
carsyn,0,boy,1,1,2.7761352310993773e-6
cas,0,boy,1,1,2.7761352310993773e-6
cayenne,0,boy,1,1,2.7761352310993773e-6
caylin,0,boy,1,1,2.7761352310993773e-6
ceiran,0,boy,2,2,5.5522704621987546e-6
chanakya,0,boy,1,1,2.7761352310993773e-6
chaniel,0,boy,1,1,2.7761352310993773e-6
channing,0,boy,1,1,2.7761352310993773e-6
charlie-dunbar,0,boy,1,1,2.7761352310993773e-6
chaudhary,0,boy,1,1,2.7761352310993773e-6
chaydenn,0,boy,1,1,2.7761352310993773e-6
chen,0,boy,3,3,8.328405693298133e-6
cherno,0,boy,1,1,2.7761352310993773e-6
chian,0,boy,1,1,2.7761352310993773e-6
chibuanyam,0,boy,1,1,2.7761352310993773e-6
chidiebubu,0,boy,1,1,2.7761352310993773e-6
chijioke,0,boy,1,1,2.7761352310993773e-6
chimaraobim,0,boy,1,1,2.7761352310993773e-6
chimkasi,0,boy,1,1,2.7761352310993773e-6
chinedum,0,boy,1,1,2.7761352310993773e-6
chinua,0,boy,2,2,5.5522704621987546e-6
chongxuan,0,boy,1,1,2.7761352310993773e-6
chris-laurell,0,boy,1,1,2.7761352310993773e-6
christo,0,boy,1,1,2.7761352310993773e-6
christy,0,boy,2,2,5.5522704621987546e-6
chukwusom,0,boy,1,1,2.7761352310993773e-6
ciar,0,boy,1,1,2.7761352310993773e-6
cieran,0,boy,2,2,5.5522704621987546e-6
cillean,0,boy,1,1,2.7761352310993773e-6
cinaed,0,boy,1,1,2.7761352310993773e-6
ciprian,0,boy,1,1,2.7761352310993773e-6
cjay,0,boy,1,1,2.7761352310993773e-6
claiden,0,boy,1,1,2.7761352310993773e-6
claye,0,boy,2,2,5.5522704621987546e-6
coan,0,boy,1,1,2.7761352310993773e-6
coban,0,boy,1,1,2.7761352310993773e-6
cobin,0,boy,1,1,2.7761352310993773e-6
cobyn,0,boy,2,2,5.5522704621987546e-6
codeigh,0,boy,1,1,2.7761352310993773e-6
coel,0,boy,1,1,2.7761352310993773e-6
cogan,0,boy,1,1,2.7761352310993773e-6
coinneach,0,boy,3,3,8.328405693298133e-6
colin-junior,0,boy,1,1,2.7761352310993773e-6
conal,0,boy,5,5,1.3880676155496887e-5
conal-jack,0,boy,1,1,2.7761352310993773e-6
conan-michael,0,boy,1,1,2.7761352310993773e-6
conell,0,boy,1,1,2.7761352310993773e-6
conlan,0,boy,7,7,1.943294661769564e-5
conleth,0,boy,1,1,2.7761352310993773e-6
conlin,0,boy,1,1,2.7761352310993773e-6
conlon,0,boy,2,2,5.5522704621987546e-6
conlyn,0,boy,3,3,8.328405693298133e-6
connal,0,boy,1,1,2.7761352310993773e-6
connall,0,boy,1,1,2.7761352310993773e-6
connar,0,boy,2,2,5.5522704621987546e-6
connel,0,boy,1,1,2.7761352310993773e-6
conner-william,0,boy,1,1,2.7761352310993773e-6
connier,0,boy,1,1,2.7761352310993773e-6
connol,0,boy,1,1,2.7761352310993773e-6
connolly,0,boy,1,1,2.7761352310993773e-6
conol,0,boy,1,1,2.7761352310993773e-6
constantino,0,boy,1,1,2.7761352310993773e-6
cooper-jae,0,boy,1,1,2.7761352310993773e-6
copeland,0,boy,1,1,2.7761352310993773e-6
copland,0,boy,1,1,2.7761352310993773e-6
corann,0,boy,1,1,2.7761352310993773e-6
corbynn,0,boy,1,1,2.7761352310993773e-6
cormack,0,boy,1,1,2.7761352310993773e-6
corran,0,boy,5,5,1.3880676155496887e-5
correy,0,boy,3,3,8.328405693298133e-6
corrie,0,boy,3,3,8.328405693298133e-6
corry,0,boy,2,2,5.5522704621987546e-6
corvyn,0,boy,1,1,2.7761352310993773e-6
couper,0,boy,2,2,5.5522704621987546e-6
coy,0,boy,1,1,2.7761352310993773e-6
crawford,0,boy,3,3,8.328405693298133e-6
creaghan,0,boy,1,1,2.7761352310993773e-6
creed,0,boy,1,1,2.7761352310993773e-6
cru,0,boy,1,1,2.7761352310993773e-6
cupar,0,boy,2,2,5.5522704621987546e-6
cye,0,boy,1,1,2.7761352310993773e-6
d'angelo-santiago,0,boy,1,1,2.7761352310993773e-6
daeb,0,boy,1,1,2.7761352310993773e-6
daegan,0,boy,1,1,2.7761352310993773e-6
daire,0,boy,1,1,2.7761352310993773e-6
dakshit,0,boy,1,1,2.7761352310993773e-6
dali,0,boy,1,1,2.7761352310993773e-6
dalleas,0,boy,1,1,2.7761352310993773e-6
damars,0,boy,1,1,2.7761352310993773e-6
damilson,0,boy,1,1,2.7761352310993773e-6
dana,0,boy,1,1,2.7761352310993773e-6
danaidh,0,boy,2,2,5.5522704621987546e-6
daniel-andrei,0,boy,1,1,2.7761352310993773e-6
daniel-john,0,boy,1,1,2.7761352310993773e-6
daniel-louis,0,boy,1,1,2.7761352310993773e-6
danimir,0,boy,1,1,2.7761352310993773e-6
dannie,0,boy,1,1,2.7761352310993773e-6
dantay,0,boy,1,1,2.7761352310993773e-6
dany,0,boy,1,1,2.7761352310993773e-6
darach,0,boy,1,1,2.7761352310993773e-6
daragh,0,boy,2,2,5.5522704621987546e-6
darbara,0,boy,1,1,2.7761352310993773e-6
darby-james,0,boy,1,1,2.7761352310993773e-6
dariyan,0,boy,1,1,2.7761352310993773e-6
darrach,0,boy,1,1,2.7761352310993773e-6
darren-andrew,0,boy,1,1,2.7761352310993773e-6
daryn,0,boy,1,1,2.7761352310993773e-6
david-jay,0,boy,1,1,2.7761352310993773e-6
david-john,0,boy,1,1,2.7761352310993773e-6
david-madalin,0,boy,1,1,2.7761352310993773e-6
david-paul,0,boy,1,1,2.7761352310993773e-6
dayle,0,boy,1,1,2.7761352310993773e-6
deakin,0,boy,1,1,2.7761352310993773e-6
deakyn,0,boy,1,1,2.7761352310993773e-6
declyn,0,boy,1,1,2.7761352310993773e-6
demid,0,boy,1,1,2.7761352310993773e-6
denholm,0,boy,1,1,2.7761352310993773e-6
denim,0,boy,1,1,2.7761352310993773e-6
denis-jack,0,boy,1,1,2.7761352310993773e-6
dennin,0,boy,1,1,2.7761352310993773e-6
dennis-junior,0,boy,1,1,2.7761352310993773e-6
dennon,0,boy,1,1,2.7761352310993773e-6
deryn,0,boy,1,1,2.7761352310993773e-6
deveron,0,boy,1,1,2.7761352310993773e-6
devesh,0,boy,1,1,2.7761352310993773e-6
devids,0,boy,1,1,2.7761352310993773e-6
devlyn,0,boy,1,1,2.7761352310993773e-6
devran,0,boy,1,1,2.7761352310993773e-6
devyansh,0,boy,1,1,2.7761352310993773e-6
dewar,0,boy,1,1,2.7761352310993773e-6
dhanjay,0,boy,1,1,2.7761352310993773e-6
dhruvah,0,boy,1,1,2.7761352310993773e-6
dhruven,0,boy,1,1,2.7761352310993773e-6
diaa,0,boy,1,1,2.7761352310993773e-6
dieter,0,boy,1,1,2.7761352310993773e-6
dilbag,0,boy,1,1,2.7761352310993773e-6
diljit,0,boy,1,1,2.7761352310993773e-6
dixon,0,boy,1,1,2.7761352310993773e-6
djahmyne,0,boy,1,1,2.7761352310993773e-6
dogan,0,boy,1,1,2.7761352310993773e-6
domhnall,0,boy,2,2,5.5522704621987546e-6
domnick,0,boy,1,1,2.7761352310993773e-6
donal,0,boy,2,2,5.5522704621987546e-6
donan,0,boy,1,1,2.7761352310993773e-6
donavan,0,boy,1,1,2.7761352310993773e-6
dong,0,boy,1,1,2.7761352310993773e-6
doogie,0,boy,1,1,2.7761352310993773e-6
dragos-ionut,0,boy,1,1,2.7761352310993773e-6
dravin,0,boy,1,1,2.7761352310993773e-6
dren,0,boy,1,1,2.7761352310993773e-6
drostan,0,boy,1,1,2.7761352310993773e-6
drurie,0,boy,1,1,2.7761352310993773e-6
duncan-james,0,boy,1,1,2.7761352310993773e-6
duncan-junior,0,boy,1,1,2.7761352310993773e-6
duruv,0,boy,1,1,2.7761352310993773e-6
dwyatt,0,boy,1,1,2.7761352310993773e-6
dylan-andrew,0,boy,1,1,2.7761352310993773e-6
eachann,0,boy,1,1,2.7761352310993773e-6
easah,0,boy,1,1,2.7761352310993773e-6
ecka,0,boy,1,1,2.7761352310993773e-6
edikan,0,boy,1,1,2.7761352310993773e-6
edvinas,0,boy,1,1,2.7761352310993773e-6
edwin-jaxon,0,boy,1,1,2.7761352310993773e-6
eero,0,boy,1,1,2.7761352310993773e-6
ehvan,0,boy,1,1,2.7761352310993773e-6
eimad,0,boy,1,1,2.7761352310993773e-6
ekansh,0,boy,1,1,2.7761352310993773e-6
eknoor,0,boy,1,1,2.7761352310993773e-6
el-ameen,0,boy,1,1,2.7761352310993773e-6
elcio,0,boy,1,1,2.7761352310993773e-6
eliaas,0,boy,1,1,2.7761352310993773e-6
elijah-lee,0,boy,2,2,5.5522704621987546e-6
elikem,0,boy,1,1,2.7761352310993773e-6
elikia,0,boy,1,1,2.7761352310993773e-6
ellys,0,boy,1,1,2.7761352310993773e-6
eloy,0,boy,1,1,2.7761352310993773e-6
elyjah,0,boy,1,1,2.7761352310993773e-6
emilius,0,boy,1,1,2.7761352310993773e-6
emillio,0,boy,1,1,2.7761352310993773e-6
emmett-edward,0,boy,1,1,2.7761352310993773e-6
emylton,0,boy,1,1,2.7761352310993773e-6
en,0,boy,1,1,2.7761352310993773e-6
eneko,0,boy,1,1,2.7761352310993773e-6
enoh,0,boy,1,1,2.7761352310993773e-6
eric-james,0,boy,1,1,2.7761352310993773e-6
erland,0,boy,1,1,2.7761352310993773e-6
erlend,0,boy,1,1,2.7761352310993773e-6
ersion,0,boy,1,1,2.7761352310993773e-6
ertie,0,boy,1,1,2.7761352310993773e-6
erving,0,boy,1,1,2.7761352310993773e-6
esca,0,boy,1,1,2.7761352310993773e-6
eshu,0,boy,1,1,2.7761352310993773e-6
esmael,0,boy,1,1,2.7761352310993773e-6
esra,0,boy,1,1,2.7761352310993773e-6
essah,0,boy,1,1,2.7761352310993773e-6
ethayn,0,boy,1,1,2.7761352310993773e-6
ethyn,0,boy,3,3,8.328405693298133e-6
etta,0,boy,1,1,2.7761352310993773e-6
evahn,0,boy,1,1,2.7761352310993773e-6
everest,0,boy,1,1,2.7761352310993773e-6
ewen,0,boy,10,10,2.7761352310993775e-5
ewoma-zino,0,boy,1,1,2.7761352310993773e-6
faariz,0,boy,1,1,2.7761352310993773e-6
faidon,0,boy,1,1,2.7761352310993773e-6
faluin,0,boy,1,1,2.7761352310993773e-6
fan,0,boy,1,1,2.7761352310993773e-6
farhee,0,boy,1,1,2.7761352310993773e-6
fearghas,0,boy,1,1,2.7761352310993773e-6
fearghus,0,boy,1,1,2.7761352310993773e-6
feo,0,boy,1,1,2.7761352310993773e-6
ferdie,0,boy,1,1,2.7761352310993773e-6
fergie,0,boy,2,2,5.5522704621987546e-6
fiach,0,boy,1,1,2.7761352310993773e-6
finlas,0,boy,1,1,2.7761352310993773e-6
finnbhair,0,boy,1,1,2.7761352310993773e-6
fionnbharr,0,boy,1,1,2.7761352310993773e-6
flint,0,boy,2,2,5.5522704621987546e-6
floinn,0,boy,1,1,2.7761352310993773e-6
fountain,0,boy,1,1,2.7761352310993773e-6
fox-valentine,0,boy,1,1,2.7761352310993773e-6
francisk,0,boy,1,1,2.7761352310993773e-6
fredy,0,boy,1,1,2.7761352310993773e-6
fyn,0,boy,2,2,5.5522704621987546e-6
fynton,0,boy,1,1,2.7761352310993773e-6
gaius,0,boy,1,1,2.7761352310993773e-6
gallacher,0,boy,1,1,2.7761352310993773e-6
garikoitz,0,boy,1,1,2.7761352310993773e-6
gautam,0,boy,2,2,5.5522704621987546e-6
gazi,0,boy,2,2,5.5522704621987546e-6
geo,0,boy,1,1,2.7761352310993773e-6
geonwoo,0,boy,1,1,2.7761352310993773e-6
geordie,0,boy,4,4,1.1104540924397509e-5
geovany,0,boy,1,1,2.7761352310993773e-6
gerardo,0,boy,1,1,2.7761352310993773e-6
ghaleb,0,boy,1,1,2.7761352310993773e-6
ghillie,0,boy,1,1,2.7761352310993773e-6
gianfranco,0,boy,1,1,2.7761352310993773e-6
gianmarco,0,boy,1,1,2.7761352310993773e-6
gijs,0,boy,1,1,2.7761352310993773e-6
gillan,0,boy,1,1,2.7761352310993773e-6
gillies,0,boy,3,3,8.328405693298133e-6
giuliano,0,boy,1,1,2.7761352310993773e-6
glebs,0,boy,1,1,2.7761352310993773e-6
goddominion,0,boy,1,1,2.7761352310993773e-6
godfrey,0,boy,1,1,2.7761352310993773e-6
godstime,0,boy,1,1,2.7761352310993773e-6
goten,0,boy,1,1,2.7761352310993773e-6
graeme,0,boy,2,2,5.5522704621987546e-6
graeson,0,boy,1,1,2.7761352310993773e-6
graycen,0,boy,1,1,2.7761352310993773e-6
greg,0,boy,2,2,5.5522704621987546e-6
gregair,0,boy,1,1,2.7761352310993773e-6
gregg,0,boy,1,1,2.7761352310993773e-6
greig,0,boy,2,2,5.5522704621987546e-6
gurash,0,boy,1,1,2.7761352310993773e-6
gurbaaz,0,boy,1,1,2.7761352310993773e-6
gurempal,0,boy,1,1,2.7761352310993773e-6
guriy,0,boy,1,1,2.7761352310993773e-6
gurmann,0,boy,1,1,2.7761352310993773e-6
gursewak,0,boy,1,1,2.7761352310993773e-6
guthrie,0,boy,1,1,2.7761352310993773e-6
haakon,0,boy,1,1,2.7761352310993773e-6
haariys,0,boy,1,1,2.7761352310993773e-6
hadrien,0,boy,1,1,2.7761352310993773e-6
haig,0,boy,1,1,2.7761352310993773e-6
haldon,0,boy,1,1,2.7761352310993773e-6
halliday,0,boy,1,1,2.7761352310993773e-6
hamed,0,boy,1,1,2.7761352310993773e-6
hanaan,0,boy,1,1,2.7761352310993773e-6
hanfei,0,boy,1,1,2.7761352310993773e-6
hanlon,0,boy,1,1,2.7761352310993773e-6
harjinder,0,boy,1,1,2.7761352310993773e-6
harley-austin,0,boy,1,1,2.7761352310993773e-6
harley-davidson,0,boy,1,1,2.7761352310993773e-6
harley-lee,0,boy,1,1,2.7761352310993773e-6
harley-oscar,0,boy,1,1,2.7761352310993773e-6
harley-scott,0,boy,1,1,2.7761352310993773e-6
harli-jak,0,boy,1,1,2.7761352310993773e-6
haroldas,0,boy,1,1,2.7761352310993773e-6
harrison-blake,0,boy,1,1,2.7761352310993773e-6
harrison-jay,0,boy,1,1,2.7761352310993773e-6
harrisyn,0,boy,1,1,2.7761352310993773e-6
harsh,0,boy,1,1,2.7761352310993773e-6
harshit,0,boy,1,1,2.7761352310993773e-6
harvard,0,boy,1,1,2.7761352310993773e-6
hary,0,boy,1,1,2.7761352310993773e-6
haryson,0,boy,1,1,2.7761352310993773e-6
hasaan,0,boy,1,1,2.7761352310993773e-6
hassam,0,boy,1,1,2.7761352310993773e-6
hattan,0,boy,1,1,2.7761352310993773e-6
hayes,0,boy,1,1,2.7761352310993773e-6
haygan,0,boy,1,1,2.7761352310993773e-6
hayyden,0,boy,1,1,2.7761352310993773e-6
henrick,0,boy,1,1,2.7761352310993773e-6
hernan,0,boy,1,1,2.7761352310993773e-6
hidar,0,boy,1,1,2.7761352310993773e-6
himaksh,0,boy,1,1,2.7761352310993773e-6
himansh,0,boy,1,1,2.7761352310993773e-6
hjalte,0,boy,1,1,2.7761352310993773e-6
hobbes,0,boy,1,1,2.7761352310993773e-6
honor,0,boy,1,1,2.7761352310993773e-6
hooper,0,boy,1,1,2.7761352310993773e-6
houd,0,boy,1,1,2.7761352310993773e-6
hozaifa,0,boy,1,1,2.7761352310993773e-6
hrishit,0,boy,1,1,2.7761352310993773e-6
huthayfa,0,boy,1,1,2.7761352310993773e-6
iacob,0,boy,1,1,2.7761352310993773e-6
iavor,0,boy,1,1,2.7761352310993773e-6
ieremia,0,boy,1,1,2.7761352310993773e-6
ikshan,0,boy,1,1,2.7761352310993773e-6
ilakkiyen,0,boy,1,1,2.7761352310993773e-6
ilham,0,boy,1,1,2.7761352310993773e-6
imants,0,boy,1,1,2.7761352310993773e-6
immanuvel,0,boy,1,1,2.7761352310993773e-6
inayaat,0,boy,1,1,2.7761352310993773e-6
innis,0,boy,4,4,1.1104540924397509e-5
irvine,0,boy,4,4,1.1104540924397509e-5
isaac-jacob,0,boy,1,1,2.7761352310993773e-6
israfil,0,boy,1,1,2.7761352310993773e-6
iteoluwakiisi,0,boy,1,1,2.7761352310993773e-6
ixacc,0,boy,1,1,2.7761352310993773e-6
iyes,0,boy,1,1,2.7761352310993773e-6
izedin,0,boy,1,1,2.7761352310993773e-6
jaac,0,boy,1,1,2.7761352310993773e-6
jace-john,0,boy,1,1,2.7761352310993773e-6
jachym,0,boy,1,1,2.7761352310993773e-6
jack-myles,0,boy,1,1,2.7761352310993773e-6
jack-xavier,0,boy,1,1,2.7761352310993773e-6
jadyn,0,boy,1,1,2.7761352310993773e-6
jae-roy,0,boy,1,1,2.7761352310993773e-6
jaelyn,0,boy,1,1,2.7761352310993773e-6
jafiya,0,boy,1,1,2.7761352310993773e-6
jagjeet,0,boy,1,1,2.7761352310993773e-6
jagveer,0,boy,1,1,2.7761352310993773e-6
jaiden-john,0,boy,1,1,2.7761352310993773e-6
jaidyn,0,boy,1,1,2.7761352310993773e-6
jaiiden,0,boy,1,1,2.7761352310993773e-6
jako,0,boy,1,1,2.7761352310993773e-6
jakyb,0,boy,1,1,2.7761352310993773e-6
jalil,0,boy,1,1,2.7761352310993773e-6
james-allan,0,boy,2,2,5.5522704621987546e-6
james-john,0,boy,1,1,2.7761352310993773e-6
jamie-lewis,0,boy,1,1,2.7761352310993773e-6
jamie-terence,0,boy,1,1,2.7761352310993773e-6
jangbir,0,boy,1,1,2.7761352310993773e-6
japhet,0,boy,1,1,2.7761352310993773e-6
japjit,0,boy,1,1,2.7761352310993773e-6
jaromir,0,boy,1,1,2.7761352310993773e-6
jarrah,0,boy,1,1,2.7761352310993773e-6
jasper-james,0,boy,1,1,2.7761352310993773e-6
jathniel,0,boy,1,1,2.7761352310993773e-6
jaxon-carter,0,boy,1,1,2.7761352310993773e-6
jaxyn,0,boy,4,4,1.1104540924397509e-5
jaxz,0,boy,1,1,2.7761352310993773e-6
jay-jai,0,boy,1,1,2.7761352310993773e-6
jaybril,0,boy,1,1,2.7761352310993773e-6
jayden-mark,0,boy,1,1,2.7761352310993773e-6
jayden-paul,0,boy,1,1,2.7761352310993773e-6
jaydenjames,0,boy,1,1,2.7761352310993773e-6
jaydin,0,boy,1,1,2.7761352310993773e-6
jaydn,0,boy,1,1,2.7761352310993773e-6
jayme,0,boy,1,1,2.7761352310993773e-6
jaymi,0,boy,1,1,2.7761352310993773e-6
jaymie,0,boy,2,2,5.5522704621987546e-6
jean-jacques,0,boy,1,1,2.7761352310993773e-6
jed-jnr,0,boy,1,1,2.7761352310993773e-6
jeemie,0,boy,1,1,2.7761352310993773e-6
jeeo,0,boy,1,1,2.7761352310993773e-6
jegors,0,boy,1,1,2.7761352310993773e-6
jeitt,0,boy,1,1,2.7761352310993773e-6
jemuel,0,boy,1,1,2.7761352310993773e-6
jenosh,0,boy,1,1,2.7761352310993773e-6
jensyn-john,0,boy,1,1,2.7761352310993773e-6
jeremiasz,0,boy,1,1,2.7761352310993773e-6
jeremy-james,0,boy,1,1,2.7761352310993773e-6
jervis,0,boy,1,1,2.7761352310993773e-6
jethro-james,0,boy,1,1,2.7761352310993773e-6
jevyn,0,boy,1,1,2.7761352310993773e-6
jiahang,0,boy,1,1,2.7761352310993773e-6
joakim,0,boy,1,1,2.7761352310993773e-6
jock,0,boy,3,3,8.328405693298133e-6
joey-valentin,0,boy,1,1,2.7761352310993773e-6
john-alexander,0,boy,1,1,2.7761352310993773e-6
johnnous,0,boy,1,1,2.7761352310993773e-6
jonasz-darach,0,boy,1,1,2.7761352310993773e-6
jonpaul,0,boy,1,1,2.7761352310993773e-6
jood,0,boy,1,1,2.7761352310993773e-6
joonwon,0,boy,1,1,2.7761352310993773e-6
jordan-james,0,boy,1,1,2.7761352310993773e-6
jordie,0,boy,1,1,2.7761352310993773e-6
joses,0,boy,1,1,2.7761352310993773e-6
joshua-david,0,boy,1,1,2.7761352310993773e-6
joshua-jared,0,boy,1,1,2.7761352310993773e-6
josif,0,boy,1,1,2.7761352310993773e-6
jude-jaxson,0,boy,1,1,2.7761352310993773e-6
jude-joseph,0,boy,1,1,2.7761352310993773e-6
julen,0,boy,2,2,5.5522704621987546e-6
julez,0,boy,1,1,2.7761352310993773e-6
juliano,0,boy,1,1,2.7761352310993773e-6
junior-jay,0,boy,1,1,2.7761352310993773e-6
jussi,0,boy,1,1,2.7761352310993773e-6
jy,0,boy,1,1,2.7761352310993773e-6
jye,0,boy,1,1,2.7761352310993773e-6
jynxx-blu,0,boy,1,1,2.7761352310993773e-6
jyoti,0,boy,1,1,2.7761352310993773e-6
kaamil,0,boy,1,1,2.7761352310993773e-6
kabes,0,boy,1,1,2.7761352310993773e-6
kacius,0,boy,1,1,2.7761352310993773e-6
kadyn,0,boy,1,1,2.7761352310993773e-6
kaedan,0,boy,1,1,2.7761352310993773e-6
kaeleb,0,boy,2,2,5.5522704621987546e-6
kaern,0,boy,1,1,2.7761352310993773e-6
kaeto,0,boy,1,1,2.7761352310993773e-6
kaetochi,0,boy,1,1,2.7761352310993773e-6
kahl,0,boy,1,1,2.7761352310993773e-6
kahle,0,boy,1,1,2.7761352310993773e-6
kai-lewis,0,boy,1,1,2.7761352310993773e-6
kai-steven,0,boy,1,1,2.7761352310993773e-6
kai-thomas,0,boy,1,1,2.7761352310993773e-6
kaicen,0,boy,1,1,2.7761352310993773e-6
kaidyn,0,boy,1,1,2.7761352310993773e-6
kaihyan,0,boy,1,1,2.7761352310993773e-6
kailash,0,boy,1,1,2.7761352310993773e-6
kailer,0,boy,1,1,2.7761352310993773e-6
kailin,0,boy,1,1,2.7761352310993773e-6
kainen,0,boy,1,1,2.7761352310993773e-6
kairyn,0,boy,1,1,2.7761352310993773e-6
kaissen,0,boy,1,1,2.7761352310993773e-6
kaitochiemeka,0,boy,1,1,2.7761352310993773e-6
kaizer,0,boy,1,1,2.7761352310993773e-6
kalam,0,boy,1,1,2.7761352310993773e-6
kale,0,boy,1,1,2.7761352310993773e-6
kaleb-kieran,0,boy,1,1,2.7761352310993773e-6
kalib,0,boy,1,1,2.7761352310993773e-6
kalibo,0,boy,1,1,2.7761352310993773e-6
kalim,0,boy,1,1,2.7761352310993773e-6
kallan,0,boy,3,3,8.328405693298133e-6
kallen,0,boy,1,1,2.7761352310993773e-6
kalvyn,0,boy,3,3,8.328405693298133e-6
kami,0,boy,1,1,2.7761352310993773e-6
kammy,0,boy,1,1,2.7761352310993773e-6
kamren,0,boy,1,1,2.7761352310993773e-6
kamsiyo,0,boy,1,1,2.7761352310993773e-6
karanjeet,0,boy,1,1,2.7761352310993773e-6
kardyn-jay,0,boy,1,1,2.7761352310993773e-6
karlis,0,boy,1,1,2.7761352310993773e-6
karlton,0,boy,1,1,2.7761352310993773e-6
karlyle,0,boy,1,1,2.7761352310993773e-6
karsen,0,boy,1,1,2.7761352310993773e-6
karsyn,0,boy,2,2,5.5522704621987546e-6
karter-jay,0,boy,1,1,2.7761352310993773e-6
kartney,0,boy,1,1,2.7761352310993773e-6
kasch,0,boy,1,1,2.7761352310993773e-6
kashi,0,boy,1,1,2.7761352310993773e-6
kaspars,0,boy,1,1,2.7761352310993773e-6
kaue,0,boy,1,1,2.7761352310993773e-6
kauly,0,boy,1,1,2.7761352310993773e-6
kaveh,0,boy,1,1,2.7761352310993773e-6
kawa,0,boy,1,1,2.7761352310993773e-6
kayden-imran,0,boy,1,1,2.7761352310993773e-6
kaydin,0,boy,1,1,2.7761352310993773e-6
kayetan,0,boy,1,1,2.7761352310993773e-6
kayler,0,boy,1,1,2.7761352310993773e-6
kaylin,0,boy,2,2,5.5522704621987546e-6
kayn,0,boy,1,1,2.7761352310993773e-6
kearney,0,boy,1,1,2.7761352310993773e-6
keeyan,0,boy,1,1,2.7761352310993773e-6
keigen,0,boy,1,1,2.7761352310993773e-6
keigyn,0,boy,1,1,2.7761352310993773e-6
keillan,0,boy,1,1,2.7761352310993773e-6
kelbie,0,boy,1,1,2.7761352310993773e-6
keller,0,boy,1,1,2.7761352310993773e-6
kelly,0,boy,1,1,2.7761352310993773e-6
kelso,0,boy,1,1,2.7761352310993773e-6
kelvan,0,boy,1,1,2.7761352310993773e-6
kenil,0,boy,1,1,2.7761352310993773e-6
kenit,0,boy,1,1,2.7761352310993773e-6
kenrik,0,boy,1,1,2.7761352310993773e-6
kerian,0,boy,1,1,2.7761352310993773e-6
kerr,0,boy,19,19,5.274656939088817e-5
kerubel,0,boy,1,1,2.7761352310993773e-6
kevin-florin,0,boy,1,1,2.7761352310993773e-6
khadime,0,boy,1,1,2.7761352310993773e-6
khal,0,boy,2,2,5.5522704621987546e-6
khalil-mikail,0,boy,1,1,2.7761352310993773e-6
khamil,0,boy,1,1,2.7761352310993773e-6
kharthikeya,0,boy,1,1,2.7761352310993773e-6
khay,0,boy,1,1,2.7761352310993773e-6
khaya,0,boy,1,1,2.7761352310993773e-6
khushveer,0,boy,1,1,2.7761352310993773e-6
khyden,0,boy,1,1,2.7761352310993773e-6
khyran,0,boy,1,1,2.7761352310993773e-6
kiann,0,boy,1,1,2.7761352310993773e-6
kiaran,0,boy,1,1,2.7761352310993773e-6
kielan,0,boy,2,2,5.5522704621987546e-6
kier,0,boy,1,1,2.7761352310993773e-6
kiler,0,boy,1,1,2.7761352310993773e-6
killean,0,boy,1,1,2.7761352310993773e-6
kinnon,0,boy,1,1,2.7761352310993773e-6
kippen,0,boy,1,1,2.7761352310993773e-6
kj,0,boy,1,1,2.7761352310993773e-6
klae,0,boy,2,2,5.5522704621987546e-6
klaeo,0,boy,1,1,2.7761352310993773e-6
klayten,0,boy,1,1,2.7761352310993773e-6
koah,0,boy,1,1,2.7761352310993773e-6
kobichidi,0,boy,1,1,2.7761352310993773e-6
kobimtochi,0,boy,1,1,2.7761352310993773e-6
kobin,0,boy,1,1,2.7761352310993773e-6
kohl,0,boy,1,1,2.7761352310993773e-6
kohrad,0,boy,1,1,2.7761352310993773e-6
koletyn,0,boy,1,1,2.7761352310993773e-6
kolten,0,boy,1,1,2.7761352310993773e-6
kolton,0,boy,2,2,5.5522704621987546e-6
konan,0,boy,2,2,5.5522704621987546e-6
konchog,0,boy,1,1,2.7761352310993773e-6
konlan,0,boy,1,1,2.7761352310993773e-6
konor,0,boy,1,1,2.7761352310993773e-6
korin,0,boy,1,1,2.7761352310993773e-6
korneliusz,0,boy,1,1,2.7761352310993773e-6
kosma,0,boy,1,1,2.7761352310993773e-6
kouper,0,boy,1,1,2.7761352310993773e-6
krishaan,0,boy,1,1,2.7761352310993773e-6
kristian-joseph,0,boy,1,1,2.7761352310993773e-6
kristofer,0,boy,1,1,2.7761352310993773e-6
kristoffer,0,boy,1,1,2.7761352310993773e-6
kristyan,0,boy,1,1,2.7761352310993773e-6
krubel,0,boy,1,1,2.7761352310993773e-6
kruze,0,boy,1,1,2.7761352310993773e-6
krystof,0,boy,1,1,2.7761352310993773e-6
krysztof,0,boy,1,1,2.7761352310993773e-6
kullan,0,boy,1,1,2.7761352310993773e-6
kurosh,0,boy,1,1,2.7761352310993773e-6
kurtis-paul,0,boy,1,1,2.7761352310993773e-6
kvido,0,boy,1,1,2.7761352310993773e-6
kydd,0,boy,1,1,2.7761352310993773e-6
kylar,0,boy,3,3,8.328405693298133e-6
kylin,0,boy,1,1,2.7761352310993773e-6
kyoinom,0,boy,1,1,2.7761352310993773e-6
kyryn,0,boy,1,1,2.7761352310993773e-6
lachlainn,0,boy,1,1,2.7761352310993773e-6
lachlann,0,boy,4,4,1.1104540924397509e-5
lachlen,0,boy,1,1,2.7761352310993773e-6
laichlyn,0,boy,1,1,2.7761352310993773e-6
laird,0,boy,1,1,2.7761352310993773e-6
laisiasa,0,boy,1,1,2.7761352310993773e-6
laith-junior,0,boy,1,1,2.7761352310993773e-6
lander,0,boy,1,1,2.7761352310993773e-6
landyn,0,boy,1,1,2.7761352310993773e-6
larkin,0,boy,1,1,2.7761352310993773e-6
larsson,0,boy,2,2,5.5522704621987546e-6
lauchlann,0,boy,1,1,2.7761352310993773e-6
lauchlin,0,boy,2,2,5.5522704621987546e-6
laughlan,0,boy,4,4,1.1104540924397509e-5
laughlin,0,boy,2,2,5.5522704621987546e-6
lavin,0,boy,1,1,2.7761352310993773e-6
lawclyn,0,boy,1,1,2.7761352310993773e-6
layden,0,boy,1,1,2.7761352310993773e-6
layker,0,boy,1,1,2.7761352310993773e-6
laylen,0,boy,1,1,2.7761352310993773e-6
laythan,0,boy,2,2,5.5522704621987546e-6
lcaro,0,boy,1,1,2.7761352310993773e-6
leander,0,boy,2,2,5.5522704621987546e-6
leandre,0,boy,1,1,2.7761352310993773e-6
leathan,0,boy,1,1,2.7761352310993773e-6
ledlay,0,boy,1,1,2.7761352310993773e-6
lee-roy,0,boy,1,1,2.7761352310993773e-6
lee-ryan,0,boy,1,1,2.7761352310993773e-6
leeland-james,0,boy,1,1,2.7761352310993773e-6
leith,0,boy,1,1,2.7761352310993773e-6
leiyton,0,boy,1,1,2.7761352310993773e-6
lelan,0,boy,1,1,2.7761352310993773e-6
lenni,0,boy,1,1,2.7761352310993773e-6
lennon-sean,0,boy,1,1,2.7761352310993773e-6
lennox-james,0,boy,1,1,2.7761352310993773e-6
lenox,0,boy,1,1,2.7761352310993773e-6
leo-alexander,0,boy,1,1,2.7761352310993773e-6
leo-scott,0,boy,1,1,2.7761352310993773e-6
leo-xavier,0,boy,1,1,2.7761352310993773e-6
leon-jai,0,boy,1,1,2.7761352310993773e-6
lewis-james,0,boy,2,2,5.5522704621987546e-6
leylind,0,boy,1,1,2.7761352310993773e-6
leyo,0,boy,1,1,2.7761352310993773e-6
leyton-james,0,boy,1,1,2.7761352310993773e-6
li,0,boy,1,1,2.7761352310993773e-6
lias,0,boy,1,1,2.7761352310993773e-6
lirison,0,boy,1,1,2.7761352310993773e-6
llayton,0,boy,1,1,2.7761352310993773e-6
lochan,0,boy,1,1,2.7761352310993773e-6
lochanjit,0,boy,1,1,2.7761352310993773e-6
lochart,0,boy,1,1,2.7761352310993773e-6
lochlan-alexander,0,boy,1,1,2.7761352310993773e-6
lochlan-james,0,boy,1,1,2.7761352310993773e-6
lochlin,0,boy,6,6,1.6656811386596265e-5
lochryn,0,boy,1,1,2.7761352310993773e-6
lochy,0,boy,1,1,2.7761352310993773e-6
locklan,0,boy,1,1,2.7761352310993773e-6
loclin,0,boy,1,1,2.7761352310993773e-6
logan-john,0,boy,1,1,2.7761352310993773e-6
logyn,0,boy,1,1,2.7761352310993773e-6
lomond,0,boy,7,7,1.943294661769564e-5
lorentz,0,boy,1,1,2.7761352310993773e-6
louden,0,boy,1,1,2.7761352310993773e-6
louie-alexander,0,boy,1,1,2.7761352310993773e-6
lubos,0,boy,1,1,2.7761352310993773e-6
lucas-jack,0,boy,1,1,2.7761352310993773e-6
lucas-oliver,0,boy,1,1,2.7761352310993773e-6
lucas-stewart,0,boy,1,1,2.7761352310993773e-6
lucky,0,boy,1,1,2.7761352310993773e-6
ludovico,0,boy,1,1,2.7761352310993773e-6
lukas-james,0,boy,1,1,2.7761352310993773e-6
lukka,0,boy,1,1,2.7761352310993773e-6
luyi,0,boy,1,1,2.7761352310993773e-6
lyken,0,boy,1,1,2.7761352310993773e-6
lyric,0,boy,1,1,2.7761352310993773e-6
maalak,0,boy,1,1,2.7761352310993773e-6
macen,0,boy,1,1,2.7761352310993773e-6
machar,0,boy,1,1,2.7761352310993773e-6
mackay,0,boy,2,2,5.5522704621987546e-6
mackinlay,0,boy,1,1,2.7761352310993773e-6
madie,0,boy,1,1,2.7761352310993773e-6
madiou,0,boy,1,1,2.7761352310993773e-6
maduabuchi,0,boy,1,1,2.7761352310993773e-6
magnie,0,boy,1,1,2.7761352310993773e-6
mahaasvin,0,boy,1,1,2.7761352310993773e-6
maher-youssef,0,boy,1,1,2.7761352310993773e-6
mahirrodi,0,boy,1,1,2.7761352310993773e-6
mahruz,0,boy,1,1,2.7761352310993773e-6
maicyn,0,boy,1,1,2.7761352310993773e-6
maitland,0,boy,1,1,2.7761352310993773e-6
makenzie-james,0,boy,1,1,2.7761352310993773e-6
maksims-renats,0,boy,1,1,2.7761352310993773e-6
malachi-john,0,boy,1,1,2.7761352310993773e-6
malan,0,boy,1,1,2.7761352310993773e-6
malin,0,boy,1,1,2.7761352310993773e-6
malloch,0,boy,1,1,2.7761352310993773e-6
manasa,0,boy,1,1,2.7761352310993773e-6
manech,0,boy,1,1,2.7761352310993773e-6
manoa,0,boy,1,1,2.7761352310993773e-6
mareks,0,boy,1,1,2.7761352310993773e-6
marken,0,boy,1,1,2.7761352310993773e-6
marr,0,boy,1,1,2.7761352310993773e-6
marshall-jack,0,boy,1,1,2.7761352310993773e-6
mart,0,boy,2,2,5.5522704621987546e-6
masen,0,boy,1,1,2.7761352310993773e-6
matias-marian,0,boy,1,1,2.7761352310993773e-6
matviey,0,boy,1,1,2.7761352310993773e-6
maui,0,boy,2,2,5.5522704621987546e-6
maureece,0,boy,1,1,2.7761352310993773e-6
maxi,0,boy,1,1,2.7761352310993773e-6
maxie,0,boy,1,1,2.7761352310993773e-6
mbete,0,boy,1,1,2.7761352310993773e-6
mccartney,0,boy,1,1,2.7761352310993773e-6
mcdavid,0,boy,1,1,2.7761352310993773e-6
mcgregor,0,boy,2,2,5.5522704621987546e-6
mckinnley,0,boy,1,1,2.7761352310993773e-6
mckinnon,0,boy,1,1,2.7761352310993773e-6
mekhai,0,boy,1,1,2.7761352310993773e-6
metatron,0,boy,1,1,2.7761352310993773e-6
mikayal,0,boy,1,1,2.7761352310993773e-6
miles-james,0,boy,1,1,2.7761352310993773e-6
millin,0,boy,1,1,2.7761352310993773e-6
millyr,0,boy,1,1,2.7761352310993773e-6
milo-nevaeh,0,boy,1,1,2.7761352310993773e-6
miloslav,0,boy,1,1,2.7761352310993773e-6
ming,0,boy,1,1,2.7761352310993773e-6
mircea-romeo,0,boy,1,1,2.7761352310993773e-6
miroslaw,0,boy,1,1,2.7761352310993773e-6
mj,0,boy,1,1,2.7761352310993773e-6
moath,0,boy,1,1,2.7761352310993773e-6
moaz,0,boy,2,2,5.5522704621987546e-6
modest,0,boy,1,1,2.7761352310993773e-6
modoulamin,0,boy,1,1,2.7761352310993773e-6
moh,0,boy,1,1,2.7761352310993773e-6
mohammad-tayyab,0,boy,1,1,2.7761352310993773e-6
mohammad-zaeem,0,boy,1,1,2.7761352310993773e-6
mohiuddin,0,boy,1,1,2.7761352310993773e-6
mohtada,0,boy,1,1,2.7761352310993773e-6
mojtaba,0,boy,1,1,2.7761352310993773e-6
momat,0,boy,1,1,2.7761352310993773e-6
momen,0,boy,1,1,2.7761352310993773e-6
moneeb,0,boy,1,1,2.7761352310993773e-6
moray,0,boy,2,2,5.5522704621987546e-6
mousa,0,boy,1,1,2.7761352310993773e-6
muhammad-aariz,0,boy,1,1,2.7761352310993773e-6
muhammad-hasnain,0,boy,1,1,2.7761352310993773e-6
muhammad-yousaf,0,boy,1,1,2.7761352310993773e-6
muhammed-esa,0,boy,1,1,2.7761352310993773e-6
muhemmed,0,boy,1,1,2.7761352310993773e-6
muhmmad,0,boy,1,1,2.7761352310993773e-6
muir,0,boy,3,3,8.328405693298133e-6
munib,0,boy,1,1,2.7761352310993773e-6
munroe,0,boy,1,1,2.7761352310993773e-6
muntether,0,boy,1,1,2.7761352310993773e-6
munzer,0,boy,1,1,2.7761352310993773e-6
murdo-angus,0,boy,1,1,2.7761352310993773e-6
murdoch,0,boy,4,4,1.1104540924397509e-5
murry,0,boy,1,1,2.7761352310993773e-6
nafiyon,0,boy,1,1,2.7761352310993773e-6
nail,0,boy,1,1,2.7761352310993773e-6
nairn,0,boy,12,12,3.331362277319253e-5
naji,0,boy,1,1,2.7761352310993773e-6
nalle,0,boy,1,1,2.7761352310993773e-6
naomhan,0,boy,1,1,2.7761352310993773e-6
napoleon,0,boy,1,1,2.7761352310993773e-6
narayoshi,0,boy,1,1,2.7761352310993773e-6
narwin,0,boy,1,1,2.7761352310993773e-6
nathen,0,boy,1,1,2.7761352310993773e-6
nathyn,0,boy,1,1,2.7761352310993773e-6
natinal,0,boy,1,1,2.7761352310993773e-6
nayte,0,boy,1,1,2.7761352310993773e-6
neevan,0,boy,1,1,2.7761352310993773e-6
neily,0,boy,1,1,2.7761352310993773e-6
neimantas,0,boy,1,1,2.7761352310993773e-6
neophytos,0,boy,1,1,2.7761352310993773e-6
nevis,0,boy,1,1,2.7761352310993773e-6
nezar,0,boy,1,1,2.7761352310993773e-6
nhyira,0,boy,1,1,2.7761352310993773e-6
nicodemus,0,boy,1,1,2.7761352310993773e-6
nicol,0,boy,2,2,5.5522704621987546e-6
nicolai,0,boy,1,1,2.7761352310993773e-6
nieko,0,boy,1,1,2.7761352310993773e-6
nihad,0,boy,1,1,2.7761352310993773e-6
nijesh,0,boy,1,1,2.7761352310993773e-6
nikhit,0,boy,1,1,2.7761352310993773e-6
nila,0,boy,1,1,2.7761352310993773e-6
nimit,0,boy,2,2,5.5522704621987546e-6
nitul,0,boy,1,1,2.7761352310993773e-6
niven,0,boy,5,5,1.3880676155496887e-5
nizar,0,boy,1,1,2.7761352310993773e-6
noall,0,boy,1,1,2.7761352310993773e-6
noell,0,boy,1,1,2.7761352310993773e-6
norek,0,boy,1,1,2.7761352310993773e-6
norrie,0,boy,1,1,2.7761352310993773e-6
nuallan,0,boy,1,1,2.7761352310993773e-6
nyro,0,boy,1,1,2.7761352310993773e-6
oakley-derry,0,boy,1,1,2.7761352310993773e-6
oaklie,0,boy,1,1,2.7761352310993773e-6
obaro,0,boy,1,1,2.7761352310993773e-6
obayemi,0,boy,1,1,2.7761352310993773e-6
obed,0,boy,1,1,2.7761352310993773e-6
obibuba,0,boy,1,1,2.7761352310993773e-6
odhin,0,boy,1,1,2.7761352310993773e-6
odhren,0,boy,1,1,2.7761352310993773e-6
odi,0,boy,1,1,2.7761352310993773e-6
odira,0,boy,1,1,2.7761352310993773e-6
oghenefejiro,0,boy,1,1,2.7761352310993773e-6
oghenemaro,0,boy,1,1,2.7761352310993773e-6
oisian,0,boy,1,1,2.7761352310993773e-6
okwara,0,boy,1,1,2.7761352310993773e-6
olabayo,0,boy,1,1,2.7761352310993773e-6
olafs,0,boy,1,1,2.7761352310993773e-6
olatayo,0,boy,1,1,2.7761352310993773e-6
olexander,0,boy,1,1,2.7761352310993773e-6
olivar,0,boy,1,1,2.7761352310993773e-6
olof,0,boy,1,1,2.7761352310993773e-6
olsen,0,boy,1,1,2.7761352310993773e-6
oluwadamola,0,boy,1,1,2.7761352310993773e-6
oluwajomiloju,0,boy,1,1,2.7761352310993773e-6
oluwamayokun,0,boy,1,1,2.7761352310993773e-6
oluwapami,0,boy,1,1,2.7761352310993773e-6
oluwashireayomi,0,boy,1,1,2.7761352310993773e-6
oni,0,boy,1,1,2.7761352310993773e-6
onno,0,boy,1,1,2.7761352310993773e-6
oreofe,0,boy,1,1,2.7761352310993773e-6
ori,0,boy,1,1,2.7761352310993773e-6
orinate,0,boy,1,1,2.7761352310993773e-6
orran,0,boy,1,1,2.7761352310993773e-6
orryn,0,boy,1,1,2.7761352310993773e-6
orville,0,boy,1,1,2.7761352310993773e-6
orvin,0,boy,1,1,2.7761352310993773e-6
osaruse,0,boy,1,1,2.7761352310993773e-6
osayiefewemwen,0,boy,1,1,2.7761352310993773e-6
oscar-j,0,boy,1,1,2.7761352310993773e-6
oscar-theo,0,boy,1,1,2.7761352310993773e-6
osejiade,0,boy,1,1,2.7761352310993773e-6
osker,0,boy,1,1,2.7761352310993773e-6
ostins,0,boy,1,1,2.7761352310993773e-6
ouais,0,boy,1,1,2.7761352310993773e-6
ouen,0,boy,1,1,2.7761352310993773e-6
oyintari,0,boy,1,1,2.7761352310993773e-6
ozair,0,boy,1,1,2.7761352310993773e-6
ozric,0,boy,1,1,2.7761352310993773e-6
ozzi,0,boy,1,1,2.7761352310993773e-6
pacey,0,boy,2,2,5.5522704621987546e-6
padhraig,0,boy,1,1,2.7761352310993773e-6
paras,0,boy,1,1,2.7761352310993773e-6
parminderjit,0,boy,1,1,2.7761352310993773e-6
patrick-francis,0,boy,1,1,2.7761352310993773e-6
patrickshaun,0,boy,1,1,2.7761352310993773e-6
paulin,0,boy,1,1,2.7761352310993773e-6
paulos,0,boy,1,1,2.7761352310993773e-6
pawandeep,0,boy,1,1,2.7761352310993773e-6
perrie,0,boy,1,1,2.7761352310993773e-6
peter-alexander,0,boy,1,1,2.7761352310993773e-6
peter-gerard,0,boy,1,1,2.7761352310993773e-6
peteris,0,boy,1,1,2.7761352310993773e-6
phelan,0,boy,1,1,2.7761352310993773e-6
phergus,0,boy,1,1,2.7761352310993773e-6
pranet,0,boy,1,1,2.7761352310993773e-6
prasun,0,boy,1,1,2.7761352310993773e-6
prathik,0,boy,1,1,2.7761352310993773e-6
preston-john,0,boy,1,1,2.7761352310993773e-6
pride,0,boy,1,1,2.7761352310993773e-6
prithvi,0,boy,1,1,2.7761352310993773e-6
qichen,0,boy,1,1,2.7761352310993773e-6
quilliam,0,boy,1,1,2.7761352310993773e-6
quinlin,0,boy,1,1,2.7761352310993773e-6
quirin,0,boy,1,1,2.7761352310993773e-6
quynn,0,boy,1,1,2.7761352310993773e-6
qwin,0,boy,1,1,2.7761352310993773e-6
rachit,0,boy,1,1,2.7761352310993773e-6
racim,0,boy,1,1,2.7761352310993773e-6
radley-stewart,0,boy,1,1,2.7761352310993773e-6
radyn,0,boy,1,1,2.7761352310993773e-6
rae,0,boy,2,2,5.5522704621987546e-6
raefe,0,boy,1,1,2.7761352310993773e-6
rahmaan,0,boy,1,1,2.7761352310993773e-6
rajdeep,0,boy,2,2,5.5522704621987546e-6
rakin,0,boy,1,1,2.7761352310993773e-6
ranald,0,boy,1,1,2.7761352310993773e-6
rannoch,0,boy,1,1,2.7761352310993773e-6
raouf,0,boy,1,1,2.7761352310993773e-6
rares-narcis,0,boy,1,1,2.7761352310993773e-6
raumaan,0,boy,1,1,2.7761352310993773e-6
ravei,0,boy,1,1,2.7761352310993773e-6
raven-jax,0,boy,1,1,2.7761352310993773e-6
ravy,0,boy,1,1,2.7761352310993773e-6
rawi,0,boy,1,1,2.7761352310993773e-6
rayf,0,boy,1,1,2.7761352310993773e-6
rayjay,0,boy,1,1,2.7761352310993773e-6
raynald,0,boy,1,1,2.7761352310993773e-6
raysh,0,boy,1,1,2.7761352310993773e-6
razique,0,boy,1,1,2.7761352310993773e-6
reace,0,boy,2,2,5.5522704621987546e-6
reeo,0,boy,1,1,2.7761352310993773e-6
regner,0,boy,1,1,2.7761352310993773e-6
reigen,0,boy,1,1,2.7761352310993773e-6
reiman,0,boy,1,1,2.7761352310993773e-6
rejwan,0,boy,1,1,2.7761352310993773e-6
remie,0,boy,1,1,2.7761352310993773e-6
remington,0,boy,1,1,2.7761352310993773e-6
renaldas,0,boy,1,1,2.7761352310993773e-6
rendijs,0,boy,1,1,2.7761352310993773e-6
reni,0,boy,2,2,5.5522704621987546e-6
renick,0,boy,1,1,2.7761352310993773e-6
renit,0,boy,1,1,2.7761352310993773e-6
rhilley,0,boy,1,1,2.7761352310993773e-6
rhoddy,0,boy,1,1,2.7761352310993773e-6
rhodin,0,boy,1,1,2.7761352310993773e-6
rhoridh,0,boy,2,2,5.5522704621987546e-6
rhu,0,boy,1,1,2.7761352310993773e-6
rhuari,0,boy,1,1,2.7761352310993773e-6
rhuaridh,0,boy,3,3,8.328405693298133e-6
rhuary,0,boy,1,1,2.7761352310993773e-6
rhudi,0,boy,1,1,2.7761352310993773e-6
rhudie,0,boy,1,1,2.7761352310993773e-6
rhuri,0,boy,1,1,2.7761352310993773e-6
rhyda,0,boy,1,1,2.7761352310993773e-6
rhyden,0,boy,2,2,5.5522704621987546e-6
rhyleigh,0,boy,1,1,2.7761352310993773e-6
rhylie,0,boy,1,1,2.7761352310993773e-6
ricci,0,boy,1,1,2.7761352310993773e-6
rickie,0,boy,1,1,2.7761352310993773e-6
ridhay,0,boy,1,1,2.7761352310993773e-6
riley-jai,0,boy,1,1,2.7761352310993773e-6
rinnes,0,boy,1,1,2.7761352310993773e-6
rj,0,boy,1,1,2.7761352310993773e-6
rjay,0,boy,1,1,2.7761352310993773e-6
roady,0,boy,1,1,2.7761352310993773e-6
roah,0,boy,1,1,2.7761352310993773e-6
robert-jake,0,boy,1,1,2.7761352310993773e-6
robert-ryan,0,boy,1,1,2.7761352310993773e-6
robi,0,boy,1,1,2.7761352310993773e-6
robin-john,0,boy,1,1,2.7761352310993773e-6
robin-ray,0,boy,1,1,2.7761352310993773e-6
robun,0,boy,1,1,2.7761352310993773e-6
rodaidh,0,boy,1,1,2.7761352310993773e-6
rogie,0,boy,1,1,2.7761352310993773e-6
rohann,0,boy,1,1,2.7761352310993773e-6
rohat,0,boy,1,1,2.7761352310993773e-6
rolf,0,boy,1,1,2.7761352310993773e-6
roman-riley,0,boy,1,1,2.7761352310993773e-6
romualdo,0,boy,1,1,2.7761352310993773e-6
rorie,0,boy,1,1,2.7761352310993773e-6
rorik,0,boy,1,1,2.7761352310993773e-6
rorrison,0,boy,1,1,2.7761352310993773e-6
rosario,0,boy,1,1,2.7761352310993773e-6
rouxx,0,boy,1,1,2.7761352310993773e-6
roxan,0,boy,1,1,2.7761352310993773e-6
roxas,0,boy,1,1,2.7761352310993773e-6
royan,0,boy,1,1,2.7761352310993773e-6
ruach,0,boy,1,1,2.7761352310993773e-6
ruadh,0,boy,2,2,5.5522704621987546e-6
ruadhan,0,boy,1,1,2.7761352310993773e-6
ruaidhri,0,boy,1,1,2.7761352310993773e-6
ruaraidh,0,boy,16,16,4.4418163697590036e-05
rudhran,0,boy,1,1,2.7761352310993773e-6
rudii,0,boy,1,1,2.7761352310993773e-6
ruraidh,0,boy,1,1,2.7761352310993773e-6
rury,0,boy,1,1,2.7761352310993773e-6
ruy,0,boy,1,1,2.7761352310993773e-6
ryan-anthony,0,boy,1,1,2.7761352310993773e-6
ryan-john,0,boy,1,1,2.7761352310993773e-6
ryeyaan,0,boy,1,1,2.7761352310993773e-6
rygg,0,boy,1,1,2.7761352310993773e-6
ryhleighy,0,boy,1,1,2.7761352310993773e-6
saahas,0,boy,1,1,2.7761352310993773e-6
sabeeh,0,boy,1,1,2.7761352310993773e-6
sachairi,0,boy,1,1,2.7761352310993773e-6
sachit,0,boy,1,1,2.7761352310993773e-6
sadaqat,0,boy,1,1,2.7761352310993773e-6
saidou,0,boy,1,1,2.7761352310993773e-6
saksham,0,boy,1,1,2.7761352310993773e-6
sal,0,boy,2,2,5.5522704621987546e-6
salaheddin,0,boy,1,1,2.7761352310993773e-6
salam,0,boy,1,1,2.7761352310993773e-6
samik,0,boy,1,1,2.7761352310993773e-6
sammeer,0,boy,1,1,2.7761352310993773e-6
samyak,0,boy,1,1,2.7761352310993773e-6
sandijs,0,boy,1,1,2.7761352310993773e-6
saoirse,0,boy,1,1,2.7761352310993773e-6
sareen,0,boy,1,1,2.7761352310993773e-6
sarvesh,0,boy,1,1,2.7761352310993773e-6
sarya,0,boy,1,1,2.7761352310993773e-6
satoya,0,boy,1,1,2.7761352310993773e-6
saudi,0,boy,1,1,2.7761352310993773e-6
saxs,0,boy,1,1,2.7761352310993773e-6
sayf,0,boy,2,2,5.5522704621987546e-6
scott-junior,0,boy,1,1,2.7761352310993773e-6
scotty,0,boy,1,1,2.7761352310993773e-6
seamas,0,boy,1,1,2.7761352310993773e-6
sean-paul,0,boy,1,1,2.7761352310993773e-6
sederi,0,boy,1,1,2.7761352310993773e-6
sejun,0,boy,1,1,2.7761352310993773e-6
senater,0,boy,1,1,2.7761352310993773e-6
seoin,0,boy,1,1,2.7761352310993773e-6
seon,0,boy,1,1,2.7761352310993773e-6
seoras,0,boy,4,4,1.1104540924397509e-5
shaanveer,0,boy,1,1,2.7761352310993773e-6
shadasivak,0,boy,1,1,2.7761352310993773e-6
shafy,0,boy,1,1,2.7761352310993773e-6
shahbaj,0,boy,1,1,2.7761352310993773e-6
shahmir,0,boy,1,1,2.7761352310993773e-6
shahyaan,0,boy,1,1,2.7761352310993773e-6
shakib,0,boy,1,1,2.7761352310993773e-6
shameel,0,boy,1,1,2.7761352310993773e-6
shaunpaul,0,boy,1,1,2.7761352310993773e-6
sheamus,0,boy,1,1,2.7761352310993773e-6
sheeran,0,boy,1,1,2.7761352310993773e-6
shehriyar,0,boy,1,1,2.7761352310993773e-6
shemar,0,boy,1,1,2.7761352310993773e-6
shezan,0,boy,1,1,2.7761352310993773e-6
shiraz,0,boy,1,1,2.7761352310993773e-6
shola,0,boy,1,1,2.7761352310993773e-6
shri,0,boy,1,1,2.7761352310993773e-6
shrihaan,0,boy,1,1,2.7761352310993773e-6
shriyan,0,boy,1,1,2.7761352310993773e-6
shujaat,0,boy,1,1,2.7761352310993773e-6
sichen,0,boy,1,1,2.7761352310993773e-6
sinclair,0,boy,2,2,5.5522704621987546e-6
sing,0,boy,1,1,2.7761352310993773e-6
slater,0,boy,1,1,2.7761352310993773e-6
slawomir,0,boy,1,1,2.7761352310993773e-6
sloane,0,boy,1,1,2.7761352310993773e-6
solo,0,boy,1,1,2.7761352310993773e-6
somerville,0,boy,1,1,2.7761352310993773e-6
sooren,0,boy,1,1,2.7761352310993773e-6
sorley,0,boy,4,4,1.1104540924397509e-5
sorren,0,boy,2,2,5.5522704621987546e-6
spencer-brodie,0,boy,1,1,2.7761352310993773e-6
srijit,0,boy,1,1,2.7761352310993773e-6
stafford,0,boy,1,1,2.7761352310993773e-6
stefans,0,boy,1,1,2.7761352310993773e-6
stephen-junior,0,boy,1,1,2.7761352310993773e-6
stephen-paul,0,boy,1,1,2.7761352310993773e-6
stevenjack,0,boy,1,1,2.7761352310993773e-6
stuart-oliver,0,boy,1,1,2.7761352310993773e-6
sturrock,0,boy,1,1,2.7761352310993773e-6
subaig,0,boy,1,1,2.7761352310993773e-6
subin,0,boy,1,1,2.7761352310993773e-6
suguru,0,boy,1,1,2.7761352310993773e-6
sulaimaan,0,boy,1,1,2.7761352310993773e-6
sumedh,0,boy,1,1,2.7761352310993773e-6
sumuka,0,boy,1,1,2.7761352310993773e-6
suphi,0,boy,1,1,2.7761352310993773e-6
suprith,0,boy,1,1,2.7761352310993773e-6
suyash,0,boy,1,1,2.7761352310993773e-6
ta'ib,0,boy,1,1,2.7761352310993773e-6
taariq,0,boy,1,1,2.7761352310993773e-6
taeyang,0,boy,1,1,2.7761352310993773e-6
tahmeed,0,boy,1,1,2.7761352310993773e-6
taig,0,boy,1,1,2.7761352310993773e-6
tair,0,boy,1,1,2.7761352310993773e-6
talkha,0,boy,1,1,2.7761352310993773e-6
tamiliniyan,0,boy,1,1,2.7761352310993773e-6
tamunonengiyefori,0,boy,1,1,2.7761352310993773e-6
taneesh,0,boy,1,1,2.7761352310993773e-6
tanraj,0,boy,1,1,2.7761352310993773e-6
taraz,0,boy,1,1,2.7761352310993773e-6
tauya,0,boy,1,1,2.7761352310993773e-6
tavis,0,boy,1,1,2.7761352310993773e-6
tavish,0,boy,4,4,1.1104540924397509e-5
taylor-stuart,0,boy,1,1,2.7761352310993773e-6
tejus,0,boy,1,1,2.7761352310993773e-6
temidire,0,boy,1,1,2.7761352310993773e-6
teodors,0,boy,1,1,2.7761352310993773e-6
thabani,0,boy,1,1,2.7761352310993773e-6
thales,0,boy,1,1,2.7761352310993773e-6
theocharis,0,boy,2,2,5.5522704621987546e-6
thibaut,0,boy,1,1,2.7761352310993773e-6
thomaz,0,boy,1,1,2.7761352310993773e-6
thorfin,0,boy,1,1,2.7761352310993773e-6
thorfinn,0,boy,3,3,8.328405693298133e-6
thurstan,0,boy,1,1,2.7761352310993773e-6
thurston,0,boy,1,1,2.7761352310993773e-6
tianming,0,boy,1,1,2.7761352310993773e-6
tiarnan,0,boy,1,1,2.7761352310993773e-6
tighe,0,boy,2,2,5.5522704621987546e-6
timofei,0,boy,1,1,2.7761352310993773e-6
toal,0,boy,1,1,2.7761352310993773e-6
toluwalase,0,boy,1,1,2.7761352310993773e-6
toluwalope,0,boy,1,1,2.7761352310993773e-6
tommy-oliver,0,boy,1,1,2.7761352310993773e-6
toni-lee,0,boy,1,1,2.7761352310993773e-6
toran,0,boy,1,1,2.7761352310993773e-6
tore-mikkel,0,boy,1,1,2.7761352310993773e-6
torfinn,0,boy,1,1,2.7761352310993773e-6
torran,0,boy,2,2,5.5522704621987546e-6
torres,0,boy,1,1,2.7761352310993773e-6
torrin,0,boy,3,3,8.328405693298133e-6
trystin,0,boy,1,1,2.7761352310993773e-6
turner,0,boy,1,1,2.7761352310993773e-6
tygh,0,boy,1,1,2.7761352310993773e-6
tylar,0,boy,1,1,2.7761352310993773e-6
tyler-rhys,0,boy,1,1,2.7761352310993773e-6
tylo,0,boy,1,1,2.7761352310993773e-6
uisdean,0,boy,1,1,2.7761352310993773e-6
unay,0,boy,1,1,2.7761352310993773e-6
usef,0,boy,1,1,2.7761352310993773e-6
uyiosa,0,boy,1,1,2.7761352310993773e-6
vafa,0,boy,1,1,2.7761352310993773e-6
vahin,0,boy,1,1,2.7761352310993773e-6
valerio,0,boy,2,2,5.5522704621987546e-6
vansen,0,boy,1,1,2.7761352310993773e-6
vasily,0,boy,1,1,2.7761352310993773e-6
vedvit,0,boy,1,1,2.7761352310993773e-6
velzian,0,boy,1,1,2.7761352310993773e-6
venkata,0,boy,1,1,2.7761352310993773e-6
vharshan,0,boy,1,1,2.7761352310993773e-6
vidal,0,boy,1,1,2.7761352310993773e-6
vihen,0,boy,1,1,2.7761352310993773e-6
vins,0,boy,1,1,2.7761352310993773e-6
viom,0,boy,1,1,2.7761352310993773e-6
vivaansh,0,boy,1,1,2.7761352310993773e-6
vlado,0,boy,1,1,2.7761352310993773e-6
vyaan,0,boy,1,1,2.7761352310993773e-6
wallace,0,boy,3,3,8.328405693298133e-6
walshak,0,boy,1,1,2.7761352310993773e-6
watson,0,boy,1,1,2.7761352310993773e-6
wedant,0,boy,1,1,2.7761352310993773e-6
wenslow,0,boy,1,1,2.7761352310993773e-6
william-j,0,boy,1,1,2.7761352310993773e-6
willum,0,boy,1,1,2.7761352310993773e-6
winters,0,boy,1,1,2.7761352310993773e-6
wisam,0,boy,1,1,2.7761352310993773e-6
wojciech-kazimierz,0,boy,1,1,2.7761352310993773e-6
wui,0,boy,1,1,2.7761352310993773e-6
wyn,0,boy,1,1,2.7761352310993773e-6
wynton,0,boy,1,1,2.7761352310993773e-6
xiangle,0,boy,1,1,2.7761352310993773e-6
xin,0,boy,1,1,2.7761352310993773e-6
xinyu,0,boy,1,1,2.7761352310993773e-6
xyler,0,boy,1,1,2.7761352310993773e-6
yaathvik,0,boy,1,1,2.7761352310993773e-6
yacquub,0,boy,1,1,2.7761352310993773e-6
yagazie,0,boy,1,1,2.7761352310993773e-6
yaksh,0,boy,1,1,2.7761352310993773e-6
yangjiaqi,0,boy,1,1,2.7761352310993773e-6
yaphet,0,boy,1,1,2.7761352310993773e-6
ye,0,boy,1,1,2.7761352310993773e-6
yezzan,0,boy,1,1,2.7761352310993773e-6
yiannis,0,boy,1,1,2.7761352310993773e-6
yixuan,0,boy,1,1,2.7761352310993773e-6
yiyang,0,boy,1,1,2.7761352310993773e-6
yosias,0,boy,1,1,2.7761352310993773e-6
yosof,0,boy,1,1,2.7761352310993773e-6
youhan,0,boy,1,1,2.7761352310993773e-6
yugveer,0,boy,1,1,2.7761352310993773e-6
yuki,0,boy,1,1,2.7761352310993773e-6
yukt,0,boy,1,1,2.7761352310993773e-6
zagros,0,boy,1,1,2.7761352310993773e-6
zahc,0,boy,1,1,2.7761352310993773e-6
zahraan,0,boy,1,1,2.7761352310993773e-6
zai,0,boy,1,1,2.7761352310993773e-6
zaiidan,0,boy,1,1,2.7761352310993773e-6
zakariyyaa,0,boy,1,1,2.7761352310993773e-6
zakhari,0,boy,1,1,2.7761352310993773e-6
zakory,0,boy,1,1,2.7761352310993773e-6
zejd,0,boy,1,1,2.7761352310993773e-6
zeyaan,0,boy,1,1,2.7761352310993773e-6
zhangheng,0,boy,1,1,2.7761352310993773e-6
zhaoqian,0,boy,1,1,2.7761352310993773e-6
zichen,0,boy,1,1,2.7761352310993773e-6
zioraife,0,boy,1,1,2.7761352310993773e-6
zirui,0,boy,1,1,2.7761352310993773e-6
zohran,0,boy,1,1,2.7761352310993773e-6
zoraavar,0,boy,1,1,2.7761352310993773e-6
zygmunt,0,boy,1,1,2.7761352310993773e-6
a'lelia,0,girl,1,1,2.9994540993539178e-6
aadrika,0,girl,1,1,2.9994540993539178e-6
aafeen,0,girl,1,1,2.9994540993539178e-6
aafreen,0,girl,1,1,2.9994540993539178e-6
aaleen,0,girl,1,1,2.9994540993539178e-6
aameera,0,girl,1,1,2.9994540993539178e-6
aariyah,0,girl,1,1,2.9994540993539178e-6
aaryella,0,girl,1,1,2.9994540993539178e-6
aathira,0,girl,1,1,2.9994540993539178e-6
aatiqa,0,girl,1,1,2.9994540993539178e-6
aayeshah,0,girl,1,1,2.9994540993539178e-6
aaylah,0,girl,1,1,2.9994540993539178e-6
abaigh,0,girl,1,1,2.9994540993539178e-6
abbi-leigh,0,girl,1,1,2.9994540993539178e-6
abbie-leigh,0,girl,2,2,5.9989081987078355e-6
abbiegail,0,girl,1,1,2.9994540993539178e-6
abena,0,girl,1,1,2.9994540993539178e-6
abigail-lee,0,girl,1,1,2.9994540993539178e-6
abiola,0,girl,2,2,5.9989081987078355e-6
abriana,0,girl,1,1,2.9994540993539178e-6
adaira,0,girl,2,2,5.9989081987078355e-6
addilynn,0,girl,2,2,5.9989081987078355e-6
addison-grace,0,girl,1,1,2.9994540993539178e-6
adeewa,0,girl,1,1,2.9994540993539178e-6
adelise,0,girl,1,1,2.9994540993539178e-6
adelola,0,girl,1,1,2.9994540993539178e-6
adelyn-charlotte,0,girl,1,1,2.9994540993539178e-6
adelynne,0,girl,1,1,2.9994540993539178e-6
ademide-favour,0,girl,1,1,2.9994540993539178e-6
ademilola,0,girl,1,1,2.9994540993539178e-6
adena,0,girl,1,1,2.9994540993539178e-6
adisha,0,girl,1,1,2.9994540993539178e-6
adorabelle,0,girl,1,1,2.9994540993539178e-6
adrhianna,0,girl,1,1,2.9994540993539178e-6
adwitiya,0,girl,1,1,2.9994540993539178e-6
adya,0,girl,1,1,2.9994540993539178e-6
aedamar,0,girl,1,1,2.9994540993539178e-6
aedyn,0,girl,1,1,2.9994540993539178e-6
aela-susie,0,girl,1,1,2.9994540993539178e-6
aerith,0,girl,1,1,2.9994540993539178e-6
aeva,0,girl,1,1,2.9994540993539178e-6
afeefeh,0,girl,1,1,2.9994540993539178e-6
afirah,0,girl,1,1,2.9994540993539178e-6
afoke-oghene,0,girl,1,1,2.9994540993539178e-6
agamaureen,0,girl,1,1,2.9994540993539178e-6
aggie-rose,0,girl,1,1,2.9994540993539178e-6
agne,0,girl,1,1,2.9994540993539178e-6
agnese,0,girl,1,1,2.9994540993539178e-6
ahlyisa,0,girl,1,1,2.9994540993539178e-6
ahria,0,girl,1,1,2.9994540993539178e-6
ai,0,girl,1,1,2.9994540993539178e-6
aibreann,0,girl,1,1,2.9994540993539178e-6
aihla,0,girl,1,1,2.9994540993539178e-6
aihleigh,0,girl,1,1,2.9994540993539178e-6
aijia,0,girl,1,1,2.9994540993539178e-6
aila-rose,0,girl,1,1,2.9994540993539178e-6
ailagh,0,girl,1,1,2.9994540993539178e-6
ailbe,0,girl,1,1,2.9994540993539178e-6
ailea,0,girl,1,1,2.9994540993539178e-6
ailee-rose,0,girl,1,1,2.9994540993539178e-6
aileigh,0,girl,2,2,5.9989081987078355e-6
ailey,0,girl,3,3,8.998362298061752e-6
ailidh,0,girl,5,5,1.4997270496769588e-5
ailie-rose,0,girl,1,1,2.9994540993539178e-6
ailios,0,girl,1,1,2.9994540993539178e-6
ailith,0,girl,1,1,2.9994540993539178e-6
ailsa-grace,0,girl,1,1,2.9994540993539178e-6
aimey,0,girl,1,1,2.9994540993539178e-6
aimi,0,girl,1,1,2.9994540993539178e-6
ainara,0,girl,1,1,2.9994540993539178e-6
airen,0,girl,1,1,2.9994540993539178e-6
airlie,0,girl,2,2,5.9989081987078355e-6
aisosa,0,girl,1,1,2.9994540993539178e-6
aiyannah-jack,0,girl,1,1,2.9994540993539178e-6
aiyzah,0,girl,1,1,2.9994540993539178e-6
akachukwu,0,girl,1,1,2.9994540993539178e-6
akira-lily,0,girl,1,1,2.9994540993539178e-6
alari,0,girl,1,1,2.9994540993539178e-6
alayia-mae,0,girl,1,1,2.9994540993539178e-6
alaynnah,0,girl,1,1,2.9994540993539178e-6
albi,0,girl,1,1,2.9994540993539178e-6
aleah-rose,0,girl,1,1,2.9994540993539178e-6
aleea,0,girl,2,2,5.9989081987078355e-6
aleri,0,girl,1,1,2.9994540993539178e-6
aleshba,0,girl,1,1,2.9994540993539178e-6
alesia-iasmina,0,girl,1,1,2.9994540993539178e-6
alessa-rose,0,girl,1,1,2.9994540993539178e-6
alesya,0,girl,1,1,2.9994540993539178e-6
alexa-mae,0,girl,1,1,2.9994540993539178e-6
alexandrina,0,girl,1,1,2.9994540993539178e-6
alexis-james,0,girl,1,1,2.9994540993539178e-6
alexis-leigh,0,girl,1,1,2.9994540993539178e-6
ali,0,girl,2,2,5.9989081987078355e-6
aliannah,0,girl,1,1,2.9994540993539178e-6
aliayah,0,girl,1,1,2.9994540993539178e-6
aliesha,0,girl,1,1,2.9994540993539178e-6
aliona,0,girl,3,3,8.998362298061752e-6
alisah,0,girl,1,1,2.9994540993539178e-6
alithea,0,girl,1,1,2.9994540993539178e-6
alivia-may,0,girl,1,1,2.9994540993539178e-6
aliviah,0,girl,1,1,2.9994540993539178e-6
aliviya,0,girl,1,1,2.9994540993539178e-6
alivya,0,girl,1,1,2.9994540993539178e-6
alizee,0,girl,1,1,2.9994540993539178e-6
allannah,0,girl,1,1,2.9994540993539178e-6
alleana,0,girl,1,1,2.9994540993539178e-6
allessa,0,girl,1,1,2.9994540993539178e-6
alli,0,girl,1,1,2.9994540993539178e-6
allie-rose,0,girl,1,1,2.9994540993539178e-6
alliha,0,girl,1,1,2.9994540993539178e-6
allisa,0,girl,1,1,2.9994540993539178e-6
allyanna,0,girl,1,1,2.9994540993539178e-6
alonna,0,girl,1,1,2.9994540993539178e-6
alphia,0,girl,1,1,2.9994540993539178e-6
altea,0,girl,1,1,2.9994540993539178e-6
aluvia,0,girl,1,1,2.9994540993539178e-6
alvira,0,girl,1,1,2.9994540993539178e-6
alyanah,0,girl,1,1,2.9994540993539178e-6
alyeah,0,girl,1,1,2.9994540993539178e-6
alyisia,0,girl,1,1,2.9994540993539178e-6
alysiah,0,girl,1,1,2.9994540993539178e-6
alyson,0,girl,1,1,2.9994540993539178e-6
alyth,0,girl,1,1,2.9994540993539178e-6
alyx-jean,0,girl,1,1,2.9994540993539178e-6
amaima,0,girl,1,1,2.9994540993539178e-6
amany,0,girl,1,1,2.9994540993539178e-6
amarah-rose,0,girl,1,1,2.9994540993539178e-6
amaryss,0,girl,1,1,2.9994540993539178e-6
amber-belle,0,girl,1,1,2.9994540993539178e-6
amber-sophia,0,girl,1,1,2.9994540993539178e-6
ameiliah,0,girl,1,1,2.9994540993539178e-6
amelia-esme,0,girl,1,1,2.9994540993539178e-6
ameliarose,0,girl,1,1,2.9994540993539178e-6
amie-leigh,0,girl,1,1,2.9994540993539178e-6
amie-rose,0,girl,1,1,2.9994540993539178e-6
amiee-leigh,0,girl,1,1,2.9994540993539178e-6
amii,0,girl,1,1,2.9994540993539178e-6
amilee,0,girl,3,3,8.998362298061752e-6
amiley,0,girl,1,1,2.9994540993539178e-6
amilija,0,girl,1,1,2.9994540993539178e-6
amiyah-grace,0,girl,1,1,2.9994540993539178e-6
aml,0,girl,1,1,2.9994540993539178e-6
amneh,0,girl,1,1,2.9994540993539178e-6
amvish,0,girl,1,1,2.9994540993539178e-6
amy-grace,0,girl,1,1,2.9994540993539178e-6
amythest,0,girl,1,1,2.9994540993539178e-6
ana-lilly,0,girl,1,1,2.9994540993539178e-6
ana-sogona,0,girl,1,1,2.9994540993539178e-6
anahat,0,girl,2,2,5.9989081987078355e-6
anamari,0,girl,1,1,2.9994540993539178e-6
andrija,0,girl,1,1,2.9994540993539178e-6
ane,0,girl,1,1,2.9994540993539178e-6
aneeyah,0,girl,1,1,2.9994540993539178e-6
anela,0,girl,1,1,2.9994540993539178e-6
aneliss-nicole,0,girl,1,1,2.9994540993539178e-6
aneta,0,girl,1,1,2.9994540993539178e-6
angel-marie,0,girl,1,1,2.9994540993539178e-6
angelita,0,girl,1,1,2.9994540993539178e-6
angelrose,0,girl,1,1,2.9994540993539178e-6
anice,0,girl,1,1,2.9994540993539178e-6
aniko,0,girl,1,1,2.9994540993539178e-6
anileah,0,girl,1,1,2.9994540993539178e-6
anna-louise,0,girl,1,1,2.9994540993539178e-6
anna-sophia,0,girl,1,1,2.9994540993539178e-6
annais,0,girl,1,1,2.9994540993539178e-6
annallie,0,girl,1,1,2.9994540993539178e-6
annarose,0,girl,1,1,2.9994540993539178e-6
annemarie,0,girl,1,1,2.9994540993539178e-6
anniejane,0,girl,1,1,2.9994540993539178e-6
annoushka,0,girl,1,1,2.9994540993539178e-6
annya,0,girl,1,1,2.9994540993539178e-6
anoosha,0,girl,1,1,2.9994540993539178e-6
anora,0,girl,1,1,2.9994540993539178e-6
anorah,0,girl,1,1,2.9994540993539178e-6
antonia'rose,0,girl,1,1,2.9994540993539178e-6
anwita,0,girl,1,1,2.9994540993539178e-6
anyu,0,girl,1,1,2.9994540993539178e-6
aoife-grace,0,girl,1,1,2.9994540993539178e-6
aomi,0,girl,1,1,2.9994540993539178e-6
appin,0,girl,1,1,2.9994540993539178e-6
apple,0,girl,1,1,2.9994540993539178e-6
april-leigh,0,girl,1,1,2.9994540993539178e-6
aqeelah,0,girl,1,1,2.9994540993539178e-6
arawyn,0,girl,1,1,2.9994540993539178e-6
areina,0,girl,1,1,2.9994540993539178e-6
aresha,0,girl,1,1,2.9994540993539178e-6
areyn,0,girl,1,1,2.9994540993539178e-6
aria-jade,0,girl,1,1,2.9994540993539178e-6
aria-sandi,0,girl,1,1,2.9994540993539178e-6
aria-skye,0,girl,1,1,2.9994540993539178e-6
ariana-joy,0,girl,1,1,2.9994540993539178e-6
arianna-leigh,0,girl,1,1,2.9994540993539178e-6
ariannah,0,girl,4,4,1.1997816397415671e-5
ariya-rose,0,girl,1,1,2.9994540993539178e-6
arlet,0,girl,1,1,2.9994540993539178e-6
arlyn,0,girl,1,1,2.9994540993539178e-6
armelle,0,girl,1,1,2.9994540993539178e-6
arrah,0,girl,1,1,2.9994540993539178e-6
arria,0,girl,2,2,5.9989081987078355e-6
arriah,0,girl,3,3,8.998362298061752e-6
arrianah,0,girl,1,1,2.9994540993539178e-6
arrianna,0,girl,2,2,5.9989081987078355e-6
arrika,0,girl,1,1,2.9994540993539178e-6
arrya,0,girl,1,1,2.9994540993539178e-6
artemisia,0,girl,1,1,2.9994540993539178e-6
aryah,0,girl,1,1,2.9994540993539178e-6
aryia-jaye,0,girl,1,1,2.9994540993539178e-6
aryiah,0,girl,1,1,2.9994540993539178e-6
aryiah-rose,0,girl,1,1,2.9994540993539178e-6
aryn,0,girl,2,2,5.9989081987078355e-6
ashadiya,0,girl,1,1,2.9994540993539178e-6
ashalynn,0,girl,1,1,2.9994540993539178e-6
ashley-leigh,0,girl,1,1,2.9994540993539178e-6
ashlin,0,girl,1,1,2.9994540993539178e-6
ashlynn,0,girl,1,1,2.9994540993539178e-6
ashwinder,0,girl,1,1,2.9994540993539178e-6
asmau,0,girl,1,1,2.9994540993539178e-6
asmita,0,girl,1,1,2.9994540993539178e-6
asna,0,girl,1,1,2.9994540993539178e-6
astaria,0,girl,1,1,2.9994540993539178e-6
aston,0,girl,1,1,2.9994540993539178e-6
astyn,0,girl,1,1,2.9994540993539178e-6
atene-athena,0,girl,1,1,2.9994540993539178e-6
athol,0,girl,1,1,2.9994540993539178e-6
atina,0,girl,1,1,2.9994540993539178e-6
aubrae,0,girl,1,1,2.9994540993539178e-6
audrey-rose,0,girl,1,1,2.9994540993539178e-6
aufa,0,girl,1,1,2.9994540993539178e-6
auley,0,girl,1,1,2.9994540993539178e-6
aunah,0,girl,1,1,2.9994540993539178e-6
aurora-sophia,0,girl,1,1,2.9994540993539178e-6
aurorah,0,girl,1,1,2.9994540993539178e-6
auryn,0,girl,2,2,5.9989081987078355e-6
autumn-lily,0,girl,1,1,2.9994540993539178e-6
ava-lynn,0,girl,1,1,2.9994540993539178e-6
ava-olivia,0,girl,1,1,2.9994540993539178e-6
avaia,0,girl,1,1,2.9994540993539178e-6
avariya,0,girl,1,1,2.9994540993539178e-6
avarose,0,girl,2,2,5.9989081987078355e-6
aven,0,girl,1,1,2.9994540993539178e-6
averie-elise,0,girl,1,1,2.9994540993539178e-6
aviara,0,girl,1,1,2.9994540993539178e-6
avijot,0,girl,1,1,2.9994540993539178e-6
avika,0,girl,1,1,2.9994540993539178e-6
ayanda,0,girl,2,2,5.9989081987078355e-6
aydah,0,girl,1,1,2.9994540993539178e-6
ayela,0,girl,1,1,2.9994540993539178e-6
ayla-louise,0,girl,1,1,2.9994540993539178e-6
ayleesia,0,girl,1,1,2.9994540993539178e-6
ayleigh,0,girl,1,1,2.9994540993539178e-6
ayler,0,girl,1,1,2.9994540993539178e-6
ayley,0,girl,1,1,2.9994540993539178e-6
aylia-marie,0,girl,1,1,2.9994540993539178e-6
aylie,0,girl,1,1,2.9994540993539178e-6
ayumi,0,girl,1,1,2.9994540993539178e-6
azealia,0,girl,1,1,2.9994540993539178e-6
azenate,0,girl,1,1,2.9994540993539178e-6
azmiyah,0,girl,1,1,2.9994540993539178e-6
baileigh,0,girl,2,2,5.9989081987078355e-6
bailey-bleu,0,girl,1,1,2.9994540993539178e-6
baillie,0,girl,4,4,1.1997816397415671e-5
balkis,0,girl,1,1,2.9994540993539178e-6
balreet,0,girl,1,1,2.9994540993539178e-6
basmah,0,girl,1,1,2.9994540993539178e-6
baylie,0,girl,1,1,2.9994540993539178e-6
beau-bear,0,girl,1,1,2.9994540993539178e-6
bejna,0,girl,1,1,2.9994540993539178e-6
belin,0,girl,1,1,2.9994540993539178e-6
bella-brooke,0,girl,1,1,2.9994540993539178e-6
bella-jane,0,girl,1,1,2.9994540993539178e-6
bella-jean,0,girl,1,1,2.9994540993539178e-6
bellamaria,0,girl,1,1,2.9994540993539178e-6
bellatrixx,0,girl,1,1,2.9994540993539178e-6
beni,0,girl,1,1,2.9994540993539178e-6
beryn,0,girl,1,1,2.9994540993539178e-6
besma,0,girl,1,1,2.9994540993539178e-6
bethany-anne,0,girl,1,1,2.9994540993539178e-6
betty-una,0,girl,1,1,2.9994540993539178e-6
bian,0,girl,1,1,2.9994540993539178e-6
bilal,0,girl,1,1,2.9994540993539178e-6
billie-leigh,0,girl,1,1,2.9994540993539178e-6
billieleigh,0,girl,1,1,2.9994540993539178e-6
bitania,0,girl,1,1,2.9994540993539178e-6
bitaniya,0,girl,1,1,2.9994540993539178e-6
blayke,0,girl,1,1,2.9994540993539178e-6
blayne,0,girl,1,1,2.9994540993539178e-6
blu-tygar,0,girl,1,1,2.9994540993539178e-6
blyth,0,girl,1,1,2.9994540993539178e-6
bobbi-jo,0,girl,2,2,5.9989081987078355e-6
boex,0,girl,1,1,2.9994540993539178e-6
boguslawa,0,girl,1,1,2.9994540993539178e-6
boshra,0,girl,1,1,2.9994540993539178e-6
boston,0,girl,1,1,2.9994540993539178e-6
bracken,0,girl,1,1,2.9994540993539178e-6
bradi,0,girl,1,1,2.9994540993539178e-6
brae,0,girl,2,2,5.9989081987078355e-6
braegan,0,girl,1,1,2.9994540993539178e-6
braelyn,0,girl,2,2,5.9989081987078355e-6
braeya,0,girl,1,1,2.9994540993539178e-6
breagh,0,girl,3,3,8.998362298061752e-6
breagha,0,girl,13,13,3.899290329160093e-5
breya,0,girl,1,1,2.9994540993539178e-6
briagh,0,girl,1,1,2.9994540993539178e-6
briah,0,girl,1,1,2.9994540993539178e-6
briana-rose,0,girl,1,1,2.9994540993539178e-6
briannah,0,girl,1,1,2.9994540993539178e-6
briannah-louise,0,girl,1,1,2.9994540993539178e-6
bridget-anne,0,girl,1,1,2.9994540993539178e-6
brier,0,girl,1,1,2.9994540993539178e-6
brihanna,0,girl,1,1,2.9994540993539178e-6
brodi,0,girl,2,2,5.9989081987078355e-6
broghan,0,girl,2,2,5.9989081987078355e-6
bronagh,0,girl,2,2,5.9989081987078355e-6
brooke-linn,0,girl,1,1,2.9994540993539178e-6
brooke-louise,0,girl,1,1,2.9994540993539178e-6
brooklynne,0,girl,1,1,2.9994540993539178e-6
brunella,0,girl,1,1,2.9994540993539178e-6
bryanni,0,girl,1,1,2.9994540993539178e-6
brylee,0,girl,1,1,2.9994540993539178e-6
bryleigh,0,girl,1,1,2.9994540993539178e-6
brynn,0,girl,1,1,2.9994540993539178e-6
byllie,0,girl,1,1,2.9994540993539178e-6
cacia,0,girl,1,1,2.9994540993539178e-6
cacie,0,girl,1,1,2.9994540993539178e-6
cadance,0,girl,1,1,2.9994540993539178e-6
caddie-elizabeth,0,girl,1,1,2.9994540993539178e-6
cadha,0,girl,1,1,2.9994540993539178e-6
cadhla,0,girl,1,1,2.9994540993539178e-6
cady,0,girl,2,2,5.9989081987078355e-6
caidrianna,0,girl,1,1,2.9994540993539178e-6
caila,0,girl,1,1,2.9994540993539178e-6
cailah,0,girl,1,1,2.9994540993539178e-6
cairistiona,0,girl,1,1,2.9994540993539178e-6
cairstine,0,girl,1,1,2.9994540993539178e-6
cait,0,girl,2,2,5.9989081987078355e-6
caitie,0,girl,1,1,2.9994540993539178e-6
caitriona,0,girl,1,1,2.9994540993539178e-6
cala,0,girl,1,1,2.9994540993539178e-6
calaidh,0,girl,1,1,2.9994540993539178e-6
cali-amber,0,girl,1,1,2.9994540993539178e-6
cali-skye,0,girl,1,1,2.9994540993539178e-6
caliah,0,girl,1,1,2.9994540993539178e-6
caliana,0,girl,1,1,2.9994540993539178e-6
callia,0,girl,1,1,2.9994540993539178e-6
callie-louise,0,girl,1,1,2.9994540993539178e-6
calsey,0,girl,1,1,2.9994540993539178e-6
cameryn,0,girl,2,2,5.9989081987078355e-6
cami-li,0,girl,1,1,2.9994540993539178e-6
camilee,0,girl,1,1,2.9994540993539178e-6
camilia,0,girl,1,1,2.9994540993539178e-6
camren,0,girl,1,1,2.9994540993539178e-6
camryn,0,girl,4,4,1.1997816397415671e-5
candaice,0,girl,1,1,2.9994540993539178e-6
caoilainn,0,girl,1,1,2.9994540993539178e-6
caoimhe-grace,0,girl,1,1,2.9994540993539178e-6
cara-grace,0,girl,1,1,2.9994540993539178e-6
carah,0,girl,1,1,2.9994540993539178e-6
caralyn,0,girl,1,1,2.9994540993539178e-6
carise,0,girl,1,1,2.9994540993539178e-6
cariss,0,girl,1,1,2.9994540993539178e-6
carleigh,0,girl,3,3,8.998362298061752e-6
carly-dee,0,girl,1,1,2.9994540993539178e-6
carly-louise,0,girl,1,1,2.9994540993539178e-6
carmyn,0,girl,1,1,2.9994540993539178e-6
carole,0,girl,1,1,2.9994540993539178e-6
carolyn,0,girl,1,1,2.9994540993539178e-6
carra,0,girl,1,1,2.9994540993539178e-6
carrick,0,girl,1,1,2.9994540993539178e-6
carsyn,0,girl,1,1,2.9994540993539178e-6
carwen,0,girl,1,1,2.9994540993539178e-6
casey-jane,0,girl,1,1,2.9994540993539178e-6
cassidhe,0,girl,1,1,2.9994540993539178e-6
cassie-ellen,0,girl,1,1,2.9994540993539178e-6
cassie-mae,0,girl,1,1,2.9994540993539178e-6
cassie-may,0,girl,1,1,2.9994540993539178e-6
cathleen,0,girl,1,1,2.9994540993539178e-6
catie,0,girl,1,1,2.9994540993539178e-6
cauvery,0,girl,1,1,2.9994540993539178e-6
caydee,0,girl,1,1,2.9994540993539178e-6
caydence,0,girl,1,1,2.9994540993539178e-6
caylee,0,girl,1,1,2.9994540993539178e-6
caylor,0,girl,1,1,2.9994540993539178e-6
caylyn,0,girl,1,1,2.9994540993539178e-6
ceanna,0,girl,1,1,2.9994540993539178e-6
ceara-leigh,0,girl,1,1,2.9994540993539178e-6
ceava,0,girl,1,1,2.9994540993539178e-6
ceilidh,0,girl,2,2,5.9989081987078355e-6
ceilidh-jane,0,girl,1,1,2.9994540993539178e-6
cerina,0,girl,1,1,2.9994540993539178e-6
cerise,0,girl,1,1,2.9994540993539178e-6
chaela,0,girl,1,1,2.9994540993539178e-6
chamelia-lily,0,girl,1,1,2.9994540993539178e-6
chanda,0,girl,1,1,2.9994540993539178e-6
chandrika,0,girl,1,1,2.9994540993539178e-6
chanjika,0,girl,1,1,2.9994540993539178e-6
channah,0,girl,1,1,2.9994540993539178e-6
channelle,0,girl,1,1,2.9994540993539178e-6
charlea,0,girl,1,1,2.9994540993539178e-6
charleigh-ann,0,girl,2,2,5.9989081987078355e-6
charleigh-ava,0,girl,1,1,2.9994540993539178e-6
charley-clare,0,girl,1,1,2.9994540993539178e-6
charley-jane,0,girl,1,1,2.9994540993539178e-6
charley-louise,0,girl,1,1,2.9994540993539178e-6
charli-mae,0,girl,1,1,2.9994540993539178e-6
charlie-anne,0,girl,1,1,2.9994540993539178e-6
charlii,0,girl,1,1,2.9994540993539178e-6
charlotte-alessa,0,girl,1,1,2.9994540993539178e-6
charlotte-grace,0,girl,1,1,2.9994540993539178e-6
chayah,0,girl,1,1,2.9994540993539178e-6
chelsea-jayne,0,girl,1,1,2.9994540993539178e-6
chen,0,girl,2,2,5.9989081987078355e-6
cheney,0,girl,1,1,2.9994540993539178e-6
cheye,0,girl,1,1,2.9994540993539178e-6
chigozirim,0,girl,1,1,2.9994540993539178e-6
chihiro,0,girl,1,1,2.9994540993539178e-6
chikamso,0,girl,1,1,2.9994540993539178e-6
chilel,0,girl,1,1,2.9994540993539178e-6
chimkarila,0,girl,1,1,2.9994540993539178e-6
chimzara,0,girl,1,1,2.9994540993539178e-6
chimzaram,0,girl,1,1,2.9994540993539178e-6
chinonye,0,girl,1,1,2.9994540993539178e-6
chisomebi,0,girl,1,1,2.9994540993539178e-6
chizaramekpere,0,girl,1,1,2.9994540993539178e-6
chizitaram,0,girl,1,1,2.9994540993539178e-6
chloe-grace,0,girl,1,1,2.9994540993539178e-6
chloee,0,girl,1,1,2.9994540993539178e-6
chrissie,0,girl,3,3,8.998362298061752e-6
chrissie-ann,0,girl,1,1,2.9994540993539178e-6
chrissy,0,girl,1,1,2.9994540993539178e-6
chu,0,girl,1,1,2.9994540993539178e-6
cienna-jai,0,girl,1,1,2.9994540993539178e-6
cievah,0,girl,1,1,2.9994540993539178e-6
circe,0,girl,1,1,2.9994540993539178e-6
cliona,0,girl,1,1,2.9994540993539178e-6
cobie,0,girl,1,1,2.9994540993539178e-6
codi,0,girl,1,1,2.9994540993539178e-6
coira,0,girl,2,2,5.9989081987078355e-6
conevieve,0,girl,1,1,2.9994540993539178e-6
connie-ann,0,girl,1,1,2.9994540993539178e-6
coragh,0,girl,1,1,2.9994540993539178e-6
coren,0,girl,1,1,2.9994540993539178e-6
corra,0,girl,1,1,2.9994540993539178e-6
corran,0,girl,3,3,8.998362298061752e-6
corrie,0,girl,2,2,5.9989081987078355e-6
corrin,0,girl,2,2,5.9989081987078355e-6
coryl,0,girl,1,1,2.9994540993539178e-6
corynn,0,girl,1,1,2.9994540993539178e-6
crystal-jayne,0,girl,1,1,2.9994540993539178e-6
cully-rose,0,girl,1,1,2.9994540993539178e-6
cyena,0,girl,1,1,2.9994540993539178e-6
d'lorah,0,girl,1,1,2.9994540993539178e-6
dahlyia,0,girl,1,1,2.9994540993539178e-6
daici,0,girl,1,1,2.9994540993539178e-6
daisee,0,girl,1,1,2.9994540993539178e-6
daisy-jayne,0,girl,1,1,2.9994540993539178e-6
daiva,0,girl,1,1,2.9994540993539178e-6
dalia-antonia,0,girl,1,1,2.9994540993539178e-6
dalida,0,girl,1,1,2.9994540993539178e-6
dalin,0,girl,1,1,2.9994540993539178e-6
dalton,0,girl,1,1,2.9994540993539178e-6
dami,0,girl,1,1,2.9994540993539178e-6
danai,0,girl,1,1,2.9994540993539178e-6
danna,0,girl,1,1,2.9994540993539178e-6
dannielle,0,girl,1,1,2.9994540993539178e-6
dannii,0,girl,1,1,2.9994540993539178e-6
dannika,0,girl,1,1,2.9994540993539178e-6
dara-abasi,0,girl,1,1,2.9994540993539178e-6
darbi,0,girl,1,1,2.9994540993539178e-6
darbie,0,girl,1,1,2.9994540993539178e-6
darceigh,0,girl,1,1,2.9994540993539178e-6
darci-rae,0,girl,1,1,2.9994540993539178e-6
darcy-ann,0,girl,1,1,2.9994540993539178e-6
darcymay,0,girl,1,1,2.9994540993539178e-6
dariya-rose,0,girl,1,1,2.9994540993539178e-6
darla-jane,0,girl,1,1,2.9994540993539178e-6
darrah,0,girl,1,1,2.9994540993539178e-6
das,0,girl,1,1,2.9994540993539178e-6
dava,0,girl,1,1,2.9994540993539178e-6
deizija,0,girl,1,1,2.9994540993539178e-6
della-mae,0,girl,1,1,2.9994540993539178e-6
denni,0,girl,1,1,2.9994540993539178e-6
derri,0,girl,1,1,2.9994540993539178e-6
derrian,0,girl,1,1,2.9994540993539178e-6
derrin,0,girl,1,1,2.9994540993539178e-6
derya,0,girl,1,1,2.9994540993539178e-6
deven,0,girl,1,1,2.9994540993539178e-6
devlin,0,girl,1,1,2.9994540993539178e-6
devyn,0,girl,2,2,5.9989081987078355e-6
devyn-rae,0,girl,1,1,2.9994540993539178e-6
devynn,0,girl,1,1,2.9994540993539178e-6
dexi-leigh,0,girl,1,1,2.9994540993539178e-6
dhax,0,girl,1,1,2.9994540993539178e-6
dhiyana,0,girl,1,1,2.9994540993539178e-6
dianna-june,0,girl,1,1,2.9994540993539178e-6
diara,0,girl,2,2,5.9989081987078355e-6
dikshita,0,girl,1,1,2.9994540993539178e-6
dilinna,0,girl,1,1,2.9994540993539178e-6
dilneet,0,girl,1,1,2.9994540993539178e-6
dimah,0,girl,1,1,2.9994540993539178e-6
dionne,0,girl,1,1,2.9994540993539178e-6
dionysia,0,girl,1,1,2.9994540993539178e-6
div,0,girl,1,1,2.9994540993539178e-6
divisha,0,girl,1,1,2.9994540993539178e-6
drisha,0,girl,1,1,2.9994540993539178e-6
drishti,0,girl,1,1,2.9994540993539178e-6
dua'a,0,girl,1,1,2.9994540993539178e-6
dulciee,0,girl,1,1,2.9994540993539178e-6
dya,0,girl,1,1,2.9994540993539178e-6
dyc,0,girl,1,1,2.9994540993539178e-6
dylan-marie,0,girl,1,1,2.9994540993539178e-6
eabha-grace,0,girl,1,1,2.9994540993539178e-6
eaden,0,girl,1,1,2.9994540993539178e-6
eala,0,girl,1,1,2.9994540993539178e-6
ealasaid,0,girl,1,1,2.9994540993539178e-6
eartha,0,girl,2,2,5.9989081987078355e-6
ebbie,0,girl,1,1,2.9994540993539178e-6
ebonnie,0,girl,1,1,2.9994540993539178e-6
ebosolease,0,girl,1,1,2.9994540993539178e-6
eden-love,0,girl,1,1,2.9994540993539178e-6
edrea,0,girl,1,1,2.9994540993539178e-6
effie-jo,0,girl,1,1,2.9994540993539178e-6
efrosyni,0,girl,1,1,2.9994540993539178e-6
ehilanah,0,girl,1,1,2.9994540993539178e-6
ehsane,0,girl,1,1,2.9994540993539178e-6
eildon,0,girl,1,1,2.9994540993539178e-6
eilean,0,girl,1,1,2.9994540993539178e-6
eilee,0,girl,1,1,2.9994540993539178e-6
eilidh-ceit,0,girl,1,1,2.9994540993539178e-6
eilidh-may,0,girl,1,1,2.9994540993539178e-6
eimhir,0,girl,1,1,2.9994540993539178e-6
eireann-rose,0,girl,1,1,2.9994540993539178e-6
eireanne,0,girl,1,1,2.9994540993539178e-6
eiryn,0,girl,1,1,2.9994540993539178e-6
eisha,0,girl,2,2,5.9989081987078355e-6
eisra,0,girl,1,1,2.9994540993539178e-6
ekaterini,0,girl,1,1,2.9994540993539178e-6
ekondu,0,girl,1,1,2.9994540993539178e-6
elaena,0,girl,1,1,2.9994540993539178e-6
elda-may,0,girl,1,1,2.9994540993539178e-6
eleah-faith,0,girl,1,1,2.9994540993539178e-6
eleanor-mae,0,girl,1,1,2.9994540993539178e-6
eleonor,0,girl,1,1,2.9994540993539178e-6
elidh,0,girl,1,1,2.9994540993539178e-6
eliotte,0,girl,1,1,2.9994540993539178e-6
elisa-cristina,0,girl,1,1,2.9994540993539178e-6
elisheba,0,girl,1,1,2.9994540993539178e-6
ella-anne,0,girl,1,1,2.9994540993539178e-6
ella-jay,0,girl,1,1,2.9994540993539178e-6
ella-mia,0,girl,1,1,2.9994540993539178e-6
ellan,0,girl,1,1,2.9994540993539178e-6
ellaria,0,girl,1,1,2.9994540993539178e-6
elleigh,0,girl,1,1,2.9994540993539178e-6
elleise,0,girl,1,1,2.9994540993539178e-6
ellera,0,girl,1,1,2.9994540993539178e-6
ellerina,0,girl,1,1,2.9994540993539178e-6
ellidh,0,girl,1,1,2.9994540993539178e-6
ellie-jasmine,0,girl,1,1,2.9994540993539178e-6
ellie-leigh,0,girl,1,1,2.9994540993539178e-6
ellie-lou,0,girl,1,1,2.9994540993539178e-6
ellie-margaret,0,girl,1,1,2.9994540993539178e-6
elliena,0,girl,1,1,2.9994540993539178e-6
ellienor,0,girl,1,1,2.9994540993539178e-6
ellsi,0,girl,1,1,2.9994540993539178e-6
elodie-anne,0,girl,1,1,2.9994540993539178e-6
elodie-rae,0,girl,1,1,2.9994540993539178e-6
elon,0,girl,1,1,2.9994540993539178e-6
elorah,0,girl,1,1,2.9994540993539178e-6
elsa-mae,0,girl,1,1,2.9994540993539178e-6
else,0,girl,1,1,2.9994540993539178e-6
elska,0,girl,1,1,2.9994540993539178e-6
elvin,0,girl,1,1,2.9994540993539178e-6
elwyn,0,girl,1,1,2.9994540993539178e-6
ely-rose,0,girl,1,1,2.9994540993539178e-6
elysabet,0,girl,1,1,2.9994540993539178e-6
elzira,0,girl,1,1,2.9994540993539178e-6
emaghaen-rose,0,girl,1,1,2.9994540993539178e-6
emaili-rose,0,girl,1,1,2.9994540993539178e-6
emalee,0,girl,1,1,2.9994540993539178e-6
emaleigh,0,girl,1,1,2.9994540993539178e-6
emeilie,0,girl,1,1,2.9994540993539178e-6
emelia-jane,0,girl,1,1,2.9994540993539178e-6
emellie,0,girl,2,2,5.9989081987078355e-6
emely,0,girl,1,1,2.9994540993539178e-6
emer,0,girl,2,2,5.9989081987078355e-6
emese,0,girl,1,1,2.9994540993539178e-6
emi-leigh,0,girl,1,1,2.9994540993539178e-6
emilietiree,0,girl,1,1,2.9994540993539178e-6
emilli,0,girl,1,1,2.9994540993539178e-6
emily-ann,0,girl,1,1,2.9994540993539178e-6
emily-lynn,0,girl,1,1,2.9994540993539178e-6
emily-vespii,0,girl,1,1,2.9994540993539178e-6
emilya,0,girl,1,1,2.9994540993539178e-6
emira,0,girl,1,1,2.9994540993539178e-6
emma-june,0,girl,1,1,2.9994540993539178e-6
emma-may,0,girl,1,1,2.9994540993539178e-6
emmalee,0,girl,1,1,2.9994540993539178e-6
emmi-grace,0,girl,1,1,2.9994540993539178e-6
emmie-anne,0,girl,1,1,2.9994540993539178e-6
empress,0,girl,1,1,2.9994540993539178e-6
en,0,girl,1,1,2.9994540993539178e-6
eneye,0,girl,1,1,2.9994540993539178e-6
enola,0,girl,1,1,2.9994540993539178e-6
enora,0,girl,1,1,2.9994540993539178e-6
enyo,0,girl,1,1,2.9994540993539178e-6
ephra,0,girl,1,1,2.9994540993539178e-6
erela,0,girl,1,1,2.9994540993539178e-6
erhiroghene,0,girl,1,1,2.9994540993539178e-6
erhyn,0,girl,1,1,2.9994540993539178e-6
erin-amelia,0,girl,1,1,2.9994540993539178e-6
eriska,0,girl,1,1,2.9994540993539178e-6
eseme,0,girl,1,1,2.9994540993539178e-6
eseoghene,0,girl,1,1,2.9994540993539178e-6
esme-ann,0,girl,1,1,2.9994540993539178e-6
esme-mira,0,girl,1,1,2.9994540993539178e-6
esmee-beau,0,girl,1,1,2.9994540993539178e-6
esrah,0,girl,1,1,2.9994540993539178e-6
esrin,0,girl,1,1,2.9994540993539178e-6
estie,0,girl,1,1,2.9994540993539178e-6
eta,0,girl,1,1,2.9994540993539178e-6
etta-mae,0,girl,1,1,2.9994540993539178e-6
euan,0,girl,1,1,2.9994540993539178e-6
eubha,0,girl,1,1,2.9994540993539178e-6
euphemia,0,girl,1,1,2.9994540993539178e-6
everay,0,girl,1,1,2.9994540993539178e-6
everly-may,0,girl,1,1,2.9994540993539178e-6
eviano,0,girl,1,1,2.9994540993539178e-6
evina,0,girl,1,1,2.9994540993539178e-6
evvie,0,girl,1,1,2.9994540993539178e-6
excellent,0,girl,1,1,2.9994540993539178e-6
eydie,0,girl,1,1,2.9994540993539178e-6
ez-mae,0,girl,1,1,2.9994540993539178e-6
faarisah,0,girl,1,1,2.9994540993539178e-6
faleha,0,girl,1,1,2.9994540993539178e-6
fallyn,0,girl,1,1,2.9994540993539178e-6
fareen,0,girl,1,1,2.9994540993539178e-6
farida-rania,0,girl,1,1,2.9994540993539178e-6
farrell,0,girl,1,1,2.9994540993539178e-6
faryl,0,girl,1,1,2.9994540993539178e-6
fayna,0,girl,1,1,2.9994540993539178e-6
feah,0,girl,1,1,2.9994540993539178e-6
febechi,0,girl,1,1,2.9994540993539178e-6
felisha,0,girl,1,1,2.9994540993539178e-6
felix,0,girl,1,1,2.9994540993539178e-6
fergie,0,girl,1,1,2.9994540993539178e-6
fiah,0,girl,1,1,2.9994540993539178e-6
filippa,0,girl,1,1,2.9994540993539178e-6
finn,0,girl,2,2,5.9989081987078355e-6
floraidh,0,girl,3,3,8.998362298061752e-6
flore,0,girl,1,1,2.9994540993539178e-6
florentina-sorina,0,girl,1,1,2.9994540993539178e-6
florina,0,girl,1,1,2.9994540993539178e-6
florrie-jane,0,girl,1,1,2.9994540993539178e-6
forde,0,girl,2,2,5.9989081987078355e-6
fowada,0,girl,1,1,2.9994540993539178e-6
francys,0,girl,1,1,2.9994540993539178e-6
frania,0,girl,1,1,2.9994540993539178e-6
freiya,0,girl,1,1,2.9994540993539178e-6
freya-anne,0,girl,1,1,2.9994540993539178e-6
freyah-may,0,girl,1,1,2.9994540993539178e-6
frieya,0,girl,1,1,2.9994540993539178e-6
fynn,0,girl,1,1,2.9994540993539178e-6
gabbie,0,girl,1,1,2.9994540993539178e-6
gabisile,0,girl,1,1,2.9994540993539178e-6
gaea,0,girl,1,1,2.9994540993539178e-6
gaja,0,girl,1,1,2.9994540993539178e-6
gea,0,girl,1,1,2.9994540993539178e-6
georgie-hope,0,girl,1,1,2.9994540993539178e-6
georgie-lee,0,girl,1,1,2.9994540993539178e-6
georgy,0,girl,1,1,2.9994540993539178e-6
ghaniya,0,girl,1,1,2.9994540993539178e-6
ghfran,0,girl,1,1,2.9994540993539178e-6
gia-james,0,girl,1,1,2.9994540993539178e-6
gianah,0,girl,1,1,2.9994540993539178e-6
girisha,0,girl,1,1,2.9994540993539178e-6
gitika,0,girl,1,1,2.9994540993539178e-6
glorie,0,girl,1,1,2.9994540993539178e-6
gnima,0,girl,1,1,2.9994540993539178e-6
gokcen,0,girl,1,1,2.9994540993539178e-6
graci-mai,0,girl,1,1,2.9994540993539178e-6
gracy,0,girl,2,2,5.9989081987078355e-6
graycee,0,girl,1,1,2.9994540993539178e-6
greer,0,girl,1,1,2.9994540993539178e-6
grier,0,girl,1,1,2.9994540993539178e-6
gursahaj,0,girl,1,1,2.9994540993539178e-6
gypsy,0,girl,1,1,2.9994540993539178e-6
haamida,0,girl,1,1,2.9994540993539178e-6
haasika,0,girl,1,1,2.9994540993539178e-6
hailee,0,girl,1,1,2.9994540993539178e-6
haillie-jade,0,girl,1,1,2.9994540993539178e-6
hailo,0,girl,1,1,2.9994540993539178e-6
haleigh,0,girl,1,1,2.9994540993539178e-6
halley,0,girl,1,1,2.9994540993539178e-6
hallie-anne,0,girl,1,1,2.9994540993539178e-6
halo-mae,0,girl,1,1,2.9994540993539178e-6
hana-rosie,0,girl,1,1,2.9994540993539178e-6
hannah-rey,0,girl,1,1,2.9994540993539178e-6
harjia,0,girl,1,1,2.9994540993539178e-6
harlae,0,girl,1,1,2.9994540993539178e-6
harlea,0,girl,1,1,2.9994540993539178e-6
harlee-amelia,0,girl,1,1,2.9994540993539178e-6
harlen,0,girl,1,1,2.9994540993539178e-6
harlie-jo,0,girl,1,1,2.9994540993539178e-6
harloh,0,girl,1,1,2.9994540993539178e-6
harlow-river,0,girl,1,1,2.9994540993539178e-6
harly,0,girl,1,1,2.9994540993539178e-6
harlyi-rae,0,girl,1,1,2.9994540993539178e-6
harlynn,0,girl,1,1,2.9994540993539178e-6
harmaya,0,girl,1,1,2.9994540993539178e-6
harmoni,0,girl,1,1,2.9994540993539178e-6
harper-ivy,0,girl,1,1,2.9994540993539178e-6
harper-scarlett,0,girl,1,1,2.9994540993539178e-6
harrai,0,girl,1,1,2.9994540993539178e-6
harris,0,girl,2,2,5.9989081987078355e-6
harsahib,0,girl,1,1,2.9994540993539178e-6
harshini,0,girl,1,1,2.9994540993539178e-6
harsimran,0,girl,1,1,2.9994540993539178e-6
harum,0,girl,1,1,2.9994540993539178e-6
harvey,0,girl,1,1,2.9994540993539178e-6
hasika,0,girl,1,1,2.9994540993539178e-6
hasini,0,girl,1,1,2.9994540993539178e-6
hasitha,0,girl,1,1,2.9994540993539178e-6
havanah,0,girl,1,1,2.9994540993539178e-6
haven,0,girl,1,1,2.9994540993539178e-6
haylay,0,girl,1,1,2.9994540993539178e-6
haylie,0,girl,2,2,5.9989081987078355e-6
hedda,0,girl,1,1,2.9994540993539178e-6
heleana,0,girl,1,1,2.9994540993539178e-6
helenna,0,girl,1,1,2.9994540993539178e-6
hellen,0,girl,1,1,2.9994540993539178e-6
hena,0,girl,1,1,2.9994540993539178e-6
heyran,0,girl,1,1,2.9994540993539178e-6
hibatullah,0,girl,1,1,2.9994540993539178e-6
hibbatul,0,girl,1,1,2.9994540993539178e-6
hilary,0,girl,1,1,2.9994540993539178e-6
hiromi,0,girl,1,1,2.9994540993539178e-6
hoi,0,girl,1,1,2.9994540993539178e-6
hong,0,girl,1,1,2.9994540993539178e-6
hope-kelsey,0,girl,1,1,2.9994540993539178e-6
hortensja,0,girl,1,1,2.9994540993539178e-6
hosnia,0,girl,1,1,2.9994540993539178e-6
hothra,0,girl,1,1,2.9994540993539178e-6
hudson,0,girl,2,2,5.9989081987078355e-6
hunsvi,0,girl,1,1,2.9994540993539178e-6
hurrain,0,girl,1,1,2.9994540993539178e-6
hyab,0,girl,1,1,2.9994540993539178e-6
ibby,0,girl,1,1,2.9994540993539178e-6
idania,0,girl,1,1,2.9994540993539178e-6
ide,0,girl,1,1,2.9994540993539178e-6
idun,0,girl,1,1,2.9994540993539178e-6
ieesha,0,girl,1,1,2.9994540993539178e-6
ife,0,girl,1,1,2.9994540993539178e-6
ifelola,0,girl,1,1,2.9994540993539178e-6
iheoma,0,girl,1,1,2.9994540993539178e-6
ilia,0,girl,2,2,5.9989081987078355e-6
ilika,0,girl,1,1,2.9994540993539178e-6
immie,0,girl,1,1,2.9994540993539178e-6
indah,0,girl,1,1,2.9994540993539178e-6
indea,0,girl,1,1,2.9994540993539178e-6
indi-sophia,0,girl,1,1,2.9994540993539178e-6
indie-gaia,0,girl,1,1,2.9994540993539178e-6
indie-raine,0,girl,1,1,2.9994540993539178e-6
ingerid,0,girl,1,1,2.9994540993539178e-6
innes,0,girl,1,1,2.9994540993539178e-6
iochebed,0,girl,1,1,2.9994540993539178e-6
ioli,0,girl,1,1,2.9994540993539178e-6
iona-jane,0,girl,1,1,2.9994540993539178e-6
ionagh,0,girl,1,1,2.9994540993539178e-6
iroroevwo,0,girl,1,1,2.9994540993539178e-6
isabella-ana,0,girl,1,1,2.9994540993539178e-6
ishbel,0,girl,4,4,1.1997816397415671e-5
ishe-oluwa,0,girl,1,1,2.9994540993539178e-6
isla-anne,0,girl,1,1,2.9994540993539178e-6
isla-lee,0,girl,1,1,2.9994540993539178e-6
islay-mae,0,girl,1,1,2.9994540993539178e-6
ithiel,0,girl,1,1,2.9994540993539178e-6
iveagh,0,girl,1,1,2.9994540993539178e-6
iveigh,0,girl,1,1,2.9994540993539178e-6
ivory-jane,0,girl,1,1,2.9994540993539178e-6
ivy-angeles,0,girl,1,1,2.9994540993539178e-6
iyesha-rose,0,girl,1,1,2.9994540993539178e-6
izabela-alexia,0,girl,1,1,2.9994540993539178e-6
izogie,0,girl,1,1,2.9994540993539178e-6
jahan,0,girl,1,1,2.9994540993539178e-6
jaia-jane,0,girl,1,1,2.9994540993539178e-6
jaimee,0,girl,1,1,2.9994540993539178e-6
jaisleen,0,girl,1,1,2.9994540993539178e-6
jamie-lee,0,girl,3,3,8.998362298061752e-6
janie-lou,0,girl,1,1,2.9994540993539178e-6
janis,0,girl,1,1,2.9994540993539178e-6
jarah-joss,0,girl,1,1,2.9994540993539178e-6
jasman,0,girl,1,1,2.9994540993539178e-6
jasmyn-rose,0,girl,1,1,2.9994540993539178e-6
jasroop,0,girl,1,1,2.9994540993539178e-6
jay-lee,0,girl,1,1,2.9994540993539178e-6
jaydee,0,girl,1,1,2.9994540993539178e-6
jayden,0,girl,1,1,2.9994540993539178e-6
jaye,0,girl,1,1,2.9994540993539178e-6
jaymi,0,girl,1,1,2.9994540993539178e-6
jaymie,0,girl,1,1,2.9994540993539178e-6
jaza,0,girl,1,1,2.9994540993539178e-6
jeannie-marie,0,girl,1,1,2.9994540993539178e-6
jeevika,0,girl,1,1,2.9994540993539178e-6
jehosheba,0,girl,1,1,2.9994540993539178e-6
jenni,0,girl,3,3,8.998362298061752e-6
jeorgie,0,girl,1,1,2.9994540993539178e-6
jerreline,0,girl,1,1,2.9994540993539178e-6
jeslin,0,girl,1,1,2.9994540993539178e-6
jessa,0,girl,1,1,2.9994540993539178e-6
jessamy,0,girl,1,1,2.9994540993539178e-6
jesselina,0,girl,1,1,2.9994540993539178e-6
jessica-ellys,0,girl,1,1,2.9994540993539178e-6
jessikah-rose,0,girl,1,1,2.9994540993539178e-6
jesslyn,0,girl,2,2,5.9989081987078355e-6
jetta,0,girl,1,1,2.9994540993539178e-6
jiakun,0,girl,1,1,2.9994540993539178e-6
jiaying,0,girl,1,1,2.9994540993539178e-6
jillian,0,girl,1,1,2.9994540993539178e-6
jitka,0,girl,1,1,2.9994540993539178e-6
jocie,0,girl,1,1,2.9994540993539178e-6
jodee,0,girl,1,1,2.9994540993539178e-6
jodi,0,girl,3,3,8.998362298061752e-6
jody,0,girl,1,1,2.9994540993539178e-6
johan,0,girl,1,1,2.9994540993539178e-6
jolin,0,girl,1,1,2.9994540993539178e-6
jonna,0,girl,1,1,2.9994540993539178e-6
jonnella,0,girl,1,1,2.9994540993539178e-6
joolz,0,girl,1,1,2.9994540993539178e-6
jora,0,girl,1,1,2.9994540993539178e-6
jordanna,0,girl,1,1,2.9994540993539178e-6
jorgi,0,girl,4,4,1.1997816397415671e-5
jori,0,girl,1,1,2.9994540993539178e-6
joudy,0,girl,1,1,2.9994540993539178e-6
juhitha,0,girl,1,1,2.9994540993539178e-6
julie-anne,0,girl,1,1,2.9994540993539178e-6
julliette,0,girl,1,1,2.9994540993539178e-6
jumaana,0,girl,1,1,2.9994540993539178e-6
junaina,0,girl,1,1,2.9994540993539178e-6
jura,0,girl,2,2,5.9989081987078355e-6
kaceyleigh,0,girl,2,2,5.9989081987078355e-6
kada,0,girl,1,1,2.9994540993539178e-6
kadei,0,girl,1,1,2.9994540993539178e-6
kadii,0,girl,1,1,2.9994540993539178e-6
kadyleigh,0,girl,1,1,2.9994540993539178e-6
kaelah,0,girl,2,2,5.9989081987078355e-6
kaicie,0,girl,1,1,2.9994540993539178e-6
kaicie-mae,0,girl,1,1,2.9994540993539178e-6
kaidence,0,girl,1,1,2.9994540993539178e-6
kaila-lei,0,girl,1,1,2.9994540993539178e-6
kailesa,0,girl,1,1,2.9994540993539178e-6
kailyn,0,girl,2,2,5.9989081987078355e-6
kailynn,0,girl,1,1,2.9994540993539178e-6
kaiyra,0,girl,1,1,2.9994540993539178e-6
kala,0,girl,1,1,2.9994540993539178e-6
kaleigha,0,girl,1,1,2.9994540993539178e-6
kaliah,0,girl,1,1,2.9994540993539178e-6
kalley,0,girl,1,1,2.9994540993539178e-6
kamerin,0,girl,1,1,2.9994540993539178e-6
kamryn,0,girl,3,3,8.998362298061752e-6
kandis,0,girl,1,1,2.9994540993539178e-6
kara-grace,0,girl,1,1,2.9994540993539178e-6
karah,0,girl,1,1,2.9994540993539178e-6
karci,0,girl,1,1,2.9994540993539178e-6
karice,0,girl,1,1,2.9994540993539178e-6
karisse,0,girl,1,1,2.9994540993539178e-6
karla-elena,0,girl,1,1,2.9994540993539178e-6
karley,0,girl,2,2,5.9989081987078355e-6
karli,0,girl,6,6,1.7996724596123505e-5
karlisse,0,girl,1,1,2.9994540993539178e-6
karlyn,0,girl,1,1,2.9994540993539178e-6
karmela,0,girl,1,1,2.9994540993539178e-6
karmin,0,girl,1,1,2.9994540993539178e-6
karra,0,girl,1,1,2.9994540993539178e-6
karragh,0,girl,1,1,2.9994540993539178e-6
karrah,0,girl,1,1,2.9994540993539178e-6
karris,0,girl,1,1,2.9994540993539178e-6
karsyn,0,girl,1,1,2.9994540993539178e-6
karthiga,0,girl,1,1,2.9994540993539178e-6
kasey-leigh,0,girl,1,1,2.9994540993539178e-6
kasey-mae,0,girl,1,1,2.9994540993539178e-6
kasie-marie,0,girl,1,1,2.9994540993539178e-6
kassiani,0,girl,1,1,2.9994540993539178e-6
kassima-mae,0,girl,1,1,2.9994540993539178e-6
kaswa,0,girl,1,1,2.9994540993539178e-6
kate-lynn,0,girl,1,1,2.9994540993539178e-6
katie-anna,0,girl,1,1,2.9994540993539178e-6
katie-beth,0,girl,1,1,2.9994540993539178e-6
katie-jane,0,girl,1,1,2.9994540993539178e-6
katie-marie,0,girl,1,1,2.9994540993539178e-6
katrine,0,girl,2,2,5.9989081987078355e-6
katryna,0,girl,1,1,2.9994540993539178e-6
kaula,0,girl,1,1,2.9994540993539178e-6
kay-dee,0,girl,1,1,2.9994540993539178e-6
kaya-rose,0,girl,1,1,2.9994540993539178e-6
kaycey,0,girl,1,1,2.9994540993539178e-6
kaydance,0,girl,1,1,2.9994540993539178e-6
kaydie-lee,0,girl,1,1,2.9994540993539178e-6
kayee,0,girl,1,1,2.9994540993539178e-6
kaylyn,0,girl,2,2,5.9989081987078355e-6
kaysi,0,girl,1,1,2.9994540993539178e-6
kayslin,0,girl,1,1,2.9994540993539178e-6
kc,0,girl,1,1,2.9994540993539178e-6
ke,0,girl,2,2,5.9989081987078355e-6
keadi,0,girl,1,1,2.9994540993539178e-6
keatyn,0,girl,1,1,2.9994540993539178e-6
keavagh,0,girl,1,1,2.9994540993539178e-6
keera-louise,0,girl,1,1,2.9994540993539178e-6
keerah,0,girl,1,1,2.9994540993539178e-6
keeva-lea,0,girl,1,1,2.9994540993539178e-6
kefah,0,girl,1,1,2.9994540993539178e-6
keiana,0,girl,1,1,2.9994540993539178e-6
keira-rose,0,girl,1,1,2.9994540993539178e-6
keiralee,0,girl,1,1,2.9994540993539178e-6
keirissy,0,girl,1,1,2.9994540993539178e-6
keitija,0,girl,1,1,2.9994540993539178e-6
keiva,0,girl,2,2,5.9989081987078355e-6
keivah,0,girl,1,1,2.9994540993539178e-6
kelci,0,girl,1,1,2.9994540993539178e-6
kelda,0,girl,1,1,2.9994540993539178e-6
kella,0,girl,1,1,2.9994540993539178e-6
kellen,0,girl,1,1,2.9994540993539178e-6
kelsey-marie,0,girl,1,1,2.9994540993539178e-6
kendall-aileen,0,girl,1,1,2.9994540993539178e-6
kendyl,0,girl,1,1,2.9994540993539178e-6
kenedi,0,girl,1,1,2.9994540993539178e-6
kenlyn,0,girl,1,1,2.9994540993539178e-6
kenzie-rose,0,girl,1,1,2.9994540993539178e-6
kereen,0,girl,1,1,2.9994540993539178e-6
keri,0,girl,1,1,2.9994540993539178e-6
kerin,0,girl,1,1,2.9994540993539178e-6
keris,0,girl,3,3,8.998362298061752e-6
kerlyn,0,girl,1,1,2.9994540993539178e-6
kerri-anne,0,girl,1,1,2.9994540993539178e-6
keryn,0,girl,3,3,8.998362298061752e-6
kerys,0,girl,1,1,2.9994540993539178e-6
kesienna,0,girl,1,1,2.9994540993539178e-6
keyvah,0,girl,1,1,2.9994540993539178e-6
khadja,0,girl,1,1,2.9994540993539178e-6
khali,0,girl,2,2,5.9989081987078355e-6
khalise,0,girl,1,1,2.9994540993539178e-6
khaly,0,girl,1,1,2.9994540993539178e-6
kharris,0,girl,1,1,2.9994540993539178e-6
khaya,0,girl,1,1,2.9994540993539178e-6
khleo,0,girl,1,1,2.9994540993539178e-6
khloey,0,girl,1,1,2.9994540993539178e-6
khonnie,0,girl,1,1,2.9994540993539178e-6
khristine,0,girl,1,1,2.9994540993539178e-6
kiara-rae,0,girl,1,1,2.9994540993539178e-6
kiela,0,girl,1,1,2.9994540993539178e-6
kievie,0,girl,1,1,2.9994540993539178e-6
kihara,0,girl,1,1,2.9994540993539178e-6
kilana,0,girl,1,1,2.9994540993539178e-6
kimarachi,0,girl,1,1,2.9994540993539178e-6
kimi-lee,0,girl,1,1,2.9994540993539178e-6
kimiko,0,girl,1,1,2.9994540993539178e-6
kingsley,0,girl,2,2,5.9989081987078355e-6
kinley,0,girl,2,2,5.9989081987078355e-6
kipepeo,0,girl,1,1,2.9994540993539178e-6
kirah,0,girl,1,1,2.9994540993539178e-6
kirsteen,0,girl,1,1,2.9994540993539178e-6
kirstie,0,girl,1,1,2.9994540993539178e-6
kitsy,0,girl,1,1,2.9994540993539178e-6
kiva,0,girl,2,2,5.9989081987078355e-6
kiyra,0,girl,1,1,2.9994540993539178e-6
kloe-may,0,girl,1,1,2.9994540993539178e-6
koda,0,girl,1,1,2.9994540993539178e-6
konnor,0,girl,1,1,2.9994540993539178e-6
konstancja,0,girl,1,1,2.9994540993539178e-6
kopelyn,0,girl,1,1,2.9994540993539178e-6
korah,0,girl,2,2,5.9989081987078355e-6
korbyn,0,girl,1,1,2.9994540993539178e-6
kori,0,girl,1,1,2.9994540993539178e-6
korra,0,girl,1,1,2.9994540993539178e-6
kripa,0,girl,1,1,2.9994540993539178e-6
krisiana,0,girl,1,1,2.9994540993539178e-6
krissi,0,girl,1,1,2.9994540993539178e-6
krista,0,girl,1,1,2.9994540993539178e-6
kumba,0,girl,1,1,2.9994540993539178e-6
kushveer,0,girl,1,1,2.9994540993539178e-6
kyrah-ann,0,girl,1,1,2.9994540993539178e-6
kyrah-leigh,0,girl,1,1,2.9994540993539178e-6
labhaoise,0,girl,1,1,2.9994540993539178e-6
lacey-marie,0,girl,1,1,2.9994540993539178e-6
laceyanne,0,girl,1,1,2.9994540993539178e-6
lachana,0,girl,1,1,2.9994540993539178e-6
lacie-marie,0,girl,1,1,2.9994540993539178e-6
lacii,0,girl,1,1,2.9994540993539178e-6
lacy-may,0,girl,1,1,2.9994540993539178e-6
laihla,0,girl,1,1,2.9994540993539178e-6
laike,0,girl,1,1,2.9994540993539178e-6
lailla,0,girl,1,1,2.9994540993539178e-6
lainy,0,girl,1,1,2.9994540993539178e-6
lanah,0,girl,1,1,2.9994540993539178e-6
lanesra,0,girl,1,1,2.9994540993539178e-6
lannah,0,girl,1,1,2.9994540993539178e-6
lara-mae,0,girl,1,1,2.9994540993539178e-6
laraz,0,girl,1,1,2.9994540993539178e-6
laria,0,girl,1,1,2.9994540993539178e-6
lark,0,girl,1,1,2.9994540993539178e-6
larra,0,girl,1,1,2.9994540993539178e-6
lateysha,0,girl,1,1,2.9994540993539178e-6
laura-ann,0,girl,1,1,2.9994540993539178e-6
laura-leigh,0,girl,1,1,2.9994540993539178e-6
laura-rose,0,girl,1,1,2.9994540993539178e-6
laurelle,0,girl,1,1,2.9994540993539178e-6
laurianna,0,girl,1,1,2.9994540993539178e-6
lawson,0,girl,1,1,2.9994540993539178e-6
layci,0,girl,1,1,2.9994540993539178e-6
layla-beth,0,girl,1,1,2.9994540993539178e-6
laylah-mae,0,girl,1,1,2.9994540993539178e-6
laylah-rose,0,girl,1,1,2.9994540993539178e-6
layyanah,0,girl,1,1,2.9994540993539178e-6
leah-lilly,0,girl,1,1,2.9994540993539178e-6
leavi,0,girl,1,1,2.9994540993539178e-6
lee,0,girl,1,1,2.9994540993539178e-6
leeann,0,girl,1,1,2.9994540993539178e-6
leianne,0,girl,1,1,2.9994540993539178e-6
leighanne,0,girl,1,1,2.9994540993539178e-6
lenix,0,girl,1,1,2.9994540993539178e-6
lennex,0,girl,1,1,2.9994540993539178e-6
lennox-leigh,0,girl,1,1,2.9994540993539178e-6
lennoxx-love,0,girl,1,1,2.9994540993539178e-6
lenore,0,girl,1,1,2.9994540993539178e-6
leoa,0,girl,1,1,2.9994540993539178e-6
leonelle,0,girl,1,1,2.9994540993539178e-6
leonni,0,girl,1,1,2.9994540993539178e-6
letisha-jay,0,girl,1,1,2.9994540993539178e-6
letizia,0,girl,1,1,2.9994540993539178e-6
leva,0,girl,1,1,2.9994540993539178e-6
lexi-corra,0,girl,1,1,2.9994540993539178e-6
lexi-katy,0,girl,1,1,2.9994540993539178e-6
lexianer,0,girl,1,1,2.9994540993539178e-6
lexii-grace,0,girl,1,1,2.9994540993539178e-6
leyton,0,girl,1,1,2.9994540993539178e-6
liby,0,girl,1,1,2.9994540993539178e-6
lilibet,0,girl,1,1,2.9994540993539178e-6
lilidh-anna,0,girl,1,1,2.9994540993539178e-6
lilith-grace,0,girl,1,1,2.9994540993539178e-6
lillia-erin,0,girl,1,1,2.9994540993539178e-6
lillianna-rose,0,girl,1,1,2.9994540993539178e-6
lillie-elizabeth,0,girl,1,1,2.9994540993539178e-6
lillie-j,0,girl,1,1,2.9994540993539178e-6
lillie-kate,0,girl,1,1,2.9994540993539178e-6
lilly-ezmai,0,girl,1,1,2.9994540993539178e-6
lily-alice,0,girl,1,1,2.9994540993539178e-6
lily-jade,0,girl,1,1,2.9994540993539178e-6
lily-joe,0,girl,1,1,2.9994540993539178e-6
lily-may-mary,0,girl,1,1,2.9994540993539178e-6
lilyanne,0,girl,1,1,2.9994540993539178e-6
limar,0,girl,1,1,2.9994540993539178e-6
lina-rose,0,girl,1,1,2.9994540993539178e-6
linga,0,girl,1,1,2.9994540993539178e-6
linisa,0,girl,1,1,2.9994540993539178e-6
linna,0,girl,1,1,2.9994540993539178e-6
linzi,0,girl,1,1,2.9994540993539178e-6
lionie,0,girl,1,1,2.9994540993539178e-6
liorah,0,girl,1,1,2.9994540993539178e-6
lira,0,girl,1,1,2.9994540993539178e-6
liril,0,girl,1,1,2.9994540993539178e-6
lisana,0,girl,1,1,2.9994540993539178e-6
liusaidh,0,girl,1,1,2.9994540993539178e-6
liyae,0,girl,1,1,2.9994540993539178e-6
liyah,0,girl,1,1,2.9994540993539178e-6
liyanna,0,girl,1,1,2.9994540993539178e-6
liylli-anne,0,girl,1,1,2.9994540993539178e-6
lizy,0,girl,1,1,2.9994540993539178e-6
llayla,0,girl,1,1,2.9994540993539178e-6
lola-lee,0,girl,1,1,2.9994540993539178e-6
lorella,0,girl,1,1,2.9994540993539178e-6
lori-ann,0,girl,1,1,2.9994540993539178e-6
lorilye,0,girl,1,1,2.9994540993539178e-6
lorrie,0,girl,1,1,2.9994540993539178e-6
lote,0,girl,1,1,2.9994540993539178e-6
lottie-quinne,0,girl,1,1,2.9994540993539178e-6
lottie-rhea,0,girl,1,1,2.9994540993539178e-6
louisa-rose,0,girl,1,1,2.9994540993539178e-6
loviah,0,girl,1,1,2.9994540993539178e-6
loxa,0,girl,1,1,2.9994540993539178e-6
luci-anna,0,girl,1,1,2.9994540993539178e-6
luciee,0,girl,1,1,2.9994540993539178e-6
lucy-anne,0,girl,1,1,2.9994540993539178e-6
lucy-jane,0,girl,1,1,2.9994540993539178e-6
lucy-lee,0,girl,1,1,2.9994540993539178e-6
lucy-madison,0,girl,1,1,2.9994540993539178e-6
lucy-may,0,girl,1,1,2.9994540993539178e-6
lukhveer,0,girl,1,1,2.9994540993539178e-6
lukrecja,0,girl,1,1,2.9994540993539178e-6
lulwah,0,girl,1,1,2.9994540993539178e-6
lumin,0,girl,1,1,2.9994540993539178e-6
lunna,0,girl,2,2,5.9989081987078355e-6
luo,0,girl,1,1,2.9994540993539178e-6
luxi,0,girl,1,1,2.9994540993539178e-6
luyi,0,girl,1,1,2.9994540993539178e-6
lyirah-jai,0,girl,1,1,2.9994540993539178e-6
lyla-zion,0,girl,1,1,2.9994540993539178e-6
lylah-rae,0,girl,1,1,2.9994540993539178e-6
lynnette,0,girl,1,1,2.9994540993539178e-6
lynsey,0,girl,1,1,2.9994540993539178e-6
lyona,0,girl,1,1,2.9994540993539178e-6
lyra-anne,0,girl,1,1,2.9994540993539178e-6
lyvia,0,girl,2,2,5.9989081987078355e-6
maca,0,girl,1,1,2.9994540993539178e-6
macarli-anne,0,girl,1,1,2.9994540993539178e-6
macci,0,girl,1,1,2.9994540993539178e-6
machaela,0,girl,1,1,2.9994540993539178e-6
machara,0,girl,2,2,5.9989081987078355e-6
maci-jay,0,girl,1,1,2.9994540993539178e-6
maci-leah,0,girl,1,1,2.9994540993539178e-6
macie-jo,0,girl,1,1,2.9994540993539178e-6
macy-dee,0,girl,1,1,2.9994540993539178e-6
macy-kate,0,girl,1,1,2.9994540993539178e-6
madisyn-grace,0,girl,1,1,2.9994540993539178e-6
madyson,0,girl,1,1,2.9994540993539178e-6
maeby,0,girl,1,1,2.9994540993539178e-6
mafalda,0,girl,2,2,5.9989081987078355e-6
magaidh,0,girl,1,1,2.9994540993539178e-6
maia-jane,0,girl,1,1,2.9994540993539178e-6
maibrei,0,girl,1,1,2.9994540993539178e-6
maili,0,girl,5,5,1.4997270496769588e-5
mailie,0,girl,1,1,2.9994540993539178e-6
maisey-leigh,0,girl,1,1,2.9994540993539178e-6
maisie-ella,0,girl,1,1,2.9994540993539178e-6
maisieann,0,girl,1,1,2.9994540993539178e-6
maissey,0,girl,1,1,2.9994540993539178e-6
maizi,0,girl,1,1,2.9994540993539178e-6
majda,0,girl,1,1,2.9994540993539178e-6
majula,0,girl,1,1,2.9994540993539178e-6
malaeka,0,girl,1,1,2.9994540993539178e-6
malath,0,girl,1,1,2.9994540993539178e-6
malihah,0,girl,1,1,2.9994540993539178e-6
malisa,0,girl,1,1,2.9994540993539178e-6
manel,0,girl,1,1,2.9994540993539178e-6
marcei,0,girl,1,1,2.9994540993539178e-6
marcelle,0,girl,1,1,2.9994540993539178e-6
maren,0,girl,2,2,5.9989081987078355e-6
maresia,0,girl,1,1,2.9994540993539178e-6
maria-louisa,0,girl,1,1,2.9994540993539178e-6
mariah-elaine,0,girl,1,1,2.9994540993539178e-6
marie-elizabeth,0,girl,1,1,2.9994540993539178e-6
marinessa,0,girl,1,1,2.9994540993539178e-6
mariska,0,girl,1,1,2.9994540993539178e-6
marley-mae,0,girl,1,1,2.9994540993539178e-6
marlia,0,girl,1,1,2.9994540993539178e-6
marliegh,0,girl,1,1,2.9994540993539178e-6
marlin,0,girl,1,1,2.9994540993539178e-6
marna,0,girl,1,1,2.9994540993539178e-6
marney-jay,0,girl,1,1,2.9994540993539178e-6
marsaili,0,girl,1,1,2.9994540993539178e-6
marsali,0,girl,1,1,2.9994540993539178e-6
martha-jane,0,girl,1,1,2.9994540993539178e-6
martha-rose,0,girl,1,1,2.9994540993539178e-6
maryliza,0,girl,1,1,2.9994540993539178e-6
marzi,0,girl,1,1,2.9994540993539178e-6
masiha,0,girl,1,1,2.9994540993539178e-6
masoume,0,girl,1,1,2.9994540993539178e-6
mastura,0,girl,1,1,2.9994540993539178e-6
matlida,0,girl,1,1,2.9994540993539178e-6
maura,0,girl,3,3,8.998362298061752e-6
maurina,0,girl,1,1,2.9994540993539178e-6
maxie,0,girl,1,1,2.9994540993539178e-6
maxwell,0,girl,2,2,5.9989081987078355e-6
mayara,0,girl,1,1,2.9994540993539178e-6
mayasin,0,girl,1,1,2.9994540993539178e-6
maylanah,0,girl,1,1,2.9994540993539178e-6
maziee,0,girl,1,1,2.9994540993539178e-6
mckey,0,girl,1,1,2.9994540993539178e-6
meaghan,0,girl,1,1,2.9994540993539178e-6
meah,0,girl,3,3,8.998362298061752e-6
meegan,0,girl,1,1,2.9994540993539178e-6
megan-may,0,girl,1,1,2.9994540993539178e-6
megyn,0,girl,1,1,2.9994540993539178e-6
meiia,0,girl,1,1,2.9994540993539178e-6
meilana,0,girl,1,1,2.9994540993539178e-6
melane,0,girl,1,1,2.9994540993539178e-6
meline,0,girl,1,1,2.9994540993539178e-6
melissa-rae,0,girl,1,1,2.9994540993539178e-6
meng,0,girl,1,1,2.9994540993539178e-6
mengyao,0,girl,1,1,2.9994540993539178e-6
meredyth,0,girl,1,1,2.9994540993539178e-6
merna,0,girl,1,1,2.9994540993539178e-6
merrily,0,girl,1,1,2.9994540993539178e-6
meryn,0,girl,1,1,2.9994540993539178e-6
mhairi-claire,0,girl,1,1,2.9994540993539178e-6
mharci,0,girl,1,1,2.9994540993539178e-6
mhari,0,girl,1,1,2.9994540993539178e-6
mhassin,0,girl,1,1,2.9994540993539178e-6
mhoirbheinn,0,girl,1,1,2.9994540993539178e-6
mhyah,0,girl,1,1,2.9994540993539178e-6
mia-estelle,0,girl,1,1,2.9994540993539178e-6
mia-lee,0,girl,1,1,2.9994540993539178e-6
mia-maria,0,girl,1,1,2.9994540993539178e-6
mia-nicole,0,girl,1,1,2.9994540993539178e-6
miah-leigh,0,girl,1,1,2.9994540993539178e-6
micayla,0,girl,1,1,2.9994540993539178e-6
michaela-mae,0,girl,1,1,2.9994540993539178e-6
midna,0,girl,1,1,2.9994540993539178e-6
mieke,0,girl,1,1,2.9994540993539178e-6
miela,0,girl,1,1,2.9994540993539178e-6
mifrah,0,girl,1,1,2.9994540993539178e-6
mikaah,0,girl,1,1,2.9994540993539178e-6
mikaella,0,girl,1,1,2.9994540993539178e-6
mikah,0,girl,1,1,2.9994540993539178e-6
mikayla-marie,0,girl,1,1,2.9994540993539178e-6
mikyla,0,girl,1,1,2.9994540993539178e-6
mila-alexandra,0,girl,1,1,2.9994540993539178e-6
mila-louisa,0,girl,1,1,2.9994540993539178e-6
milaniah,0,girl,1,1,2.9994540993539178e-6
milaniya,0,girl,1,1,2.9994540993539178e-6
milann,0,girl,1,1,2.9994540993539178e-6
milannia,0,girl,1,1,2.9994540993539178e-6
milannie,0,girl,1,1,2.9994540993539178e-6
milca,0,girl,1,1,2.9994540993539178e-6
milleigh,0,girl,1,1,2.9994540993539178e-6
millie-jane,0,girl,1,1,2.9994540993539178e-6
millie-jo,0,girl,1,1,2.9994540993539178e-6
millyanne,0,girl,1,1,2.9994540993539178e-6
milou,0,girl,1,1,2.9994540993539178e-6
minea,0,girl,1,1,2.9994540993539178e-6
minii,0,girl,1,1,2.9994540993539178e-6
mio,0,girl,1,1,2.9994540993539178e-6
mirin,0,girl,2,2,5.9989081987078355e-6
mirona,0,girl,1,1,2.9994540993539178e-6
mirrin,0,girl,5,5,1.4997270496769588e-5
mirryn,0,girl,7,7,2.0996178695477422e-5
miryn,0,girl,1,1,2.9994540993539178e-6
missoni,0,girl,1,1,2.9994540993539178e-6
mittra,0,girl,1,1,2.9994540993539178e-6
miya-jo,0,girl,1,1,2.9994540993539178e-6
mo,0,girl,1,1,2.9994540993539178e-6
modebare,0,girl,1,1,2.9994540993539178e-6
moira,0,girl,2,2,5.9989081987078355e-6
molly-jane,0,girl,2,2,5.9989081987078355e-6
monalisa,0,girl,1,1,2.9994540993539178e-6
monreaux,0,girl,1,1,2.9994540993539178e-6
morag,0,girl,3,3,8.998362298061752e-6
moran,0,girl,1,1,2.9994540993539178e-6
morgan-madison,0,girl,1,1,2.9994540993539178e-6
morganne,0,girl,1,1,2.9994540993539178e-6
moriiyanu,0,girl,1,1,2.9994540993539178e-6
morna,0,girl,1,1,2.9994540993539178e-6
morrighan,0,girl,1,1,2.9994540993539178e-6
morven,0,girl,17,17,5.09907196890166e-5
mouli,0,girl,1,1,2.9994540993539178e-6
mu,0,girl,1,1,2.9994540993539178e-6
mubeen,0,girl,1,1,2.9994540993539178e-6
muhaddsa,0,girl,1,1,2.9994540993539178e-6
munawar,0,girl,1,1,2.9994540993539178e-6
munya,0,girl,1,1,2.9994540993539178e-6
murann,0,girl,1,1,2.9994540993539178e-6
murn,0,girl,1,1,2.9994540993539178e-6
murran,0,girl,1,1,2.9994540993539178e-6
murren,0,girl,2,2,5.9989081987078355e-6
murrin,0,girl,2,2,5.9989081987078355e-6
murron,0,girl,14,14,4.1992357390954844e-5
murron-rose,0,girl,2,2,5.9989081987078355e-6
murryn,0,girl,3,3,8.998362298061752e-6
muyan,0,girl,1,1,2.9994540993539178e-6
muying,0,girl,1,1,2.9994540993539178e-6
myah-laya,0,girl,1,1,2.9994540993539178e-6
myiafaith,0,girl,1,1,2.9994540993539178e-6
mylar,0,girl,1,1,2.9994540993539178e-6
myran,0,girl,1,1,2.9994540993539178e-6
myrren,0,girl,1,1,2.9994540993539178e-6
myrtle,0,girl,1,1,2.9994540993539178e-6
nadirah,0,girl,1,1,2.9994540993539178e-6
naiah,0,girl,2,2,5.9989081987078355e-6
naiara,0,girl,2,2,5.9989081987078355e-6
nairn,0,girl,1,1,2.9994540993539178e-6
nairne,0,girl,3,3,8.998362298061752e-6
najax,0,girl,1,1,2.9994540993539178e-6
nancy-laine,0,girl,1,1,2.9994540993539178e-6
nandana,0,girl,1,1,2.9994540993539178e-6
nao,0,girl,1,1,2.9994540993539178e-6
naqeebah,0,girl,1,1,2.9994540993539178e-6
nasma,0,girl,1,1,2.9994540993539178e-6
natalee,0,girl,1,1,2.9994540993539178e-6
natalya-sabrina,0,girl,1,1,2.9994540993539178e-6
natalyia,0,girl,1,1,2.9994540993539178e-6
neah,0,girl,1,1,2.9994540993539178e-6
neith,0,girl,1,1,2.9994540993539178e-6
neivah,0,girl,1,1,2.9994540993539178e-6
nene,0,girl,1,1,2.9994540993539178e-6
nesia,0,girl,1,1,2.9994540993539178e-6
nheive,0,girl,1,1,2.9994540993539178e-6
niadh,0,girl,1,1,2.9994540993539178e-6
niamh-anna,0,girl,1,1,2.9994540993539178e-6
niimah,0,girl,1,1,2.9994540993539178e-6
nikhila,0,girl,1,1,2.9994540993539178e-6
ningyuan,0,girl,1,1,2.9994540993539178e-6
niome,0,girl,1,1,2.9994540993539178e-6
niomi,0,girl,4,4,1.1997816397415671e-5
nirvana-andi,0,girl,1,1,2.9994540993539178e-6
niswan,0,girl,1,1,2.9994540993539178e-6
nithya,0,girl,1,1,2.9994540993539178e-6
nivah,0,girl,1,1,2.9994540993539178e-6
nivedita,0,girl,1,1,2.9994540993539178e-6
nizah,0,girl,1,1,2.9994540993539178e-6
nkemdilichukwu,0,girl,1,1,2.9994540993539178e-6
nnenna-elizabeth,0,girl,1,1,2.9994540993539178e-6
nontlantla,0,girl,1,1,2.9994540993539178e-6
noomi,0,girl,1,1,2.9994540993539178e-6
noor-ul-hayya,0,girl,1,1,2.9994540993539178e-6
noor-ul-huda,0,girl,1,1,2.9994540993539178e-6
noor-ul-imaan,0,girl,1,1,2.9994540993539178e-6
norri,0,girl,1,1,2.9994540993539178e-6
nova-leigh,0,girl,1,1,2.9994540993539178e-6
nova-louise,0,girl,1,1,2.9994540993539178e-6
novalee,0,girl,1,1,2.9994540993539178e-6
nula,0,girl,2,2,5.9989081987078355e-6
numa,0,girl,1,1,2.9994540993539178e-6
nusrah,0,girl,1,1,2.9994540993539178e-6
nyalah,0,girl,1,1,2.9994540993539178e-6
nyasha,0,girl,1,1,2.9994540993539178e-6
nyhira,0,girl,1,1,2.9994540993539178e-6
nylah-grace,0,girl,1,1,2.9994540993539178e-6
ocian,0,girl,2,2,5.9989081987078355e-6
odelle-michelle,0,girl,1,1,2.9994540993539178e-6
oghenetega,0,girl,1,1,2.9994540993539178e-6
oilbhe,0,girl,1,1,2.9994540993539178e-6
oladunni,0,girl,1,1,2.9994540993539178e-6
olamiseji,0,girl,1,1,2.9994540993539178e-6
olea-mae,0,girl,1,1,2.9994540993539178e-6
olivia-elaine,0,girl,1,1,2.9994540993539178e-6
olivia-michelle,0,girl,1,1,2.9994540993539178e-6
olivia-shay,0,girl,1,1,2.9994540993539178e-6
oliviah,0,girl,1,1,2.9994540993539178e-6
oliviarose,0,girl,1,1,2.9994540993539178e-6
ollie,0,girl,1,1,2.9994540993539178e-6
oluwabukunmi,0,girl,1,1,2.9994540993539178e-6
oluwafimisewa,0,girl,1,1,2.9994540993539178e-6
oluwafolakemi,0,girl,1,1,2.9994540993539178e-6
oluwagbemisola,0,girl,1,1,2.9994540993539178e-6
oluwamodupe,0,girl,1,1,2.9994540993539178e-6
oluwasemilanu,0,girl,1,1,2.9994540993539178e-6
oluwasunmisoke,0,girl,1,1,2.9994540993539178e-6
olyvia,0,girl,1,1,2.9994540993539178e-6
oneika,0,girl,1,1,2.9994540993539178e-6
opaline,0,girl,1,1,2.9994540993539178e-6
orin,0,girl,1,1,2.9994540993539178e-6
orlagh-grace,0,girl,1,1,2.9994540993539178e-6
orlaidh,0,girl,1,1,2.9994540993539178e-6
orlaigh,0,girl,1,1,2.9994540993539178e-6
orlla,0,girl,1,1,2.9994540993539178e-6
ouma,0,girl,1,1,2.9994540993539178e-6
oumnia,0,girl,1,1,2.9994540993539178e-6
ozioma,0,girl,1,1,2.9994540993539178e-6
padme,0,girl,2,2,5.9989081987078355e-6
paislie,0,girl,1,1,2.9994540993539178e-6
paisly,0,girl,1,1,2.9994540993539178e-6
paiyton,0,girl,1,1,2.9994540993539178e-6
paraskevi-angeliki,0,girl,1,1,2.9994540993539178e-6
parisha,0,girl,1,1,2.9994540993539178e-6
pariza,0,girl,1,1,2.9994540993539178e-6
parul,0,girl,1,1,2.9994540993539178e-6
pavla,0,girl,1,1,2.9994540993539178e-6
payson,0,girl,1,1,2.9994540993539178e-6
payton-may,0,girl,1,1,2.9994540993539178e-6
payton-rose,0,girl,1,1,2.9994540993539178e-6
pehel,0,girl,1,1,2.9994540993539178e-6
pei,0,girl,1,1,2.9994540993539178e-6
peiqi,0,girl,1,1,2.9994540993539178e-6
penelopie,0,girl,1,1,2.9994540993539178e-6
penny-may,0,girl,1,1,2.9994540993539178e-6
perhi,0,girl,1,1,2.9994540993539178e-6
perri-grace,0,girl,1,1,2.9994540993539178e-6
perry,0,girl,1,1,2.9994540993539178e-6
perth,0,girl,1,1,2.9994540993539178e-6
petra-rose,0,girl,1,1,2.9994540993539178e-6
peysonn,0,girl,1,1,2.9994540993539178e-6
piper-james,0,girl,1,1,2.9994540993539178e-6
pippin,0,girl,1,1,2.9994540993539178e-6
piriyan,0,girl,1,1,2.9994540993539178e-6
pixi,0,girl,2,2,5.9989081987078355e-6
poppy-ray,0,girl,1,1,2.9994540993539178e-6
portia-marie,0,girl,1,1,2.9994540993539178e-6
prayushi,0,girl,1,1,2.9994540993539178e-6
prerana,0,girl,1,1,2.9994540993539178e-6
preslie,0,girl,1,1,2.9994540993539178e-6
priceless,0,girl,1,1,2.9994540993539178e-6
priyangi,0,girl,1,1,2.9994540993539178e-6
prusha,0,girl,1,1,2.9994540993539178e-6
pyper-ava,0,girl,1,1,2.9994540993539178e-6
queena,0,girl,1,1,2.9994540993539178e-6
quetzalli,0,girl,1,1,2.9994540993539178e-6
raai,0,girl,1,1,2.9994540993539178e-6
rachele,0,girl,2,2,5.9989081987078355e-6
radeyah,0,girl,1,1,2.9994540993539178e-6
radostina,0,girl,1,1,2.9994540993539178e-6
raevan,0,girl,1,1,2.9994540993539178e-6
rahelah,0,girl,1,1,2.9994540993539178e-6
rahne,0,girl,1,1,2.9994540993539178e-6
raian,0,girl,1,1,2.9994540993539178e-6
raimah,0,girl,1,1,2.9994540993539178e-6
rainn,0,girl,2,2,5.9989081987078355e-6
rajwa,0,girl,1,1,2.9994540993539178e-6
rameesah,0,girl,1,1,2.9994540993539178e-6
ramisa,0,girl,1,1,2.9994540993539178e-6
rari,0,girl,1,1,2.9994540993539178e-6
rateel,0,girl,1,1,2.9994540993539178e-6
ravenjaye,0,girl,1,1,2.9994540993539178e-6
ravika,0,girl,1,1,2.9994540993539178e-6
rawdha,0,girl,1,1,2.9994540993539178e-6
raya-mae,0,girl,1,1,2.9994540993539178e-6
rayann,0,girl,1,1,2.9994540993539178e-6
rayna-nicole,0,girl,1,1,2.9994540993539178e-6
raynie,0,girl,1,1,2.9994540993539178e-6
raynor,0,girl,1,1,2.9994540993539178e-6
reah,0,girl,1,1,2.9994540993539178e-6
rebecca-grace,0,girl,1,1,2.9994540993539178e-6
rebecca-pearl,0,girl,1,1,2.9994540993539178e-6
reece,0,girl,1,1,2.9994540993539178e-6
reesa,0,girl,1,1,2.9994540993539178e-6
reeva-violet,0,girl,1,1,2.9994540993539178e-6
reevah,0,girl,1,1,2.9994540993539178e-6
reeve,0,girl,2,2,5.9989081987078355e-6
reigan,0,girl,1,1,2.9994540993539178e-6
reigan-jade,0,girl,1,1,2.9994540993539178e-6
reighn,0,girl,1,1,2.9994540993539178e-6
reigne,0,girl,1,1,2.9994540993539178e-6
reinelle,0,girl,1,1,2.9994540993539178e-6
reis,0,girl,1,1,2.9994540993539178e-6
reiss,0,girl,1,1,2.9994540993539178e-6
remi-may,0,girl,1,1,2.9994540993539178e-6
remi-river,0,girl,1,1,2.9994540993539178e-6
remii,0,girl,1,1,2.9994540993539178e-6
rengim,0,girl,1,1,2.9994540993539178e-6
renisha,0,girl,1,1,2.9994540993539178e-6
reshalya,0,girl,1,1,2.9994540993539178e-6
reve,0,girl,1,1,2.9994540993539178e-6
revie,0,girl,1,1,2.9994540993539178e-6
rezelle,0,girl,1,1,2.9994540993539178e-6
rhania,0,girl,1,1,2.9994540993539178e-6
rhayn,0,girl,1,1,2.9994540993539178e-6
rhegan,0,girl,1,1,2.9994540993539178e-6
rhema-evangeline,0,girl,1,1,2.9994540993539178e-6
rhiann,0,girl,1,1,2.9994540993539178e-6
rhiley,0,girl,1,1,2.9994540993539178e-6
rhodes,0,girl,1,1,2.9994540993539178e-6
rhoma,0,girl,1,1,2.9994540993539178e-6
rhomey,0,girl,1,1,2.9994540993539178e-6
rhowen,0,girl,1,1,2.9994540993539178e-6
rhyian,0,girl,1,1,2.9994540993539178e-6
rhylie,0,girl,1,1,2.9994540993539178e-6
rian,0,girl,1,1,2.9994540993539178e-6
ricki,0,girl,1,1,2.9994540993539178e-6
rienka,0,girl,1,1,2.9994540993539178e-6
riese,0,girl,1,1,2.9994540993539178e-6
rievah,0,girl,1,1,2.9994540993539178e-6
rihannah,0,girl,1,1,2.9994540993539178e-6
rionach,0,girl,1,1,2.9994540993539178e-6
rishana,0,girl,1,1,2.9994540993539178e-6
ritaal,0,girl,1,1,2.9994540993539178e-6
riviera,0,girl,1,1,2.9994540993539178e-6
riyaa,0,girl,1,1,2.9994540993539178e-6
roame,0,girl,1,1,2.9994540993539178e-6
roan,0,girl,1,1,2.9994540993539178e-6
robyn-jane,0,girl,1,1,2.9994540993539178e-6
robynn-belle,0,girl,1,1,2.9994540993539178e-6
roise,0,girl,1,1,2.9994540993539178e-6
romyn,0,girl,1,1,2.9994540993539178e-6
rona-grace,0,girl,1,1,2.9994540993539178e-6
ronni-louise,0,girl,1,1,2.9994540993539178e-6
rony,0,girl,1,1,2.9994540993539178e-6
roqaya,0,girl,1,1,2.9994540993539178e-6
roqeebah,0,girl,1,1,2.9994540993539178e-6
rory,0,girl,1,1,2.9994540993539178e-6
rosagrace,0,girl,1,1,2.9994540993539178e-6
rosalea,0,girl,1,1,2.9994540993539178e-6
rosalin,0,girl,1,1,2.9994540993539178e-6
rosanna-may,0,girl,1,1,2.9994540993539178e-6
roshanara,0,girl,1,1,2.9994540993539178e-6
roslin,0,girl,1,1,2.9994540993539178e-6
rowenna,0,girl,1,1,2.9994540993539178e-6
roxane,0,girl,1,1,2.9994540993539178e-6
roxann,0,girl,1,1,2.9994540993539178e-6
roxi,0,girl,1,1,2.9994540993539178e-6
rozanna,0,girl,1,1,2.9994540993539178e-6
rozi,0,girl,1,1,2.9994540993539178e-6
rozy,0,girl,1,1,2.9994540993539178e-6
ruadh,0,girl,1,1,2.9994540993539178e-6
ruah,0,girl,1,1,2.9994540993539178e-6
rubin,0,girl,1,1,2.9994540993539178e-6
ruby-june,0,girl,1,1,2.9994540993539178e-6
rudi-may,0,girl,1,1,2.9994540993539178e-6
ruhaab,0,girl,1,1,2.9994540993539178e-6
ruihan,0,girl,1,1,2.9994540993539178e-6
ruilin,0,girl,1,1,2.9994540993539178e-6
rumannah,0,girl,1,1,2.9994540993539178e-6
rumeisa,0,girl,1,1,2.9994540993539178e-6
rumla,0,girl,1,1,2.9994540993539178e-6
rumor,0,girl,1,1,2.9994540993539178e-6
ruqaiyyah,0,girl,1,1,2.9994540993539178e-6
ruth-makafui,0,girl,1,1,2.9994540993539178e-6
ryann,0,girl,1,1,2.9994540993539178e-6
ryver,0,girl,1,1,2.9994540993539178e-6
sabri,0,girl,1,1,2.9994540993539178e-6
sabria,0,girl,1,1,2.9994540993539178e-6
sadan,0,girl,1,1,2.9994540993539178e-6
sadie-may,0,girl,1,1,2.9994540993539178e-6
safanah,0,girl,1,1,2.9994540993539178e-6
saffiatou,0,girl,1,1,2.9994540993539178e-6
safija,0,girl,1,1,2.9994540993539178e-6
sahali,0,girl,1,1,2.9994540993539178e-6
sahibah,0,girl,1,1,2.9994540993539178e-6
sainabou,0,girl,1,1,2.9994540993539178e-6
saleeha,0,girl,1,1,2.9994540993539178e-6
salesha,0,girl,1,1,2.9994540993539178e-6
salice,0,girl,1,1,2.9994540993539178e-6
salleigh,0,girl,1,1,2.9994540993539178e-6
sam,0,girl,1,1,2.9994540993539178e-6
samawatha,0,girl,1,1,2.9994540993539178e-6
samayyah,0,girl,1,1,2.9994540993539178e-6
samiera,0,girl,1,1,2.9994540993539178e-6
samra,0,girl,1,1,2.9994540993539178e-6
sanabil,0,girl,1,1,2.9994540993539178e-6
sandi,0,girl,2,2,5.9989081987078355e-6
sandie,0,girl,2,2,5.9989081987078355e-6
sanjna,0,girl,1,1,2.9994540993539178e-6
sanjog,0,girl,1,1,2.9994540993539178e-6
sanne,0,girl,1,1,2.9994540993539178e-6
sansitha,0,girl,1,1,2.9994540993539178e-6
saoirse-rose,0,girl,1,1,2.9994540993539178e-6
saphire-rose,0,girl,1,1,2.9994540993539178e-6
sarah-anne,0,girl,1,1,2.9994540993539178e-6
sarah-cristiana,0,girl,1,1,2.9994540993539178e-6
sarahn,0,girl,1,1,2.9994540993539178e-6
savannah-ray,0,girl,1,1,2.9994540993539178e-6
savvanah,0,girl,1,1,2.9994540993539178e-6
sawyer,0,girl,1,1,2.9994540993539178e-6
sayona,0,girl,1,1,2.9994540993539178e-6
sazan,0,girl,1,1,2.9994540993539178e-6
scarlet-louise,0,girl,1,1,2.9994540993539178e-6
seaneen,0,girl,1,1,2.9994540993539178e-6
seba,0,girl,1,1,2.9994540993539178e-6
seileach,0,girl,1,1,2.9994540993539178e-6
selia,0,girl,1,1,2.9994540993539178e-6
selina-rose,0,girl,1,1,2.9994540993539178e-6
selvana,0,girl,1,1,2.9994540993539178e-6
sema,0,girl,1,1,2.9994540993539178e-6
seona,0,girl,1,1,2.9994540993539178e-6
seonaid,0,girl,1,1,2.9994540993539178e-6
sephira-temple,0,girl,1,1,2.9994540993539178e-6
serena-mei,0,girl,1,1,2.9994540993539178e-6
seyida-fatima,0,girl,1,1,2.9994540993539178e-6
shadden,0,girl,1,1,2.9994540993539178e-6
shadh,0,girl,1,1,2.9994540993539178e-6
shadleen,0,girl,1,1,2.9994540993539178e-6
shahed,0,girl,1,1,2.9994540993539178e-6
shahlyla,0,girl,1,1,2.9994540993539178e-6
shahnoor,0,girl,1,1,2.9994540993539178e-6
shajeena,0,girl,1,1,2.9994540993539178e-6
shalisha,0,girl,1,1,2.9994540993539178e-6
shamail,0,girl,1,1,2.9994540993539178e-6
shanaida,0,girl,1,1,2.9994540993539178e-6
shanaide,0,girl,1,1,2.9994540993539178e-6
shanel,0,girl,1,1,2.9994540993539178e-6
shanelly,0,girl,1,1,2.9994540993539178e-6
shannah,0,girl,1,1,2.9994540993539178e-6
shanniah,0,girl,1,1,2.9994540993539178e-6
sharai,0,girl,1,1,2.9994540993539178e-6
sharan,0,girl,1,1,2.9994540993539178e-6
shareena,0,girl,1,1,2.9994540993539178e-6
sharise,0,girl,1,1,2.9994540993539178e-6
sharon-rose,0,girl,1,1,2.9994540993539178e-6
sharvani,0,girl,1,1,2.9994540993539178e-6
shayla-may,0,girl,1,1,2.9994540993539178e-6
shaylen,0,girl,1,1,2.9994540993539178e-6
shebnem,0,girl,1,1,2.9994540993539178e-6
shehzeen,0,girl,1,1,2.9994540993539178e-6
shelbie,0,girl,1,1,2.9994540993539178e-6
shellby,0,girl,1,1,2.9994540993539178e-6
sherilyn,0,girl,1,1,2.9994540993539178e-6
shevaun,0,girl,1,1,2.9994540993539178e-6
shiniece,0,girl,1,1,2.9994540993539178e-6
shiyao,0,girl,1,1,2.9994540993539178e-6
shmookh,0,girl,1,1,2.9994540993539178e-6
sholo,0,girl,1,1,2.9994540993539178e-6
shranaya,0,girl,1,1,2.9994540993539178e-6
shreedhanya,0,girl,1,1,2.9994540993539178e-6
shuang,0,girl,1,1,2.9994540993539178e-6
siba,0,girl,1,1,2.9994540993539178e-6
sienna-paige,0,girl,1,1,2.9994540993539178e-6
sigrid,0,girl,1,1,2.9994540993539178e-6
sileas,0,girl,1,1,2.9994540993539178e-6
sime,0,girl,1,1,2.9994540993539178e-6
sineade,0,girl,1,1,2.9994540993539178e-6
sionainn,0,girl,1,1,2.9994540993539178e-6
siri-singha,0,girl,1,1,2.9994540993539178e-6
siti,0,girl,1,1,2.9994540993539178e-6
siyi,0,girl,1,1,2.9994540993539178e-6
skylar-louise,0,girl,1,1,2.9994540993539178e-6
soa,0,girl,1,1,2.9994540993539178e-6
solene,0,girl,1,1,2.9994540993539178e-6
solenne,0,girl,1,1,2.9994540993539178e-6
somtochukwu,0,girl,1,1,2.9994540993539178e-6
sonea,0,girl,1,1,2.9994540993539178e-6
sophia-lee,0,girl,1,1,2.9994540993539178e-6
sophia-lily,0,girl,1,1,2.9994540993539178e-6
sophie-lee,0,girl,1,1,2.9994540993539178e-6
sophie-marie,0,girl,2,2,5.9989081987078355e-6
sorsha,0,girl,1,1,2.9994540993539178e-6
sravya,0,girl,1,1,2.9994540993539178e-6
sreshta,0,girl,1,1,2.9994540993539178e-6
stacy-alexis,0,girl,1,1,2.9994540993539178e-6
steavy,0,girl,1,1,2.9994540993539178e-6
stepanka,0,girl,1,1,2.9994540993539178e-6
stephenie,0,girl,1,1,2.9994540993539178e-6
sterling,0,girl,1,1,2.9994540993539178e-6
stevie-eloise,0,girl,1,1,2.9994540993539178e-6
stevie-rae,0,girl,1,1,2.9994540993539178e-6
storme-helena,0,girl,1,1,2.9994540993539178e-6
suilven,0,girl,1,1,2.9994540993539178e-6
sukritta,0,girl,1,1,2.9994540993539178e-6
sumer,0,girl,1,1,2.9994540993539178e-6
summer-ray,0,girl,1,1,2.9994540993539178e-6
sun,0,girl,1,1,2.9994540993539178e-6
sunni,0,girl,1,1,2.9994540993539178e-6
sunnie,0,girl,2,2,5.9989081987078355e-6
surina,0,girl,1,1,2.9994540993539178e-6
suriya,0,girl,1,1,2.9994540993539178e-6
suzi,0,girl,1,1,2.9994540993539178e-6
syenna,0,girl,1,1,2.9994540993539178e-6
sylwia,0,girl,1,1,2.9994540993539178e-6
synnove,0,girl,1,1,2.9994540993539178e-6
taabia,0,girl,1,1,2.9994540993539178e-6
talana,0,girl,1,1,2.9994540993539178e-6
talia-jane,0,girl,1,1,2.9994540993539178e-6
talulagh,0,girl,1,1,2.9994540993539178e-6
tamaki,0,girl,1,1,2.9994540993539178e-6
tamora,0,girl,1,1,2.9994540993539178e-6
tamyra,0,girl,1,1,2.9994540993539178e-6
tamzine,0,girl,1,1,2.9994540993539178e-6
tanith,0,girl,2,2,5.9989081987078355e-6
tansi,0,girl,1,1,2.9994540993539178e-6
tanwen,0,girl,1,1,2.9994540993539178e-6
tara-leigh,0,girl,1,1,2.9994540993539178e-6
taranmeet,0,girl,1,1,2.9994540993539178e-6
taraoluwanimi,0,girl,1,1,2.9994540993539178e-6
tarryn,0,girl,1,1,2.9994540993539178e-6
taslim,0,girl,1,1,2.9994540993539178e-6
tasmin,0,girl,1,1,2.9994540993539178e-6
tauriel,0,girl,1,1,2.9994540993539178e-6
taye,0,girl,1,1,2.9994540993539178e-6
tayni,0,girl,1,1,2.9994540993539178e-6
taysia,0,girl,1,1,2.9994540993539178e-6
teagen-rose,0,girl,1,1,2.9994540993539178e-6
teaghan,0,girl,1,1,2.9994540993539178e-6
teeanna,0,girl,1,1,2.9994540993539178e-6
teena,0,girl,1,1,2.9994540993539178e-6
tegan-louise,0,girl,1,1,2.9994540993539178e-6
teghan,0,girl,1,1,2.9994540993539178e-6
tehila,0,girl,1,1,2.9994540993539178e-6
teighlor,0,girl,2,2,5.9989081987078355e-6
tejiri,0,girl,1,1,2.9994540993539178e-6
temika,0,girl,1,1,2.9994540993539178e-6
temilolaoluwa,0,girl,1,1,2.9994540993539178e-6
teri,0,girl,1,1,2.9994540993539178e-6
terri-leigh,0,girl,1,1,2.9994540993539178e-6
tesla,0,girl,1,1,2.9994540993539178e-6
thanuja,0,girl,1,1,2.9994540993539178e-6
tharini,0,girl,1,1,2.9994540993539178e-6
thea-alexandria,0,girl,1,1,2.9994540993539178e-6
thea-jessica,0,girl,1,1,2.9994540993539178e-6
theia-mae,0,girl,1,1,2.9994540993539178e-6
theola,0,girl,1,1,2.9994540993539178e-6
therese,0,girl,1,1,2.9994540993539178e-6
thwaya,0,girl,1,1,2.9994540993539178e-6
tiami,0,girl,1,1,2.9994540993539178e-6
tienna-rose,0,girl,1,1,2.9994540993539178e-6
tierni,0,girl,1,1,2.9994540993539178e-6
tilde,0,girl,1,1,2.9994540993539178e-6
tilldin,0,girl,1,1,2.9994540993539178e-6
tillee,0,girl,1,1,2.9994540993539178e-6
tilley-louise,0,girl,1,1,2.9994540993539178e-6
tilly-anna,0,girl,1,1,2.9994540993539178e-6
tindaya,0,girl,1,1,2.9994540993539178e-6
tionnie,0,girl,1,1,2.9994540993539178e-6
tippi,0,girl,1,1,2.9994540993539178e-6
tiree,0,girl,1,1,2.9994540993539178e-6
tiwatope,0,girl,1,1,2.9994540993539178e-6
tomislava,0,girl,1,1,2.9994540993539178e-6
torria,0,girl,1,1,2.9994540993539178e-6
torrie,0,girl,1,1,2.9994540993539178e-6
torrin,0,girl,1,1,2.9994540993539178e-6
tosca,0,girl,1,1,2.9994540993539178e-6
touba,0,girl,1,1,2.9994540993539178e-6
traci,0,girl,1,1,2.9994540993539178e-6
triana-eloise,0,girl,1,1,2.9994540993539178e-6
trisa,0,girl,1,1,2.9994540993539178e-6
udaimatunnur,0,girl,1,1,2.9994540993539178e-6
ulamila,0,girl,1,1,2.9994540993539178e-6
ulla,0,girl,1,1,2.9994540993539178e-6
uwuma,0,girl,1,1,2.9994540993539178e-6
uxia,0,girl,1,1,2.9994540993539178e-6
vaeda,0,girl,1,1,2.9994540993539178e-6
vaila,0,girl,12,12,3.599344919224701e-5
vaishali,0,girl,1,1,2.9994540993539178e-6
vaishvi,0,girl,1,1,2.9994540993539178e-6
valla,0,girl,2,2,5.9989081987078355e-6
vania,0,girl,1,1,2.9994540993539178e-6
varrie,0,girl,1,1,2.9994540993539178e-6
varyse,0,girl,1,1,2.9994540993539178e-6
vashti,0,girl,1,1,2.9994540993539178e-6
veeha,0,girl,1,1,2.9994540993539178e-6
vegas,0,girl,1,1,2.9994540993539178e-6
velvet,0,girl,1,1,2.9994540993539178e-6
vhairi,0,girl,1,1,2.9994540993539178e-6
vhara,0,girl,1,1,2.9994540993539178e-6
vhari,0,girl,1,1,2.9994540993539178e-6
viaana,0,girl,1,1,2.9994540993539178e-6
vidya,0,girl,1,1,2.9994540993539178e-6
viera,0,girl,1,1,2.9994540993539178e-6
viole,0,girl,1,1,2.9994540993539178e-6
vishnu,0,girl,1,1,2.9994540993539178e-6
viva,0,girl,2,2,5.9989081987078355e-6
vrisha,0,girl,1,1,2.9994540993539178e-6
vyenna,0,girl,1,1,2.9994540993539178e-6
waad,0,girl,1,1,2.9994540993539178e-6
walla,0,girl,1,1,2.9994540993539178e-6
wallis,0,girl,3,3,8.998362298061752e-6
wantanee,0,girl,1,1,2.9994540993539178e-6
wesal,0,girl,1,1,2.9994540993539178e-6
whynter-rose,0,girl,1,1,2.9994540993539178e-6
wiloh,0,girl,1,1,2.9994540993539178e-6
wilow,0,girl,1,1,2.9994540993539178e-6
winni,0,girl,1,1,2.9994540993539178e-6
wrd,0,girl,1,1,2.9994540993539178e-6
xaiya,0,girl,1,1,2.9994540993539178e-6
xana,0,girl,1,1,2.9994540993539178e-6
xante,0,girl,1,1,2.9994540993539178e-6
xia,0,girl,1,1,2.9994540993539178e-6
xinhuay,0,girl,1,1,2.9994540993539178e-6
xinyi,0,girl,1,1,2.9994540993539178e-6
xiomara,0,girl,1,1,2.9994540993539178e-6
xixi,0,girl,1,1,2.9994540993539178e-6
y,0,girl,1,1,2.9994540993539178e-6
yaadavi,0,girl,1,1,2.9994540993539178e-6
yabesera,0,girl,1,1,2.9994540993539178e-6
yalini,0,girl,1,1,2.9994540993539178e-6
yannis,0,girl,1,1,2.9994540993539178e-6
yara-rose,0,girl,1,1,2.9994540993539178e-6
yashleen,0,girl,1,1,2.9994540993539178e-6
yashvika,0,girl,1,1,2.9994540993539178e-6
yassin,0,girl,1,1,2.9994540993539178e-6
yeshna,0,girl,1,1,2.9994540993539178e-6
yi-lan,0,girl,1,1,2.9994540993539178e-6
yiling,0,girl,1,1,2.9994540993539178e-6
yinglun,0,girl,1,1,2.9994540993539178e-6
yinuo,0,girl,1,1,2.9994540993539178e-6
yishu,0,girl,1,1,2.9994540993539178e-6
yohana,0,girl,1,1,2.9994540993539178e-6
yolandi,0,girl,1,1,2.9994540993539178e-6
yong,0,girl,1,1,2.9994540993539178e-6
yosan,0,girl,1,1,2.9994540993539178e-6
yuanai,0,girl,1,1,2.9994540993539178e-6
yukta,0,girl,1,1,2.9994540993539178e-6
yulia,0,girl,1,1,2.9994540993539178e-6
yun,0,girl,1,1,2.9994540993539178e-6
yurana,0,girl,1,1,2.9994540993539178e-6
yuuha,0,girl,1,1,2.9994540993539178e-6
yuxi,0,girl,1,1,2.9994540993539178e-6
yuxin,0,girl,1,1,2.9994540993539178e-6
yvanna,0,girl,1,1,2.9994540993539178e-6
zahra-bilan,0,girl,1,1,2.9994540993539178e-6
zanelle,0,girl,1,1,2.9994540993539178e-6
zarnish,0,girl,1,1,2.9994540993539178e-6
zarrah,0,girl,1,1,2.9994540993539178e-6
zarwa,0,girl,1,1,2.9994540993539178e-6
zealina,0,girl,1,1,2.9994540993539178e-6
zee,0,girl,1,1,2.9994540993539178e-6
zemirah,0,girl,1,1,2.9994540993539178e-6
zen,0,girl,1,1,2.9994540993539178e-6
zenna,0,girl,1,1,2.9994540993539178e-6
zerlina,0,girl,1,1,2.9994540993539178e-6
zeyra,0,girl,1,1,2.9994540993539178e-6
zhen,0,girl,1,1,2.9994540993539178e-6
zhining,0,girl,1,1,2.9994540993539178e-6
ziana,0,girl,1,1,2.9994540993539178e-6
zihan,0,girl,1,1,2.9994540993539178e-6
zinachimdi,0,girl,1,1,2.9994540993539178e-6
zinachimdindu,0,girl,1,1,2.9994540993539178e-6
zinan,0,girl,1,1,2.9994540993539178e-6
ziyan,0,girl,1,1,2.9994540993539178e-6
ziyue,0,girl,1,1,2.9994540993539178e-6
zuriah,0,girl,1,1,2.9994540993539178e-6
zurie,0,girl,1,1,2.9994540993539178e-6
zyah-rose,0,girl,1,1,2.9994540993539178e-6
